Dungeon by Rooms begins here.


[!<LabyrinthRoom>@

REQUIRES COMMENTING

@inherits <Room>

@!]
A labyrinth room is a kind of room.  A labyrinth room has a labyrinth shape called shape.  The shape of a labyrinth room is usually L1/0-0-1-1-1-1.  The grid position of a labyrinth room is usually <0,0,0>.

[!<dungeon01:LabyrinthRoom>*

REQUIRES COMMENTING

*!]
Dungeon01 is a sandy labyrinth room.  The printed name of Dungeon01 is "Small Stone Room".  "After moving through so many open areas, it was odd to come across a room so cramped. It appeared to have been built into one of the larger walls as some kind of storage cubby that gave way to another door to another area. You figure you could hold your arms out and touch two adjacent walls, but decide against it. You have more important things to be worried about.".

[!<dungeon02:LabyrinthRoom>*

REQUIRES COMMENTING

*!]
Dungeon02 is a sandy labyrinth room.  The printed name of Dungeon02 is "Large Stone Room".  "The expansive stone room was easily the largest area you've seen, outside of the throne room. Your feet tap against the hardwood floors as you explore, admiring the paintings that hang on the walls surrounding you. Some are landscapes, but you encounter a few portraits of quite sexual rulers of the land from an era long past.".

[!<dungeon03:LabyrinthRoom>*

REQUIRES COMMENTING

*!]
Dungeon03 is a sandy labyrinth room.  The printed name of Dungeon03 is "Stone Cell". "In a far, dark corner of the dungeon, you find a room containing a private jail cell. The room is divided in half with metal bars, a door with an opened lock bridging the divide. Peering inside the cell, you can make out only a stone bench for the captive to lay on, and some chains on the walls to hold them in place. [if diaper quest is 0]Dark visions pass through your mind as you think of what could happen to someone stuck in this game for too long...[end if][if the flat intelligence of the player > 12][one of][line break]Examining the jail cell, you come across a strange carving under the bench. While most of the text in the dungeon is a language you don't know, there is a single word in plain English: hope. Standing up and returning to the lock, you notice that it was picked open, possibly by whoever was being held here. Maybe there's someone with the will to fight still in this world. Maybe you can find an ally.[or][stopping][end if]".  The shape of Dungeon02 is L1/0-0-0-0-1-0.

[!<dungeon04:LabyrinthRoom>*

REQUIRES COMMENTING

*!]
Dungeon04 is an untrappable labyrinth room.  The printed name of Dungeon04 is "Stone Hallway". "A long stone hallway.".

[!<dungeon05:LabyrinthRoom>*

REQUIRES COMMENTING

*!]
Dungeon05 is a sandy labyrinth room.  The printed name of Dungeon05 is "Storage Room".  "While the room probably could hold many people if it were cleaned out, it is currently anything but. Boxes, chests, and crates line the walls and are stacked haphazardly all the way up to the ceiling. Moving through the room has to be done with care, as it seems like one wrong move or one bad push against one of the towers would send the whole thing tumbling down. Still, even amongst all that, there are a few containers you can reach and open without crushing everyone inside.".  The shape of Dungeon05 is L1/0-0-0-0-1-0.

[!<dungeon06:LabyrinthRoom>*

REQUIRES COMMENTING

*!]
Dungeon06 is a mandatory important labyrinth room.  The printed name of Dungeon06 is "Prison Guard's Bedroom".  "Far away from the standard bunk rooms of the rank-and-file royal guards, you come across a private bedroom. The bed in it appears to simply be two of the lower bunks pushed together with a larger mattress place over them, but the royal banner hanging over the bed shows that whoever sleeps there is of some kind of authority.  You dare not rest in this bed, it is clearly not for you. There are a few sparse bookcases and a desk with a lamp attached to it. Against the back wall is a single ominous looking lever with a label attached to it, but to what it does you do not know.[if the flat intelligence of the player > 14 and diaper quest is 0][one of][line break]Examining the handle reveals a leather engraving of some kind of mythological beast. Running your fingers over it, you can make out the horns of an animal and the body of a man. This lever probably has something to do with the minotaur...[or][stopping]".

[!<dungeon07:LabyrinthRoom>*

REQUIRES COMMENTING

*!]
Dungeon07 is a sandy labyrinth room.  The printed name of Dungeon07 is "Poker Room".  "While many other areas of the dungeon were centred squarely in the medieval period, this room seems oddly contemporary by comparison. [one of]A green felt table in a hexagon shape sits in the centre of the room, along with many velvet chairs around it. There are chips and cards resting along the table, and a few oil lanterns hanging from the walls.[or][stopping]".

[!<dungeon08:LabyrinthRoom>*

REQUIRES COMMENTING

*!]
Dungeon08 is an important labyrinth room.  The printed name of Dungeon08 is "Training Room".  "Nestled out of the way is a room that reeks of sweat and chopped wood, giving a strange musk to the entire area. This room is probably used by guards, gladiators and the like for training when not patrolling. There are wooden dummies made out to relatively human shapes, along with a few leather targets for archery practice, though you have never seen a guard with a bow.[if the flat intelligence of the player > 8][one of][line break]Examining the tools along the wall, you can see among them crops, paddles, and bindings that don't fit in with the rest of the weight-lifting gear. A shiver runs down your spine as you imagine another kind of 'training' one could be forced through.[or][stopping][end if]".

[!<dungeon09:LabyrinthRoom>*

REQUIRES COMMENTING

*!]
Dungeon09 is a sandy labyrinth room.  The printed name of Dungeon09 is "Arena".  "While it isn't large enough to house many, the arena in the dungeons has seen plenty of use. From the slash marks and broken boards along the wooden walls of the fighting ring, it is very easy to see that the warriors who fought within it had the strength to match. There are a few crude seats around it, and the lighting is a little more complex, with wall torches for those watching and a single metal lantern suspended from the ceiling for the fighters.".

[!<dungeon10:LabyrinthRoom>*

REQUIRES COMMENTING

*!]
Dungeon10 is a pinned important untrappable labyrinth room.  The printed name of Dungeon10 is "Statue Hall".  "Descending from the throne room is a long hall flanked with statues on both sides. The beautiful bronzed decorations are of [if diaper quest is 1]naked women, their large bare bums facing towards you like some lewd display.[line break][variable custom style][end if][one of][if diaper quest is 1 and the diaper addiction of the player < 2]What does this game have to do with butts?[otherwise if diaper quest is 1 and asshole is exposed]I'm as exposed as they are![otherwise if diaper quest is 1]I wish I was allowed to keep my butt bare...[end if][roman type][line break][or][stopping][if diaper quest is 0]both men and women, each depicted in the most fantastic of physical shape. The women are extremely voluptuous and the men both well hung and quite erect. Their eyes seem to peer at you as you walk, inviting you towards their genitals...[one of][line break]The male statues seem to give the sound of liquid moving through them. Upon closer inspection, you can see that they can dispense some kind of liquid if one was desperate or thirsty enough to get curious with them.[or][stopping][end if]".  Dungeon10 is east of Dungeon11.  The shape of Dungeon10 is L1/0-0-0-1-0-1.  The grid position of Dungeon10 is  <1,13,12>.

[!<dungeon11:LabyrinthRoom>*

REQUIRES COMMENTING

*!]
Dungeon11 is a pinned important untrappable labyrinth room.  Dungeon11 is west of Dungeon10.  Dungeon11 is east of Dungeon12.  The printed name of Dungeon11 is "Throne Room".  "The throne room; the centre jewel of the kingdom. Sitting high among a series of risers and stairs is a beautiful throne, fit truly for royalty. Descending down the stairs and along the scarlet carpeting leads into another long hall, and tucked away behind a false wall is the spiral staircase back to the Royal Bedroom.[if the flat intelligence of the player > 10][one of][line break]Listening closely to the throne as you walk by it, you can detect some kind of apparatus within it. A closer look reveals little that could trigger whatever machine or magic the throne protects, other than giving the soft-cushion a sit...[or][stopping]".  The shape of Dungeon11 is L1/0-0-0-1-0-1.  The grid position of Dungeon11 is  <1,12,12>.  Dungeon11 is seen.

[!<dungeon12:LabyrinthRoom>*

REQUIRES COMMENTING

*!]
Dungeon12 is a pinned important bossed untrappable labyrinth room.  Dungeon12 is west of Dungeon11.  The printed name of Dungeon12 is "Royal Chambers".  "Tucked away out of sight from everything that prowls the dungeon, you feel safe in the pink confines of the royal chambers. Everything in the room is an eye-catching pink, from the bed to the wardrobe, and everything in-between. The lack of any windows gives the feeling of being held captive, even in such a plush room. It may be the chamber of royalty, but it is also the prison that houses you.  A pink photo frame hangs on one wall.[one of][or]  You feel safe from monsters here.[stopping]".  The shape of Dungeon12 is L1/0-0-0-1-0-0.  The grid position of Dungeon12 is  <1,11,12>.  Dungeon12 is discovered.

[!<dungeon13:LabyrinthRoom>*

REQUIRES COMMENTING

*!]
Dungeon13 is a sandy labyrinth room.  The printed name of Dungeon13 is "Armoury".  "With so many [if there is an alive gladiator]gladiators and [end if]guards wandering around, all their gear would have to be stored somewhere. Much like the other storage rooms, this area is absolutely jam packed with armour and weapons, though most of it is swords and plate-mail. Approaching any of the items brings with it a sense of unease, and all the weapons are quite firmly held in their scabbards by some unseen magical presence.".  The shape of Dungeon13 is L1/0-0-0-0-0-1.

[!<dungeon14:LabyrinthRoom>*

REQUIRES COMMENTING

*!]
Dungeon14 is a sandy labyrinth room.  The printed name of Dungeon14 is "Changing Rooms".  "The smell of the room hit you long before the sight of it did. Piles of dirty tunics and underwear sit in the corners, waiting for someone to take them to be cleaned. There is little privacy in the room, with only a few sections marked off with dividers. Even more disconcerting is the smooth tiling on the floor leading to a small drainage grate...".

[!<dungeon15:LabyrinthRoom>*

REQUIRES COMMENTING

*!]
Dungeon15 is a sandy labyrinth room.  The printed name of Dungeon15 is "Swimming Pool".  "A large ditch occupies the centre of the room, which is surrounded by a rusted metal fence on all sides. You can't be sure whether not it was used as a swimming pool, or as some sort of underground aquarium. The bottom of the basin is covered in a layer of stagnant water, just below what remains of a drainage hole on the east wall. It looks like it used to have some sort of grate attached, but it's nowhere to be seen[if bukkake fetish is 1]. In fact, the only thing that stands out in the water is an enormous eggshell, about the size of a beach ball. You don't want to know what came out of that[end if].".

[!<dungeon16:LabyrinthRoom>*

REQUIRES COMMENTING

*!]
Dungeon16 is an untrappable labyrinth room.  The printed name of Dungeon16 is "Mess Hall".  "Wooden tables and benches line this long hall, where great feasts were eaten long ago. Now the place seems quite empty, as if no one had eaten there in quite a long time. The trays are empty, with barely a dust outline of plates left upon them. It's incredibly eerie; maybe you should consider staying away from this room.".

[!<dungeon17:LabyrinthRoom>*

REQUIRES COMMENTING

*!]
Dungeon17 is a sandy labyrinth room.  The printed name of Dungeon17 is "Kitchen".  "While it wouldn't pass in the modern world, this was definitely the dungeon's kitchen. A large iron oven sits against the wall, the piping of it going into the roof and then above-ground. There are tables lined with preparatory space, so that whoever was cooking had room to get everything ready for all the guards and inhabitants. Oddly enough, you can't recall ever seeing a cook or a maid wandering the dungeon[if the bimbo of the player < 6]... the thought of where they might be sends a shiver through your whole body[end if].".

[!<dungeon18:LabyrinthRoom>*

REQUIRES COMMENTING

*!]
Dungeon18 is an important labyrinth room.  The printed name of Dungeon18 is "Pantry".  "Near the mess hall and kitchen, you find yourself in a food storage area. There are boxes and bins of produce lined up along the walls, with slabs of meat lined with salt and spices hanging from the ceiling. Appetising as they may look, it's hard to trust anything in this world, so you decide not to mess with them. Goodness knows what your body would do if you actually ate any of it.".

[!<dungeon19:LabyrinthRoom>*

REQUIRES COMMENTING

*!]
Dungeon19 is a sandy labyrinth room.  The printed name of Dungeon19 is "Toilets".  "No matter what modern commodities you were imagining, that is not the reality of the toilet room. In truth, they were little more than holes in the ground leading to some kind of underground river that has long since gone stagnant. The smell is rather unpleasant[if the player is upright]; you fear that crouching anywhere near one of those holes would flood your nostrils with the foulest of stenches[end if].".  The shape of Dungeon19 is L1/0-0-0-0-1-1.  Dungeon19 is toilets.

[!<dungeon20:LabyrinthRoom>*

REQUIRES COMMENTING

*!]
Dungeon20 is an untrappable labyrinth room.  The printed name of Dungeon20 is "Stone Corridor".  "Winding around one of the corners of the dungeon, you keep walking through the low-ceiling corridors of the dungeon. It's difficult to tell how deep underground you are, with the air hanging still as you explore. A breath of fresh air would truly be a breath of fresh air right about now...".

[!<dungeon21:LabyrinthRoom>*

REQUIRES COMMENTING

*!]
Dungeon21 is an untrappable labyrinth room.  The printed name of Dungeon21 is "Stone Corridor".  "The long cobblestone halls that criss-cross the dungeon seem to go on for miles in every direction. The lanterns attached to the walls cast elongated and distorted shadows, making it difficult to tell how far any of the hallways lead before coming up to wall until you're already there. ".

[!<dungeon22:LabyrinthRoom>*

REQUIRES COMMENTING

*!]
Dungeon22 is a sandy labyrinth room.  The printed name of Dungeon22 is "Bunk Room".  "The tucked away room is longer than it is tall and filled to the brim with rows of bunk beds, each one with a footlocker sitting before it. It's almost military in nature, and put together with extreme precision. This is where the guards rest and congregate when they aren't prowling the dungeon, and there are a few signs of the area being inhabited by people. A few stray articles of clothes by one or a journal sitting on top of a footlocker reminds you that the guards do have their own personalities and are their own people, even if they do all take the [']hands-on['] approach.".  The shape of Dungeon22 is L1/0-0-0-0-0-1.

[!<dungeon23:LabyrinthRoom>*

REQUIRES COMMENTING

*!]
Dungeon23 is a sandy labyrinth room.  The printed name of Dungeon23 is "Bunk Room".  "The tucked away room is longer than it is tall and filled to the brim with rows of bunk beds, each one with a footlocker sitting before it. It's almost military in nature, and put together with extreme precision. This is where the guards rest and congregate when they aren't prowling the dungeon, and there are a few signs of the area being inhabited by people. A few stray articles of clothes by one or a journal sitting on top of a footlocker reminds you that the guards do have their own personalities and are their own people, even if they do all take the [']hands-on['] approach.". The shape of Dungeon23 is L1/0-0-0-0-1-0.

[!<dungeon24:LabyrinthRoom>*

REQUIRES COMMENTING

*!]
Dungeon24 is a sandy labyrinth room.  The printed name of Dungeon24 is "Bunk Room".  "The tucked away room is longer than it is tall and filled to the brim with rows of bunk beds, each one with a footlocker sitting before it. It's almost military in nature, and put together with extreme precision. This is where the guards rest and congregate when they aren't prowling the dungeon, and there are a few signs of the area being inhabited by people. A few stray articles of clothes by one or a journal sitting on top of a footlocker reminds you that the guards do have their own personalities and are their own people, even if they do all take the [']hands-on['] approach.". The shape of Dungeon24 is L1/0-0-0-0-0-1.

[!<dungeon25:LabyrinthRoom>*

REQUIRES COMMENTING

*!]
Dungeon25 is a sandy labyrinth room.  The printed name of Dungeon25 is "Bunk Room".  "The tucked away room is longer than it is tall and filled to the brim with rows of bunk beds, each one with a footlocker sitting before it. It's almost military in nature, and put together with extreme precision. This is where the guards rest and congregate when they aren't prowling the dungeon, and there are a few signs of the area being inhabited by people. A few stray articles of clothes by one or a journal sitting on top of a footlocker reminds you that the guards do have their own personalities and are their own people, even if they do all take the [']hands-on['] approach.". The shape of Dungeon25 is L1/0-0-1-0-0-0.

[!<dungeon27:LabyrinthRoom>*

REQUIRES COMMENTING

*!]
Dungeon27 is a sandy labyrinth room.  The printed name of Dungeon27 is "Library".  "Providing a small commodity to the otherwise dull area, you encounter a rather quaint library. Books line the walls and a few sparse shelves divide the room up into a few reading areas. A few lamps rest along the area, either hanging from the ceiling or sitting atop a few desks scattered among the tomes. Sadly, admiring the spines of the reading material reveals it to be in an unknown language. ".

[!<dungeon28:LabyrinthRoom>*

REQUIRES COMMENTING

*!]
Dungeon28 is a mandatory important labyrinth room.  The printed name of Dungeon28 is "Altar Room".  "The sounds of the dungeon seem to fade away as you enter the hallowed room, the air standing still as you approach the rectangular stone altar. There is no light in the room, other than a circular glass window letting in outside light directly above it. The light draws you closer to the altar, inviting you to test its power...[if the flat intelligence of the player > 10][one of][line break]Looking along the floor, you notice some kind of engraving surrounding the altar. It's not in any language you can understand, but there appears to be some numbers you can make out. While the words around it are shrouded in a different language, you make out a 300 and a 120...[or][stopping][end if]".  The shape of Dungeon28 is L1/0-0-1-0-0-0.

[!<dungeon29:LabyrinthRoom>*

REQUIRES COMMENTING

*!]
Dungeon29 is a sandy labyrinth room.  The printed name of Dungeon29 is "Tool Room".  "This room is filled with [if the bimbo of the player > 10]grown-up[otherwise]heavy[end if] tools.  Better leave them alone.".  The shape of Dungeon29 is L1/0-0-1-0-0-0.

[!<dungeon30:LabyrinthRoom>*

REQUIRES COMMENTING

*!]
Dungeon30 is an important labyrinth room.  The printed name of Dungeon30 is "Chambermaid's Room".  "With a dungeon so large and the work so messy, someone has to look after the facility. Whoever does would probably sleep in here; you say would because there doesn't appear to be anyone staying there. Along the walls are cleaning tools and bottles of chemicals kept in little bottles. There are clean sheets, fresh cups, and everything on hand, just waiting for someone to put them all in their proper places around the dungeon.".  The shape of Dungeon30 is L1/0-0-1-1-0-0.

[!<dungeon31:LabyrinthRoom>*

REQUIRES COMMENTING

*!]
Dungeon31 is a sandy labyrinth room.  The printed name of Dungeon31 is "[if diaper quest is 1]Theatre[otherwise]Brothel[end if]".  "[if diaper quest is 0]If walls could talk, these ones would moan. You can practically smell the events that took place in here by walking around, admiring the secluded tables, dim lighting, and small stage. There is a podium up there, hinting that the guards might have bid on who they were taking back that night[otherwise]A bunch of tables and seats are dispersed amongst this room, that has a raised stage in one corner.  The background of the stage is decorated with flowery and animal motifs like you might expect in a nursery, which makes it self-evident the type of 'productions' this theatre probably shows[end if]. [if the bimbo of the player > 13][second custom style]Looks like people had fun in this room![roman type][line break][otherwise if diaper quest is 1]There's a gap between the background and the stage that you won't be able to see down without getting up onto the stage.[otherwise]A chill runs down your spine at the thought of being brought up to that podium in chains...[end if]".

[!<dungeon32:LabyrinthRoom>*

REQUIRES COMMENTING

*!]
Dungeon32 is a pinned untrappable labyrinth room.  The printed name of Dungeon32 is "Stone Hallway".  "[one of]Upon descending the stairs in the statue hall, the long cobblestone corridors of the dungeon sprawl out in all directions. [or][stopping]Heavy iron lanterns stand motionless above you, casting long shadows as you venture into the complex of rooms and further away from the safety of the bedroom.".  Dungeon32 is east of Dungeon10.  Dungeon10 is west of Dungeon32.  The grid position of Dungeon32 is  <1,14,12>.

[!<dungeon33:LabyrinthRoom>*

REQUIRES COMMENTING

*!]
Dungeon33 is a sandy labyrinth room.  The printed name of Dungeon33 is "Ritual room".  "Entering the room, you are immediately beset by a feeling of dread as you scout the dark room. Dim torches illuminate what appears to be a small room, the heavy iron lock that kept it shut having long since rusted away. Inside there is a softly glowing pentagram, with a set of candles congregated along the points of the star. Whatever ritual here has been long past, but the effects could still be felt.[if the flat intelligence of the player > 8][one of][line break]Along the walls you can make out some kind of pairing of scratch marks and what appear to be heel-prints, as if indicating that something climbed up. Following their path, you can see an area of loose rocks, pulled away to let whatever was in here escape to the surrounding areas...[or][stopping]".  The shape of Dungeon33 is L1/0-0-0-1-0-1.

[!<dungeon34:LabyrinthRoom>*

REQUIRES COMMENTING

*!]
Dungeon34 is an important labyrinth room.  The printed name of Dungeon34 is "[if diaper quest is 1]Toy room[otherwise]Catacombs[end if]".  "[if diaper quest is 1]The walls of this room are lined with stuffed toys protected behind impenetrable glass cases.[otherwise]A chill runs down your spine as you enter the catacombs of the dungeon's royalty. Each body is laid to rest in a beautifully crafted casket, the lid engraved to depict who was within it during their life. Men and women of extreme beauty and endowment, clad in the most extravagant of garb and lingerie, resting in serene peace within their castle.[end if]".  The shape of Dungeon34 is L1/0-0-0-1-0-1.

[!<dungeon35:LabyrinthRoom>*

REQUIRES COMMENTING

*!]
Dungeon35 is a mandatory labyrinth room.  The printed name of Dungeon35 is "Underground Lake".  "Stepping through the archway, you discover to your awe and amusement an underground lake. It is quite expansive, flowing into various other caves beyond your view. In the distance, you wonder if you can vaguely make out some kind of outlet leading to the outside world, though swimming is out of the question.[if the flat intelligence of the player > 11 and bukkake fetish is 1][one of][line break]Examining the currents and ripples in the water, you deduce that something large inhabits the pond. While it may not stir from your movements, there is the chance that whatever it is will awaken if you enter.[or][stopping][end if]".  The shape of Dungeon35 is L1/0-0-0-0-1-1.  The first forbidden direction of Dungeon35 is north.  The second forbidden direction of Dungeon35 is east.

[!<dungeon36:LabyrinthRoom>*

REQUIRES COMMENTING

*!]
Dungeon36 is a mandatory sandy labyrinth room.  The printed name of Dungeon36 is "Cage Room".  "The room is massive and complex, making it one of the few areas you've seen of the dungeon that required some level of craftsmanship. In the centre of the room is a large cage made of extremely heavy metal, built in a bell-shape. It is suspended by a tough-looking chain that keeps the entire contraption about eighteen inches off the ground. [if there is an alive captive dungeon boss and the flat intelligence of the player > 7]The beast contained within can see and look around with ease, capable of swinging itself a few inches in any direction if it feels provoked, but unable to inflict any real harm.  Looking up at the chain that keeps the cage suspended, you notice that it doesn't appear to coordinate to any device or lever in the room. To lower the monster and open the cage, you'd need to find something elsewhere.[otherwise if a random minotaur is an alive captive monster]The beast contained within can see and look around with ease, capable of swinging itself a few inches in any direction if it feels provoked, but unable to inflict any real harm.[otherwise]The cage is open and empty.[end if][if there is a mystical amulet in Dungeon36][line break]In the middle of the cage, you can see a valuable looking amulet.[end if]". The semen-puddle of Dungeon36 is usually 2. [He's a messy guy.]

[!<TheNoMinotaurSemenInDQRule>+

REQUIRES COMMENTING

+!]
This is the no minotaur semen in DQ rule:
	now the semen-puddle of Dungeon36 is 0.
The no minotaur semen in DQ rule is listed in the diaper quest fix rules.

[!<dungeon37:LabyrinthRoom>*

REQUIRES COMMENTING

*!]
Dungeon37 is a sandy mandatory labyrinth room.  The printed name of Dungeon37 is "Apothecary".  "In a dark corner of the dungeon, you stumble across a dimly lit room filled with hand-crafted posters lining the walls, each one bearing some kind of marking upon it. In the centre is an alchemist's table with a large clay bowl that emits a soft glow, inviting anyone who dares the art of alchemy to attempt to [bold type]craft something[roman type] upon it.".

[!<dungeon38:LabyrinthRoom>*

REQUIRES COMMENTING

*!]
Dungeon38 is a sandy labyrinth room.  The printed name of Dungeon38 is "Chapel".  "The high, vaulted ceiling of the chapel welcomes you as you push past the heavy wooden doors. Inside are rows of wooden pews leading up towards a small stage, flanked on both sides by stained glass windows. [if diaper quest is 1]Rather than religious iconography, the images depicted all seem to centre around the changing of diapers...[otherwise]Many of the images depicted are quite lewd, with very little religious imagery visible in the area. Whatever is worshipped here might be found in the body more than the spirit...[end if]".

[!<dungeon39:LabyrinthRoom>*

REQUIRES COMMENTING

*!]
Dungeon39 is a sandy labyrinth room.  The printed name of Dungeon39 is "Healer's Room".  "It wasn't much, but you can faintly make out this room as some kind of doctor's or medicine man's room. There are cabinets lined with various herbal remedies and a long table one could lie down on along the side of the room. Candles light the area, giving a very cosy, intimate feel to the entire area... or maybe just that no one had used the room in quite a while.".

[!<dungeon40:LabyrinthRoom>*

REQUIRES COMMENTING

*!]
Dungeon40 is a sandy labyrinth room.  The printed name of Dungeon40 is "Circular Stone Room".  "While the other rooms you've passed through in the dungeon have proven to be of a fairly rudimentary rectangular shape, this single room has a circular design. It wouldn't be noteworthy if it weren't for the strange change from the norm that it brought. Examining the area, you look up at the domed ceiling to make out a portrait of female angels circling overhead, looking down at you as you pass through.[if the flat intelligence of the player > 7][one of][line break]Upon closer examination, you recognize the angels as the Nintendolls employees that locked you in this simulation. The reminder of your captivity doesn't sit easy with you as you press on.[or][stopping]".

[!<dungeon41:LabyrinthRoom>*

REQUIRES COMMENTING

*!]
Dungeon41 is a mandatory untrappable labyrinth room.  The printed name of Dungeon41 is "Dungeon Shop".  "The shop you emerge in would fit into nearly any fantasy RPG, with lines of products sitting on wooden shelves, and with their prices neatly stencilled onto wooden plaques sitting beneath them. All manner of goods are sold here, all at the behest of the massive shopkeeper.".  The shape of Dungeon41 is L1/0-0-0-0-1-0.

[!<dungeon42:LabyrinthRoom>*

REQUIRES COMMENTING

*!]
Dungeon42 is a sandy mandatory labyrinth room.  The printed name of Dungeon42 is "[if there is a warp portal in Dungeon42]Dungeon Portal Room[otherwise]Empty Room[end if]".  "[if there is a warp portal in Dungeon42]This room has a swirling green portal in the north wall that leads to the Hotel.[otherwise]This room has a bizarre closed metal shutter in the north wall.  It doesn't look like you can do anything with it at the moment, but maybe later it will have opened.[end if]".  The shape of Dungeon42 is L1/0-0-0-1-1-1.

[!<dungeonScenery02:Scenery>*

REQUIRES COMMENTING

*!]
DungeonScenery02 is scenery.  DungeonScenery02 is in Dungeon15.  The printed name of DungeonScenery02 is "Ditch".  The description of DungeonScenery02 is "There is a large ditch here, which looks like it once held water for people to swim in.  [one of]It's completely empty now though.[or]There's no point going in there.[stopping]".  Understand "swimming","pool","swimming pool", "ditch" as DungeonScenery02.  Instead of entering DungeonScenery02, say "There's nothing interesting down there.".

[!<dungeonScenery03:Scenery>*

REQUIRES COMMENTING

*!]
DungeonScenery03 is scenery.  DungeonScenery03 is in Dungeon35.  The printed name of DungeonScenery03 is "Lake".  The description of DungeonScenery03 is  usually "[LakeDesc]". Understand "lake", "underground", "underground lake", "water", "pool", "sea" as DungeonScenery03.

[!<SayLakeDesc>+

REQUIRES COMMENTING

+!]
To say LakeDesc:
	let L be a random lake monster;
	let S be the semen-sniffing of L;
	if L is not in the location of the player, now S is 0;
	say "A large underground lake, spanning as far as you can see. [if S < 200]The waters are calm, and you can see deep into the dark abyss underneath the surface.[otherwise if S < 400]The water is calm, although a tiny wave occasionally travels across the surface.[otherwise if S < 800]Tiny waves move frequently over the surface, seeming to emanate from some place far offshore.[otherwise if L is not in the location of the player]Tiny waves move across the surface in a subtle rhythm, emanating from some place far offshore.[otherwise]The surface is choppy, and the tentacles appear to be in the center of the waves.[end if]".

[!<dungeonScenery04:Scenery>*

REQUIRES COMMENTING

*!]
DungeonScenery04 is scenery.  DungeonScenery04 is in Dungeon36.  The printed name of DungeonScenery04 is "Cage".  The description of DungeonScenery04 is "A large metal cage.  [if there is an alive captive dungeon boss]The entrance to the cage is locked, and appears to be opened by an automatic mechanism.  Inside there is an angry looking monster.  He snarls at you.[otherwise]The cage is open and empty.[end if]".  Understand "cage", "prison" as DungeonScenery04.

[!<dungeonScenery05:Scenery>*

REQUIRES COMMENTING

*!]
DungeonScenery05 is scenery.  DungeonScenery05 is in Dungeon12.  The printed name of DungeonScenery05 is "Photo".  The description of DungeonScenery05 is "[if the faint count of the player is 0]A pink photo frame.  There is currently no picture in the frame.[otherwise]The photo within the pink frame shows you[RealDesc][end if]".  Understand "photo", "picture", "frame" as DungeonScenery05.

[!<dungeonScenery06:Thing>*

REQUIRES COMMENTING

*!]
DungeonScenery06 is a thing.  DungeonScenery06 is in Dungeon06.  DungeonScenery06 is not portable.  The printed name of DungeonScenery06 is "[TQlink of item described]lever[TQxlink of item described][verb-desc of item described]".  The description of DungeonScenery06 is "Whatever pulling this lever does, it can't be good.".  Understand "lever" as DungeonScenery06.  The text-shortcut of DungeonScenery06 is "lv".

[!<DungeonScenery06IsImmuneToChange>+

REQUIRES COMMENTING

+!]
Definition: DungeonScenery06 is immune to change:
	decide yes.

[!<CheckPullingDungeonScenery06>+

REQUIRES COMMENTING

+!]
Check pulling DungeonScenery06:
	try turning the noun instead.

[!<CheckTurningDungeonScenery06>+

REQUIRES COMMENTING

+!]
Check turning DungeonScenery06:
	let M be a random alive captive dungeon boss;
	now seconds is 2;
	if M is not monster, say "Nothing seems to happen." instead;
	now M is released;
	say "You hear a mechanism whirring, and what sounds like a metal door swing open." instead.

[!<CheckPushingDungeonScenery06>+

REQUIRES COMMENTING

+!]
Check pushing DungeonScenery06:
	try turning the noun instead.

[!<SayRealDesc>+

REQUIRES COMMENTING

+!]
To say RealDesc:
	say "inside a metal chamber filled with a transparent liquid.  You are motionless and have your eyes closed.  You have straight black [RealHairDesc], [RealBreastDesc] and what look like [RealHipDesc].  [RealGapeDesc].".

[!<stairwell01:LabyrinthRoom>*

REQUIRES COMMENTING

*!]
Stairwell01 is a mandatory labyrinth room.  The printed name of Stairwell01 is "Stone Stairwell".  [Stairwell01 is east of Dungeon02.]  "Before you even emerge in the room, you can feel that it is different. The air is lighter and there is natural lighting; could it be a way out? Sure enough, you discover a stone staircase leading up and out of the dungeon to whatever wonders and wilderness await you above the dungeon complex.".  The shape of Stairwell01 is L1/1-0-1-1-1-1.

[!<dungeon:Region>*

REQUIRES COMMENTING

*!]
The Dungeon is a region.  Dungeon01, Dungeon02, Dungeon03, Dungeon04, Dungeon05, Dungeon06, Dungeon07, Dungeon08, Dungeon09, Dungeon10, Dungeon11, Dungeon12, Dungeon13, Dungeon14, Dungeon15, Dungeon16, Dungeon17, Dungeon18, Dungeon19, Dungeon20, Dungeon21, Dungeon22, Dungeon23, Dungeon24, Dungeon25, [Dungeon26,] Dungeon27, Dungeon28, Dungeon29, Dungeon30, Dungeon31, Dungeon32, Dungeon33, Dungeon34, Dungeon35, Dungeon36, Dungeon37, Dungeon38, Dungeon39, Dungeon40, Dungeon41, Dungeon42, Stairwell01 are in The Dungeon.


Dungeon ends here.
