Woods by Rooms begins here.


[!<JungleRoom>@

REQUIRES COMMENTING

@inherits <Room>

@!]
A jungle room is a kind of room. A jungle room has a labyrinth shape called shape. The shape of a jungle room is usually L2/0-0-1-1-1-1. The grid position of a jungle room is usually <0,0,0>. A jungle room is usually no-roof.


[!<woods01:JungleRoom>*

REQUIRES COMMENTING

*!]
Woods01 is a pinned unspawnable untrappable jungle room. Woods01 is above Stairwell01. The printed name of Woods01 is "Dungeon Entrance". "You are in a clearing in [if the bimbo of the player > 8]a scary looking[otherwise]some[end if] woods. An open trap door reveals a stairwell downwards back into the dungeons.". Stairwell01 is below Woods01. The shape of Woods01 is L2/0-0-1-1-1-1.

[!<woods02:JungleRoom>*

REQUIRES COMMENTING

*!]
Woods02 is a dodgy jungle room. The printed name of Woods02 is "Winding Pathway". "You are on a winding concrete pathway through the woods.". The shape of Woods02 is L2/0-0-1-0-1-0.

[!<woods03:JungleRoom>*

REQUIRES COMMENTING

*!]
Woods03 is an important jungle room. The printed name of Woods03 is "Dead End". "Thick foliage surrounds all directions except back the way you came.". The shape of Woods03 is L2/0-0-1-0-0-0.

[!<woods04:JungleRoom>*

REQUIRES COMMENTING

*!]
Woods04 is a dodgy jungle room. The printed name of Woods04 is "Twisting Pathway". "You are on a twisting dirt pathway through the woods.". The shape of Woods04 is L2/0-0-1-1-0-0.

[!<woods05:JungleRoom>*

REQUIRES COMMENTING

*!]
Woods05 is a mandatory important jungle room. The printed name of Woods05 is "Waterfall Clearing". "A beautiful clearing with a cliff above a pool of water. A steady stream of water is falling down into the plunge pool from the top of the cliff.". The shape of Woods05 is L2/0-0-0-1-0-0. The first forbidden direction of Woods05 is west.

[!<woods06:JungleRoom>*

REQUIRES COMMENTING

*!]
Woods06 is a dodgy jungle room. The printed name of Woods06 is "Grassy Clearing". "This clearing is mostly covered in short grass.". The shape of Woods06 is L2/0-0-1-1-1-1.

[!<woods07:JungleRoom>*

REQUIRES COMMENTING

*!]
Woods07 is a jungle room. The printed name of Woods07 is "Empty Clearing". "This clearing in the woods is mostly bare.". The shape of Woods07 is L2/0-0-1-1-1-1.

[!<woods08:JungleRoom>*

REQUIRES COMMENTING

*!]
Woods08 is a dodgy jungle room. The printed name of Woods08 is "Muddy Clearing". "This clearing is mostly covered in dry mud and dirt.". The shape of Woods08 is L2/0-0-1-1-1-1.

[!<woods09:JungleRoom>*

REQUIRES COMMENTING

*!]
Woods09 is a dodgy jungle room. The printed name of Woods09 is "Stone Clearing". "This clearing seems to be man-made, as it is paved in stone.". The shape of Woods09 is L2/0-0-1-1-1-1.

[!<woods10:JungleRoom>*

REQUIRES COMMENTING

*!]
Woods10 is a dodgy jungle room. The printed name of Woods10 is "Statue Clearing". "Right in the middle of this clearing is a [if diaper quest is 1]fountain of a peeing woman[otherwise]statue of a man and woman having sex[end if]. [if a random vine boss is off-stage]The grass and trees here seems especially lush and vibrant.[otherwise]Thick green vines are draped over the man's shoulders, giving him the appearance of having a cape.[end if]". The shape of Woods10 is L2/0-0-1-1-1-1.

[!<woods11:JungleRoom>*

REQUIRES COMMENTING

*!]
Woods11 is a dodgy jungle room. The printed name of Woods11 is "Creepy Pathway". "The trees either side of this pathway look like they have faces and arms. It's almost as if they're alive...". The shape of Woods11 is L2/0-0-0-1-1-0.

[!<woods12:JungleRoom>*

REQUIRES COMMENTING

*!]
Woods12 is a dodgy jungle room. The printed name of Woods12 is "Deep Woods". "The trees are particularly large and close together in this part of the woods.". The shape of Woods12 is L2/0-0-1-1-1-1.

[!<woods13:JungleRoom>*

REQUIRES COMMENTING

*!]
Woods13 is a dodgy jungle room. The printed name of Woods13 is "Deep Woods". "The trees are particularly large and close together in this part of the woods.". The shape of Woods13 is L2/0-0-1-1-1-1.

[!<woods14:JungleRoom>*

REQUIRES COMMENTING

*!]
Woods14 is a dodgy jungle room. The printed name of Woods14 is "Deep Woods". "The trees are particularly large and close together in this part of the woods.". The shape of Woods14 is L2/0-0-1-1-1-1.

[!<woods15:JungleRoom>*

REQUIRES COMMENTING

*!]
Woods15 is a dodgy jungle room. The printed name of Woods15 is "Deep Woods". "The trees are particularly large and close together in this part of the woods.". The shape of Woods15 is L2/0-0-1-1-1-1.

[!<woods16:JungleRoom>*

REQUIRES COMMENTING

*!]
Woods16 is a mandatory jungle room. The printed name of Woods16 is "Hole in the Ground". "There appears to be a hole in the ground here. You could climb down it, but something tells you it is extremely dangerous.". The shape of Woods16 is L2/0-0-1-1-1-1.

[!<woods17:JungleRoom>*

REQUIRES COMMENTING

*!]
Woods17 is an important jungle room. The printed name of Woods17 is "Dark Area". "The trees are so tall and thick in this part of the woods that they mostly block out the sun.". The shape of Woods17 is L2/0-0-0-1-0-0.

[!<woods18:JungleRoom>*

REQUIRES COMMENTING

*!]
Woods18 is a dodgy jungle room. The printed name of Woods18 is "Pine Clearing". "For some reason, all the trees around the edge of this clearing are pine trees.". The shape of Woods18 is L2/0-0-0-0-1-0.

[!<woods19:JungleRoom>*

REQUIRES COMMENTING

*!]
Woods19 is a dodgy jungle room. The printed name of Woods19 is "Oak Clearing". "For some reason, all the trees around the edge of this clearing are oak trees.". The shape of Woods19 is L2/0-0-0-0-0-1.

[!<woods20:JungleRoom>*

REQUIRES COMMENTING

*!]
Woods20 is a mandatory important jungle room. The printed name of Woods20 is "Witch's Shack". "In the middle of another clearing, a small open air shack stands, sheltering a peculiar stone pillar.". The shape of Woods20 is L2/0-0-1-1-1-1.

[!<woods21:JungleRoom>*

REQUIRES COMMENTING

*!]
Woods21 is a mandatory important jungle room. The printed name of Woods21 is "Mysterious White Wall". "At the other end of this area, is a white wall with a very unique statue of the bottom half of a human stuck through it. A ladder leads up to a huge hole in the statue which it looks like you could peek through.". The shape of Woods21 is L2/0-0-1-0-0-0. The first forbidden direction of Woods21 is south.

[!<woods22:JungleRoom>*

REQUIRES COMMENTING

*!]
Woods22 is a dodgy jungle room. The printed name of Woods22 is "Shallow Woods". "The trees are particularly thin in this part of the woods.". The shape of Woods22 is L2/0-0-0-1-1-1.

[!<woods23:JungleRoom>*

REQUIRES COMMENTING

*!]
Woods23 is a dodgy jungle room. The printed name of Woods23 is "Shallow Woods". "The trees are particularly thin in this part of the woods.". The shape of Woods23 is L2/0-0-1-0-1-1.

[!<woods24:JungleRoom>*

REQUIRES COMMENTING

*!]
Woods24 is a dodgy jungle room. The printed name of Woods24 is "Shallow Woods". "The trees are particularly thin in this part of the woods.". The shape of Woods24 is L2/0-0-1-1-0-1.

[!<woods25:JungleRoom>*

REQUIRES COMMENTING

*!]
Woods25 is a dodgy jungle room. The printed name of Woods25 is "Shallow Woods". "The trees are particularly thin in this part of the woods.". The shape of Woods25 is L2/0-0-1-1-1-0.

[!<woods26:JungleRoom>*

REQUIRES COMMENTING

*!]
Woods26 is an important mandatory jungle room. The printed name of Woods26 is "Sword in the Stone". "A stone [if diaper quest is 1]slab in the centre of this clearing has a giant rattle embedded in it. Surely t[otherwise if (the player is female and the virgin of the player is 1) or (tg fetish >= 1 and the player is male)]slab in the centre of this clearing has a shining sword stuck in it. T[otherwise]statue in the center of this clearing has a floppy dildo sticking out of it. It doesn't look useful for anything, but t[end if]here's probably no harm in seeing if you can pull it out.". The shape of Woods26 is L2/0-0-1-1-1-1. 

[!<woods27:JungleRoom>*

REQUIRES COMMENTING

*!]
Woods27 is a dodgy jungle room. The printed name of Woods27 is "The Well". "[if a random vine boss is off-stage]An overgrown clearing with a brick well surrounded by four stone statues in the center. Each statue is intricately carved, all depicting a blissfully masturbating nude woman.[otherwise]An overgrown clearing with a dilapidated brick well in the center. It is surrounded by four pillars of varying height, all completely encased with solid vine.[end if]".

[!<woods28:JungleRoom>*

REQUIRES COMMENTING

*!]
Woods28 is a dodgy jungle room. The printed name of Woods28 is "Abandoned Nest". "A small clearing, hidden underneath a dense canopy of trees. Broken eggs are strewn across the area, all brown and no smaller than a football. [line break][variable custom style][if egg laying fetish is 0]Looks like whatever was here is long gone now.[otherwise]You can't help the feeling that whatever came out of those eggs...is still here.[end if][roman type][line break]". The shape of Woods28 is L2/0-0-0-1-0-0. 

[!<woods29:JungleRoom>*

REQUIRES COMMENTING

*!]
Woods29 is a mandatory jungle room. The printed name of Woods29 is "Pumpkin Patch". "A patch of wild pumpkins, growing on the edges of a small clearing.". [The grid position of Woods29 is <?,?,?>.]

[!<woods30:JungleRoom>*

REQUIRES COMMENTING

*!]
Woods30 is a mandatory dodgy jungle room. The printed name of Woods30 is "Giant Statue". "There is an enormous statue of a naked woman [if doomed is 5]laying in the center of this clearing. Green vines are wrapped around her body, as if holding her down for the massive, sickly purple creepers plugging her holes.[otherwise if a random vine boss is off-stage]kneeling in the center of this clearing.[otherwise]on all fours in the center of this clearing. Massive green vines are crammed into her mouth and wrapped around her wrists and ankles.[end if]". The shape of Woods30 is L2/0-0-0-1-0-1.

[!<stairway03:JungleRoom>*

REQUIRES COMMENTING

*!]
Stairwell03 is a mandatory untrappable jungle room. The printed name of Stairwell03 is "Spooky Mansion". "An imposing mansion, which rests at just the right angle to be completely hidden from the rest of the woods unless you're standing on the crude path leading up to the front stoop.". The shape of Stairwell03 is L2/0-0-0-0-1-0. [Stairwell03 is north of Woods29. The grid position of Stairwell03 is <?,?,?>]

[!<stairway02:JungleRoom>*

REQUIRES COMMENTING

*!]
Stairwell02 is a mandatory untrappable jungle room. The printed name of Stairwell02 is "Hotel Rear Entrance". "An entrance to what appears to be a hotel seems very out of place embedded in a cliff face. Stairs lead up to the doors; a sign above them says 'Hotel Premier Sinn - Backdoor Entrance'.[one of]  [if the bimbo of the player < 9 and diaper quest is 0][line break][first custom style]Oh look, another anal sex pun. This is getting old fast.[otherwise if the bimbo of the player < 9][first custom style]Is that supposed to be another butthole pun?  This is getting old fast.[otherwise][line break][second custom style]*Snigger* Backdoor entrance...[end if][roman type][line break][or][stopping]". The shape of Stairwell02 is L2/0-0-0-1-0-0. The first forbidden direction of Stairwell02 is west.

[!<woodsBoss01:Room>*

REQUIRES COMMENTING

*!]
WoodsBoss01 is a room. The printed name of WoodsBoss01 is "Underground Chamber". "This appears to be the home of the body of the monster controlling the vines.". WoodsBoss01 is below Woods16.

[!<sky01:Room>*

REQUIRES COMMENTING

*!]
Sky01 is a room. The printed name of Sky01 is "Up in the Sky". "You can see all of the Woods from up here!".

[Selkie wonders: what happens if you add a new room here, but forget to add it to the statement: "The Woods is a region. Woods01,..., Woods30, Stairwell02 are in The Woods."  Bad things?  If so: remember to adjust that definition, if you add new rooms here. Like uncommenting "Stairwell03"...]

[!<woodsScenery01:Scenery>*

REQUIRES COMMENTING

*!]
WoodsScenery01 is scenery. WoodsScenery01 is in Woods05. The printed name of WoodsScenery01 is "Waterfall". The description of WoodsScenery01 is "A clear waterfall[one of].[or] that you could use as a shower.[stopping]". Understand "waterfall", "pool", "water", "fall" as WoodsScenery01. Instead of entering WoodsScenery01, try showering WoodsScenery01.

[!<woodsScenery04:Scenery>*

REQUIRES COMMENTING

*!]
WoodsScenery04 is a scenery. WoodsScenery04 is in Woods27. The description of WoodsScenery04 is "A dilapidated brick well.". Understand "well", "brick", "wishing well" as WoodsScenery04.

The block climbing rule is not listed in the check climbing rulebook.

[!<CheckDrinkingWoodsScenery03>+

REQUIRES COMMENTING

+!]
Check drinking WoodsScenery03:
	try climbing the noun instead.

[!<CheckClimbingSomething>+

REQUIRES COMMENTING

+!]
Check climbing something:
	if the noun is not WoodsScenery03, say "How would that work?" instead;
	if the player is prone, say "You need to be standing up to climb a ladder." instead;
	if the player is ankle bound, say "You can't climb the ladder with your ankles bound." instead;
	if the player is immobile, say "Aren't you a bit busy?" instead.

[!<CarryOutClimbingWoodsScenery03>+

REQUIRES COMMENTING

+!]
Carry out climbing WoodsScenery03:
	if the uses of WoodsScenery03 is 0, say "You've already seen what's through there, no need to look again." instead;
	say "You climb the ladder and put your face through the statue's hole.[line break]";
	let R be a random number between 1 and 3 - (diaper quest + ungape);
	if R is 1:
		say "You can't believe what you see - beyond the wall is a beautiful green field meadow, with the sun shining onto a glittering lake. Fluffy rabbits roam the grass and graceful swans drift freely on the lake. You desire for nothing more than to find a way to the other side of the wall. The sight is so uplifting that you feel more wholesome inside.";
		SemenAddictDown 2;
		IntUp 1;
		Dignify 5000;
	if R is 3:
		say "The statue appears to continue on the other side of the wall - you can't see what's inside.[if the openness of asshole < 10][line break]While your head is in the statue's asshole, you feel your own sphincter suddenly stretch![end if]";
		gape asshole times 5;
	if R is 2:
		say "The statue appears to continue on the other side of the wall - the belly of the statue is filled with [if diaper quest is 0][semen][otherwise if diaper lover >= 4 and there are worn knickers]food[otherwise]water[end if]![if the largeness of belly < 10][line break]While your head is in there, you feel your own belly suddenly fill from the inside![end if]";
		if diaper quest is 1:
			if diaper lover >= 4 and there are worn knickers:
				increase rectum by 12;
			otherwise:
				increase the water volume of belly by belly limit - the total fill of belly;
		otherwise:
			AssFill 8;
	decrease the uses of WoodsScenery03 by 1.


[!<woods:Region>*

REQUIRES COMMENTING

*!]
The Woods is a region. Woods01, Woods02, Woods03, Woods04, Woods05, Woods06, Woods07, Woods08, Woods09, Woods10, Woods11, Woods12, Woods13, Woods14, Woods15, Woods16, Woods17, Woods18, Woods19, Woods20, Woods21, Woods22, Woods23, Woods24, Woods25, Woods26, Woods27, Woods28, Woods29, Woods30, Stairwell02, Stairwell03 are in The Woods.


Woods ends here.

