Gape Gloves by Equippables begins here.

gape-gloves is a gloves. gape-gloves is unique. gape-gloves is glued. gape-gloves is latex. gape-gloves is anal-sex-addiction-influencing. Understand "gape", "gloves" as gape-gloves.
The printed name of gape-gloves is "[clothing-title-before]pair of latex gape gloves[clothing-title-after]". Figure of gape-gloves is the file "Items/Accessories/Equippables/gloves1.jpg". The text-shortcut of gape-gloves is "ggl".
To decide which figure-name is clothing-image of (C - gape-gloves):
	decide on figure of gape-gloves.

To decide which number is the initial outrage of (C - gape-gloves):
	if C is wrist-bound-behind, decide on 20;
	decide on 1.

To decide which number is the damage improvement of (W - gape-gloves):
	decide on 0.

Definition: gape-gloves is anal sex themed: decide yes.
Definition: gape-gloves is white themed: decide yes.

To say ShortDesc of (W - gape-gloves):
	say "gloves".

To say MediumDesc of (W - gape-gloves):
	say "latex gape gloves".

To say ClothingDesc of (W - gape-gloves):
	say "A pair of white skintight latex gloves.";
	if W is wrist-bound-behind and W is worn, say "You are completely unable to remove these from their location on your [AssDesc], two fingers from each hand holding your butthole wide open at all times.".

This is the gape gloves prevent hand use rule:
	if gape-gloves is wrist-bound-behind and gape-gloves is worn:
		if manual hands attempt is 1, say "Your hands are stuck in your [MediumDesc of gape-gloves][one of] which are in turn glued to[or], permanently spreading[or] on[or], forcing you to invitingly spread[cycling] your [if the total volume of hips < 3]asscheeks[otherwise][AssDesc][end if]!";
		rule fails.
The gape gloves prevent hand use rule is listed in the hands restriction rules.

Definition: gape-gloves is transformation-protected: decide yes.

This is the knickers gape gloves clash rule:
	if wearing-target is total protection:
		if gape-gloves is worn and gape-gloves is wrist-bound-behind:
			if summoning is 0 and autowear is false, say "You can't wear that because your [printed name of gape-gloves] is in the way!";
			rule fails.
The knickers gape gloves clash rule is listed in the knickers wearability rules.

This is the trousers gape gloves clash rule:
	if wearing-target is total protection:
		if gape-gloves is worn and gape-gloves is wrist-bound-behind:
			if summoning is 0 and autowear is false, say "You can't wear that because your [printed name of gape-gloves] is in the way!";
			rule fails.
The trousers gape gloves clash rule is listed in the trousers wearability rules.

This is the overdress gape gloves clash rule:
	if wearing-target is total protection:
		if gape-gloves is worn and gape-gloves is wrist-bound-behind:
			if summoning is 0 and autowear is false, say "You can't wear that because your [printed name of gape-gloves] is in the way!";
			rule fails.
The overdress gape gloves clash rule is listed in the overdress wearability rules.

This is the skirt gape gloves clash rule:
	if wearing-target is total protection:
		if gape-gloves is worn and gape-gloves is wrist-bound-behind:
			if summoning is 0 and autowear is false, say "You can't wear that because your [printed name of gape-gloves] is in the way!";
			rule fails.
The skirt gape gloves clash rule is listed in the skirt wearability rules.

This is the equippable gape gloves clash rule:
	if wearing-target is hand ready and gape-gloves is worn and gape-gloves is wrist-bound-behind:
		if summoning is 0 and autowear is false, say "You can't because your hands are busy holding your butthole open!";
		rule fails.
The equippable gape gloves clash rule is listed in the equippable wearability rules.

Check replacing:
	if gape-gloves is worn and gape-gloves is wrist-bound-behind:
		unless the noun is crotch-assless, say "You can't replace any clothing while you are stuck with your [MediumDesc of gape-gloves] on your [AssDesc]!" instead.

This is the gape gloves butt slut rule:
	if gape-gloves is worn, increase the desirability of asshole by 20.
The gape gloves butt slut rule is listed in the butt slut eligibility rules.

To compute periodic effect of (C - gape-gloves):
	let S be a random worn crotch-in-place displacable clothing;
	if S is clothing:
		say "Your [ShortDesc of S] quickly bunches up at the back thanks to the position of your hands on your [AssDesc].";
		displace S.
To compute school periodic effect of (C - gape-gloves):
	compute periodic effect of C.

Gape Gloves ends here.
