Aeromancer by Monster begins here.

An aeromancer is a kind of monster. An aeromancer is intelligent. The leftover-type of an aeromancer is usually 113. An aeromancer has a number called science requests. An aeromancer has a number called science history. An aeromancer has a number called inflation-choice.

Definition: an aeromancer is willing to do anal: decide yes.

Definition: an aeromancer is willing to do vaginal: decide yes.

Definition: An aeromancer is dungeon dwelling: decide yes.

Definition: An aeromancer is woods dwelling: decide yes.

Definition: An aeromancer is wenchy: decide yes.

To say ShortDesc of (M - an aeromancer):
	say "aeromancer".

smirking aeromancer is an aeromancer. The text-shortcut of smirking aeromancer is "sae".
To say MediumDesc of (M - smirking aeromancer):
	say "smirking [if M is ballooned]massive-breasted [end if]aeromancer".

grinning aeromancer is an aeromancer. The text-shortcut of grinning aeromancer is "gae".
To say MediumDesc of (M - grinning aeromancer):
	say "grinning [if M is ballooned]massive-breasted [end if]aeromancer".

chuckling aeromancer is an aeromancer. The text-shortcut of chuckling aeromancer is "cae".
To say MediumDesc of (M - chuckling aeromancer):
	say "chuckling [if M is ballooned]massive-breasted [end if]aeromancer".

Understand "massive", "massive-breasted" as aeromancer when the item described is ballooned.

Figure of aeromancer 1 is the file "NPCs/Dungeon/Aeromancer/aeromancer1.jpg".
Figure of aeromancer 2 is the file "NPCs/Dungeon/Aeromancer/aeromancer2.jpg".
Figure of aeromancer 3 is the file "NPCs/Dungeon/Aeromancer/aeromancer3.jpg".
Figure of aeromancer 4 is the file "NPCs/Dungeon/Aeromancer/aeromancer4.jpg".
Figure of aeromancer 5 is the file "NPCs/Dungeon/Aeromancer/aeromancer5.jpg".
Figure of aeromancer 6 is the file "NPCs/Dungeon/Aeromancer/aeromancer6.jpg".
Figure of aeromancer 7 is the file "NPCs/Dungeon/Aeromancer/aeromancer7.jpg".

Figure of aeromancer interact 1 is the file "Special/Cutscene/cutscene-aeromancer-interact1.png".
Figure of aeromancer interact 2 is the file "Special/Cutscene/cutscene-aeromancer-interact2.png".
Figure of aeromancer interact 3 is the file "Special/Cutscene/cutscene-aeromancer-interact3.png".
Figure of aeromancer interact 4 is the file "Special/Cutscene/cutscene-aeromancer-interact4.png".
Figure of aeromancer interact 5 is the file "Special/Cutscene/cutscene-aeromancer-interact5.png".
Figure of aeromancer interact 6 is the file "Special/Cutscene/cutscene-aeromancer-interact6.png".
Figure of aeromancer interact 7 is the file "Special/Cutscene/cutscene-aeromancer-interact7.png".
Figure of aeromancer interact 8 is the file "Special/Cutscene/cutscene-aeromancer-interact8.png".
Figure of aeromancer interact 9 is the file "Special/Cutscene/cutscene-aeromancer-interact9.png".
Figure of aeromancer interact 10 is the file "Special/Cutscene/cutscene-aeromancer-interact10.png".
Figure of aeromancer interact 11 is the file "Special/Cutscene/cutscene-aeromancer-interact11.png".
Figure of aeromancer interact 12 is the file "Special/Cutscene/cutscene-aeromancer-interact12.png".
Figure of aeromancer interact 13 is the file "Special/Cutscene/cutscene-aeromancer-interact13.png".
Figure of aeromancer interact 14 is the file "Special/Cutscene/cutscene-aeromancer-interact14.png".
Figure of aeromancer interact 15 is the file "Special/Cutscene/cutscene-aeromancer-interact15.png".
Figure of aeromancer interact 16 is the file "Special/Cutscene/cutscene-aeromancer-interact16.png".
Figure of aeromancer interact 17 is the file "Special/Cutscene/cutscene-aeromancer-interact17.png".
Figure of aeromancer interact 18 is the file "Special/Cutscene/cutscene-aeromancer-interact18.png".

Figure of aeromancer cutscene 1 is the file "Special/Cutscene/cutscene-aeromancer-balloon1.png".
Figure of aeromancer cutscene 2 is the file "Special/Cutscene/cutscene-aeromancer-science1.png".
Figure of aeromancer cutscene 3 is the file "Special/Cutscene/cutscene-aeromancer-science2.png".
Figure of aeromancer cutscene 4 is the file "Special/Cutscene/cutscene-aeromancer-fuck1.png".
Figure of aeromancer cutscene 5 is the file "Special/Cutscene/cutscene-aeromancer-fuck2.png".
Figure of aeromancer cutscene 6 is the file "Special/Cutscene/cutscene-aeromancer-fuck3.png".
Figure of aeromancer cutscene 8 is the file "Special/Cutscene/cutscene-aeromancer-fairy1.jpg".

To decide which figure-name is the monster-image of (M - an aeromancer):
	if M is ballooned:
		decide on figure of aeromancer 3;
	otherwise if the previously-ballooned of M > 0 or M is confident aeromancer:
		decide on figure of aeromancer 2;
	otherwise:
		decide on figure of aeromancer 1.

To decide which figure-name is the anal-sex-monster-image of (M - an aeromancer):
	decide on figure of aeromancer cutscene 4.

To decide which figure-name is the vaginal-sex-monster-image of (M - an aeromancer):
	decide on figure of aeromancer cutscene 4.

To say MonsterDesc of (M - an aeromancer):
	if lady fetish is 2:
		say "[if M is confident aeromancer or the previously-ballooned of M > 0]The [man of M] is wearing a pair of stylish sorcerer's pants and an inflatable harness in place of a shirt. You can see a solid gold wand resting in [his of M] hand, glowing faintly as [his of M] clothes subtly flow with the direction of the wind. [big he of M] seems very confident and focused on [his of M] goals, whatever they are.[otherwise]This [man of M] is dressed in a sexy but not slutty sorcerer's outfit, complete with what looks like a solid gold wand. [big he of M] seems very upbeat and focused on [his of M] goals, whatever they are.[end if][if M is ballooned]Right now, the harness is inflated, and [he of M] is hovering a foot off the ground.[end if]";
	otherwise:
		say "[if M is confident aeromancer or the previously-ballooned of M > 0]This [man of M] is wearing a pair of stylish sorcerer's pants and a birthday suit for a shirt. You can see a solid gold wand resting in [his of M] hand, glowing faintly as [his of M] clothes subtly flow with the direction of the wind. [big he of M] seems very confident and focused on [his of M] goals, whatever they are.[otherwise]This [man of M] is dressed in a sexy but not slutty sorceress['] outfit, complete with what looks like a solid gold wand. [big he of M] seems very upbeat and focused on [his of M] goals, whatever they are.[end if][if M is ballooned]Right now [he of M] has inhumanly huge air-inflated breasts and is hovering a foot above the ground. [line break][variable custom style]Something tells me [he of M]'s a bit more powerful while [he of M]'s got those boobs...[roman type][line break]".

To say MonsterComment of (M - aeromancer):
	if M is ballooned:
		say "[line break][variable custom style]Something tells me [he of M]'s a bit more powerful while [he of M]'s got those [if lady fetish is 2]balloons[otherwise]boobs[end if]...[roman type][line break]";
	otherwise:
		say "[if the bimbo of the player <= 7 and the player is female][line break][first custom style][one of][big he of M]'s not that out of the ordinary, I suppose.[or]Where did [he of M] get all those clothes?[purely at random][otherwise if the bimbo of the player <= 7][one of]Is that real gold?![or][big he of M] probably looks better naked.[at random][otherwise if the bimbo of the player <= 12][line break][variable custom style][one of]That's a cute pair of pants. I guess.[or]That wand is kind of boner-like. Now that I think about it.[purely at random][otherwise][line break][second custom style][one of]Who needs magic when you can suck dick![or][big he of M]'s wearing way too much clothing. Everybody knows sluts look better nude![purely at random][end if][roman type][line break]".

To set up (M - an aeromancer):
	reset M;
	now the monstersetup of M is 1;
	if inflation fetish is 1 or artificial enhancements fetish is 1:
		now the raw difficulty of M is 6;
		if M is in the Woods, DifficultyUp M by 2;
		now the health of M is the maxhealth of M;
	otherwise:
		remove M from play;

Definition: An aeromancer (called M) is first level:
	if inflation fetish is 0 and artificial enhancements fetish is 0, decide no;
	decide yes.

Definition: An aeromancer (called M) is second level:
	if inflation fetish is 0, decide no;
	if M is confident aeromancer, decide yes;
	decide no.

To decide which number is the girth of (M - a aeromancer):
	decide on 6.

This is the spawn initial dungeon aeromancer rule:
	if debugmode > 1, say "Now summoning aeromancer.";
	if the number of alive aeromancers in the dungeon is 0 and (inflation fetish is 1 or artificial enhancements fetish is 1):
		let M be a random off-stage dungeon dwelling aeromancer;
		summon M in the dungeon.
The spawn initial dungeon aeromancer rule is listed in the setting up dungeon monsters rules.

Definition: an aeromancer is human: decide yes.

To say LeftoverDesc (N - 113):
	say "An unconscious aeromancer on the ground has a [if pregnancy fetish is 1]pregnant looking[otherwise]fully stretched[end if] belly and [semen] slowly flowing out of [his of a random aeromancer] asshole.[line break]";

To decide which number is the base semen load of (M - an aeromancer):
	decide on a random number between 7 and 11.

Part 1 - Misc Flavour

To say SummoningFlav of (M - an aeromancer):
	if M is in the dungeon:
		say "[if M is in the location of the player]A space opens up in the centre of the circle, and a surprisingly clothed [man of M] flies through riding on a gust of wind. [line break][speech style of M]Looks like I gust about escaped![roman type][line break][big he of M] chuckles at [his of M] own terrible pun as the portal closes behind [him of M].[otherwise]You hear a [man of M] chuckling at [his of M] own terrible puns.[end if]";
	otherwise:
		say "[if M is in the location of the player]The wind kicks up suddenly, howling fiercely as a surprisingly clothed [man of M] flies through the stone opening between the statue's legs. [line break][speech style of M]'With the right wind in my sails, there[']s nothing I can[']t blow!'[roman type][line break][big he of M] lands on [his of M] feet, chuckling at [his of M] own terrible pun.[otherwise]You hear a [man of M] chuckling at [his of M] own terrible puns.[end if]".

To say DiaperReaction of (M - a aeromancer):
	if there is a currently visible diaper or the player is shameless:
		say "[BigNameDesc of M] smirks and looks directly at your dampening crotch.[line break][speech style of M]'[one of][if the class of the player is princess]Princess[otherwise]Pathetic[end if] Pottypants Prefers Peers['] Perception of [big his of the player] Pitiful Panty Peeing. Haha, I'm a poet and I don't even know it! Seriously though, you're a disgrace.'[or]Do you get off on me watching you wet yourself, or something? Gross.'[stopping][roman type][line break]";
		if the player is modest, say "[one of]You are so ashamed you wish the ground would just open up and swallow you. [or][stopping]You turn bright red and refuse to look at [NameDesc of M] in the eye.";
	otherwise:
		say "It seems that [he of M] hasn't sensed anything, so you've gotten away with it this time.".

To compute diaper mess reaction of (M - an aeromancer):
	say "[BigNameDesc of M] recoils with shock.[line break][speech style of M]'Are you shitting me?! Pun not intended!!! [if M is uninterested]I'm getting out of here.'[otherwise]I'm not going anywhere near that.'[end if][roman type][line break]";
	humiliate 400;
	if M is uninterested:
		bore M;
		if M is in the location of the player, compute mandatory room leaving of M.

To compute (M - a monster) stomping (N - an aeromancer):
	if M is in the location of the player, say "With lightning speed [NameDesc of M] grabs [NameDesc of N] and starts fucking [his of N] ass furiously. [BigNameDesc of M] starts cumming inside [him of N] within seconds, and [he of N] screams in both pleasure and terror as [his of M] belly rapidly begins to expand. After [he of N] is full, [NameDesc of M] tosses [him of N] to the ground, where [he of N] promptly faints.";
	otherwise say "You hear a [boy of N] shout out in a mixture of ecstasy and terror from [if N is nearby]nearby![otherwise]somewhere in the dungeon![end if]";
	destroy N;
	let L be a random off-stage leftover;
	now L is in the location of M;
	now the leftover-type of L is the leftover-type of N.

Definition: an aeromancer (called M) is distracted:
	if inflation fetish is 1 and M is reactive and (M is uninterested or M is friendly):
		let N be a random undefeated fairy in the location of M;
		if N is monster and (N is not grabbing the player and N is not penetrating a body part):
			say "[BigNameDesc of M] looks [if M is interested]straight past you [end if]at [NameDesc of N]. [big he of M] takes out [his of M] golden wand and waves it towards [NameDesc of N].[line break][speech style of M]'I love doing this.'[roman type][line break][BigNameDesc of N] begins to inflate in all directions!";
			cutshow figure of aeromancer cutscene 8;
			say "[speech style of N]'What the?!'[roman type][line break]That's all [NameDesc of N] manages to squeak before the air pressure inside [him of N] gets too high and it begins to shoot out of [him of M] like a balloon, sending [him of M] spiralling into the distance. [BigNameDesc of M] laughs joyfully.[line break][speech style of M]'That never gets old!'[roman type][line break]";
			if N is interested, bore N;
			regionally place N;
			decide yes;
	decide no.

Part 2 - Perception

Definition: an aeromancer (called M) is outrage disapproving:
	if the player is exposed and the class of the player is not faerie, decide yes;
	decide no.

To check disapproval of (M - an aeromancer):
	let A be the appearance of the player;
	let L be the latest-appearance of M;
	now the latest-appearance of M is A;
	if A > L and M is outrage disapproving, compute disapproval of M;
	if M is cringe disapproving, compute cringe disapproval of M.

To say DisapprovalFlav of (M - an aeromancer):
	say "[BigNameDesc of M] licks [his of M] lips.[line break][speech style of M]'I can see your [if there is an at least partially lewdly exposed fuckhole or penis is at least partially lewdly exposed]bits[otherwise]nips[end if] now, you know. Isn't that pretty much an invitation?'[roman type][line break]".

To say BecomesAggressive of (M - an aeromancer):
	say "You watch [him of M] draw power to [his of M] wand![line break][speech style of M]'[one of]I think you need to learn what happens to greedy sluts who expose themselves to others...'[or]That's fine with me, because I've been BURSTING to play with you!'[in random order][roman type][line break]".

To compute appearance assessment of (M - an aeromancer):
	if M is outrage disapproving:
		FavourDown M by 2;
		if M is unfriendly:
			say "[speech style of M]'[one of]Aww yeah, combat time! ... You do realise you look pretty slutty right now, right?'[or]My motto is: ['][if vagina is lewdly exposed][cunt][otherwise if penis is lewdly exposed and penis is tiny][sissy] clitty[otherwise if asshole is lewdly exposed]butthole[otherwise if penis is lewdly exposed]willy[otherwise]nipples[end if] on display, it must be okay![']'[or]Ooh, a new subject for my experiments!'[or]You look like you could use some uplifting!'[or]Ooh, yay, I found one! Let's do this!'[or]Hey there! Would you rather fight or just let me fuck you?'[then at random][roman type][line break][one of]Uh-oh, [he of M] seems unfriendly...[or][stopping]";
			anger M;
			alwayscutshow figure of aeromancer interact 10 for M;
		otherwise if M is groping:
			compute grope of M;
		otherwise:
			say "[speech style of M]'[one of]You do realise you look pretty slutty right now, right? [or]My motto is: ['][if vagina is lewdly exposed][cunt][otherwise if penis is lewdly exposed and penis is tiny][sissy] clitty[otherwise if asshole is lewdly exposed]butthole[otherwise if penis is lewdly exposed]willy[otherwise]nipples[end if] on display, it must be okay!['] [then at random]So if you don't want me to fuck you senseless, I'd suggest putting some proper clothes on[if M is not acquaintance] before the next time we meet[end if].'[roman type][line break][big he of M] turns away, clearly not currently interested in talking to you.";
			distract M;
			alwayscutshow figure of aeromancer interact 11 for M;
	otherwise:
		FavourDown M by the science requests of M;
		if M is unfriendly:
			say "[speech style of M]'Okay, I'm officially fed up of asking. Get on your knees and participate in my experiments before I MAKE you.'[roman type][line break]";
			now the science requests of M is 0;
			alwayscutshow figure of aeromancer interact 5 for M;
		otherwise:
			if the class of the player is faerie:
				say "[speech style of M]'[if the science requests of M > 0]You know, my experiments are really fun! I know you[']d love helping if you gave me a chance. Help out before I decide to show you what you[']ve been missing?'[otherwise if the science history of M > 0]Ah, just the fairy I wanted to see! Help me with another experiment!'[otherwise]Hey, want to try out something fun? That's what you fairies are into, right?'[end if][roman type] ";
			otherwise:
				say "[speech style of M]'[if the science requests of M > 0]You know, you should really consider my request. Before I decide my experiments are a little less... optional. Come on, surely you'll let me try a new spell out on you?'[otherwise if the science history of M > 0]Hey, fancy helping me out with some more science?'[otherwise]Hey, would you like to help me out with an experiment?'[end if][roman type] ";
				if the science requests of M is 0:
					alwayscutshow figure of aeromancer interact 6 for M;
				otherwise if the science requests of M is 1:
					alwayscutshow figure of aeromancer interact 7 for M;
				otherwise:
					alwayscutshow figure of aeromancer interact 8 for M;
			increase the science requests of M by 1;
			if the player is bimbo consenting:
				now the science requests of M is 0;
				FavourUp M;
				compute aeromancer science of M;
				if M is unfriendly, satisfy M;
			otherwise:
				if the class of the player is faerie:
					say "[speech style of M]'[one of]Looks like I need to uplift your expectations!'[or]It[']s about time I aired some grievances!'[or]You won[']t stay this air free for long!'[at random]";
					anger M;
				otherwise:
					say "[speech style of M]'[one of]Fine, have it your way...'[or]Stupid airheads...'[at random][roman type][line break]";
				alwayscutshow figure of aeromancer interact 9 for M.

To compute perception of (M - an aeromancer):
	now M is interested;
	if the class of the player is living sex doll:
		say "[BigNameDesc of M] notices you[if the player is sluttily dressed].[otherwise]![end if][line break][speech style of M]'Hey there little inflatable sex doll, do you need a top-up?'[roman type][line break]";
		anger M;
		alwayscutshow figure of aeromancer interact 14 for M;
	otherwise if M is objectifying the player:
		say "[BigNameDesc of M] notices you[if the player is sluttily dressed].[otherwise]![end if][line break][speech style of M]'[one of]Ooh, I can tell that you just can't wait to be played with!'[or]Wow, now that's a [tasty] slut! Come here pretty [boy of the player], let me play with you!'[or]Ooh, yay, I've finally found the perfect subject for my experiments!'[in random order][roman type][line break]";
		anger M;
		alwayscutshow figure of aeromancer interact 10 for M;
	otherwise if M is unfriendly:
		say "[BigNameDesc of M] notices you[if the player is sluttily dressed].[otherwise]![end if][line break][speech style of M]'[one of]Hi again! Guess what time I've just decided it is?'[or]Ah, perfect, I was just wondering where my favourite test subject had got to!'[or]Sweet, there you are. I thought I'd scared you off!'[in random order][roman type][line break][if the player is upright][big he of M] takes an aggressive stance.[end if]";
		alwayscutshow figure of aeromancer interact 12 for M;
	otherwise if the player is in danger or there is a live thing penetrating a body part:
		say "[BigNameDesc of M] notices you[if the player is sluttily dressed]! [otherwise]. [end if][line break][speech style of M]'[one of]Fascinating! I'll be back[or]Haha, sure looks like you're having fun[in random order]!'[roman type][line break][big he of M] turns to leave you alone.";
		distract M;
		alwayscutshow figure of aeromancer interact 13 for M;
	otherwise:
		say "[BigNameDesc of M] looks you up and down[if the player is sluttily dressed].[otherwise]![end if][line break]";
		compute appearance assessment of M;
	if M is interested and M is friendly, display interaction of M.

To display interaction of (M - an aeromancer):
	unless the science requests of M is 0: [we don't want to give an image here if we just did science]
		if M is ally:
			alwayscutshow figure of aeromancer interact 1 for M;
		otherwise if M is buddy:
			alwayscutshow figure of aeromancer interact 2 for M;
		otherwise if M is acquaintance:
			alwayscutshow figure of aeromancer interact 3 for M;
		otherwise:
			alwayscutshow figure of aeromancer interact 4 for M.

Part 3 - Aeromancer Science

To compute aeromancer science of (M - an aeromancer):
	increase the science history of M by a random number between 1 and 2;
	let N be the science history of M;
	if N > 5, now N is 5;
	let R be a random number between 0 and N;
	say "[speech style of M]'[one of]Sweet! Let's do this.' [or]Okay, cool! Here we go...' [or]Nice! Right, stay still...' [at random][roman type][line break]Pointing [his of M] wand towards you, [NameDesc of M] concentrates. ";
	if R is 0 or (inflation fetish is 0 and R is 2):
		if the silicone volume of breasts > 0 or the silicone volume of hips > 0 or inflation fetish is 0:
			say "[big his of M] magic seems to [if the silicone volume of breasts > 0 or the silicone volume of hips > 0]react with the[otherwise]create[end if] silicone implants in your body! Your [if the player is top heavy][AssDesc][otherwise][ShortDesc of breasts] and [AssDesc] both[end if] expand as your implants are magically enhanced!";
			BustImplantsUp 3;
			AssImplantsUp 3;
		otherwise:
			say "You feel your whole body exploding outwards!";
			if the largeness of breasts < max breast size, BustInflate 6;
			AssFill (belly limit - the total fill of belly) air;
			if the total volume of hips < max ass size, AssInflate 4;
		if the player is flying:
			cutshow figure of aeromancer cutscene 2 for M;
		otherwise if the player is not a flatchested trap:
			cutshow figure of aeromancer cutscene 3 for M;
	otherwise if R is 1:
		if the raw strength of the player < 20:
			say "You feel your muscles inflate! The bizarre sensation leaves you feeling stronger but also [if the player is a bit horny]even hotter on the inside[otherwise]you feel like you're getting hotter inside[end if].";
			StrengthUp 1;
		otherwise:
			say "Nothing physical changes, but you feel a weird, strong heat growing at your crotch!";
		arouse 3000;
	otherwise if R is 2:
		let K be a random off-stage pump plug panties;
		let C be a random worn knickers;
		if K is actually summonable:
			say "A [ShortDesc of K] materialises on and inside of you! [line break][variable custom style][if the openness of asshole < 3]Ouch![otherwise if the openness of asshole < 6 or the anal sex addiction of the player < 4]Eek![otherwise]Ooh![end if][roman type][line break]";
			summon K cursed with quest;
		otherwise if the bladder of the player > 0:
			say "Air fills your bladder, putting immense pressure on it! You can't help but start to wet yourself.";
			now delayed urination is 1;
			try urinating;
		otherwise if C is transformable clothing:
			say "Your [ShortDesc of C] is suddenly hit by a beam of light from [his of M] wand!";
			potentially transform C;
		otherwise:
			say "Air suddenly forces its way inside your [asshole], stretching your sphincter as it makes its way in!";
			gape asshole times 1;
			AssFill 5 air;
	otherwise if R is 3:
		say "Air whips around you, hitting you from all sides with stinging strikes!";
		PainUp 1;
		if unlucky is 1:
			repeat with C running through worn cotton destructible clothing:
				say "Your [ShortDesc of C] is ripped apart!";
				destroy C;
	otherwise: [Selkie: it'd be sweet if she could add a step or two to a latex-doll transformation that was underway]
		say "A beam flies straight from [his of M] wand to your face!";
		if a random number between 1 and 3 > 1 and the raw largeness of hair < max hair length:
			say "Your hair grows!";
			HairUp 1;[####Selkie: Shouldn't the rest of these be 'otherwise' clauses? Or do we want there to be a possibility of multiple changes?]
		if a random number between 1 and 3 > 1 and the make-up of face < 3:
			say "Your make up gets thicker!";
			FaceUp 1;
		if a random number between 1 and 4 > 1:
			say "You feel smarter!";
			IntUp 1;
		if a random number between 1 and 3 > 1 and the lips of face < 2 + artificial enhancements fetish:
			say "Your lips get plumper!";
			LipsUp 1;
		say "Your head feels a bit more giddy!";
		OralSexAddictUp 1;
		SexAddictUp 1;
	say "[speech style of M]'[one of]Whew, that was awesome!'[or]Thanks for your help.'[or]Interesting...'[or]Well that was unexpected...'[or]Curiouser and curiouser.'[in random order][roman type][line break][BigNameDesc of M] writes a scribble in [his of M] pocket book and then closes it.".

Part 4 - Combat

Definition: a aeromancer (called M) is actually interested:
	unless M is unfriendly, decide no.[The aeromancer is interested for the purposes of accepting a presentation, but not for anything else.]

To say SexSubmissionFlav of (M - a aeromancer): [this is customized because I rewrote the scene so the player is floating a couple feet off the ground.]
	let F be a random fuckhole penetrated by M;
	if the delicateness of the player < 13:
		say "[one of]Recognising how much it will hurt if you fall, you do your best not to resist and hope [NameDesc of M] will get bored soon.[or]As humiliating as it is to let [his of M] have [his of M] way, it[']s not like you can do much about it anyway.[or]You try your best not to break [NameDesc of M][']s concentration. [if the openness of F < 6]It hurts, but it would hurt more if [he of M] dropped you.[otherwise]It would hurt if [he of M] dropped you.[end if][or]You submit to being used as a plaything.[at random]";
	otherwise:
		say "[one of]You allow [NameDesc of M] to violate you as much as [he of M] likes. [big he of M]'s in charge![or]You laugh heartily at [NameDesc of M][']s wordplay, hoping [he of M][']ll reward you after.[at random]".

To say SexResistFlav of (M - a aeromancer):
	say "[one of]You hopelessly flail from your position in mid-air, doing everything you can to resist the invasion.[or]Since you're trapped several feet off the ground, you have no real way of resisting, but you still try![or]Your hands pass right through when you try to yank a tentacle out of you, but thanks to your struggling, you feel some very tangible pain![or]You flail around and make as much noise as you can, but no matter how much you try, you can't break [NameDesc of M][']s concentration[unless M is confident aeromancer] for very long[end if].[or]You frantically try to claw your way to the aeromancer and hopefully get the wand out of [his of M] hand, [if the M is confident aeromancer]but [he of M] effortlessly holds you at bay[otherwise]but [he of M] always manages to keep you just out of reach[end if].[at random]".

Section 0 - Ballooning

[Aeromancers power up and then get higher strength for a while]

An aeromancer has a number called balloon.
An aeromancer has a number called previously-ballooned.
An aeromancer can be wand-empowered. An aeromancer is usually not wand-empowered.

Definition: an aeromancer (called M) is ballooned:
	if M is in the woods:
		if the difficulty of M > 8, decide yes;
	otherwise if the difficulty of M > 6:
		decide yes;
	decide no.

To compute unique early action of (M - an aeromancer):
	unless the player is prone or there is a monster penetrating a body part or there is a thing grabbing the player, compute ballooning of M.

To compute ballooning of (M - an aeromancer):
	if M is ballooned:
		if M is not wand-empowered:
			decrease the balloon of M by 1;
			if debuginfo > 0, say "[input-style]Aeromancer air loss: [balloon of M + 1] -> [balloon of M][roman type][line break]";
		if the balloon of M <= 1:
			if M is in the location of the player, say "[BigNameDesc of M][']s breasts deflate and [he of M] returns to the ground.";
			let DAM be the maxhealth of M - the health of M;
			if M is in the Woods, DifficultyDown M by 6;
			otherwise DifficultyDown M by 4;
			now the health of M is the maxhealth of M - DAM;
			if the health of M < 1:
				now the health of M is 1;
				say "It seems that move took a lot out of [him of M] - [he of M][']s pretty much gasping to recover [his of M] breath.";
			now M is flightless;
	otherwise:
		if M is in the location of the player and M is dangerous:
			increase the balloon of M by 1;
			let R be a random number between 2 and 5;
			if debuginfo > 0, say "[input-style]Aeromancer power-up check: air stored ([balloon of M]) | ([R].5) d4+1.5 power-up threshold[roman type][line break]";
			if the balloon of M > R:
				say "[speech style of M]'[one of]I've been waiting for an excuse to use this...' [or]Ultimate Airbag Transformation - Engage!' [stopping][roman type][line break][BigNameDesc of M] pushes [his of M] wand between [his of M] breasts and massages it like a [manly-penis]. You watch [if the bimbo of the player < 6]in horror [end if]as [his of M] breasts balloon, quadrupling in size[if M is not confident aeromancer], bursting through [his of M] tight top and destroying it permanently[end if]! They begin to lift [him of M] off of the ground until [he of M] is hovering gracefully a foot in the air. [if M is wand-empowered][he of M][']s definitely going to be a lot more powerful now.[otherwise]You feel [he of M][']s probably a lot more powerful until [he of M] lands.[end if]";
				now M is airborne;
				let DAM be the maxhealth of M - the health of M;
				if M is in the Woods, DifficultyUp M by 6;
				otherwise DifficultyUp M by 4;
				increase the previously-ballooned of M by 1;
				now the health of M is the maxhealth of M - DAM;
				cutshow figure of aeromancer cutscene 1 for M.

To compute unique dislodging of (M - an aeromancer):
	now the balloon of M is 1.

Section 1 - Attack

To compute the flying player taunting of (M - an aeromancer):[TODO: angry aeromancers actually mess with you.]
	if a random number from 1 to 6 is 1:
		say "[BigNameDesc of M] laughs at you. [line break][speech style of M]'[one of]Enjoying your flight? Hahahaha!'[or]Is it a bird? Is it a plane? No, it's a dumb fat whore!'[or]I should attach a string to your toe and pull you around like a kite!'[or]You must be ballooning with humiliation! Get it? Haha.'[or]Don't let all that air get to your head! Get it? Because you're air-headed!'[or]Hey now, it looks like you've blown things way out of proportion! Bwahaha.'[in random order][roman type][line break][if the humiliation of the player < 17500]You [one of]wince[or]shudder[or]cringe[purely at random] with shame.";
		humiliate 20.

The latex punishment rule of an aeromancer is usually the no latex punishment rule.

To say LandingTaunt of (M - an aeromancer):
	say "[BigNameDesc of M] [if a random number between 1 and 2 is 1]giggles[otherwise]laughs mercilessly[end if].";
	humiliate 50.

To compute fuckhole sex of (M - an aeromancer): [separated these out so it's less confusing to do if statements]
	let F be a random fuckhole penetrated by M;
	if M is confident aeromancer:[The woods aeromancer is a great deal more powerful than the dungeon aeromancer, so not only is she strong enough to violate you with a giant air penis instead of several smaller tentacles, she's also skilled enough that she can do more things with it.]
		if the sex-length of M is 3:
			say "[BigNameDesc of M] jeers at you as the magical sex organ fucks you.";
		otherwise:
			say "[one of][BigNameDesc of M] badgers you with taunts as the magical sex organ continues to hammer away.[or]The magic [manly-penis] continues to fuck you. Somehow, [NameDesc of M] still has enough concentration left over to keep jeering at you.[or]Powerful gusts of wind smack your [BreastDesc] and pull your hair as the magical sex organ hammers away.[or]The magical [manly-penis] continues to drill your [if the soreness of F > 5]tender[end if][F], seemingly emboldened by [NameDesc of M][']s grating wordplay.[at random]";
	otherwise:
		if the sex-length of M is 3: [The dungeon aeromancer is weaker than the woods aeromancer, so there are signs that she's having trouble coordinating with her tentacles and thinking of puns at the same time.]
			say "[BigNameDesc of M] jeers at you as the magical sex organs fuck you.";
		otherwise:
			say "[one of][BigNameDesc of M][']s magic sex organs continue to fuck you.[or][BigNameDesc of M] struggles to come up with more puns as the magic tentacles piston away.[or][BigNameDesc of M] continues to violate you with [his of M] magical sex organs.[or]The invisible tentacles continue pistoning away in between [his of M] awful puns.[or]The magical tentacles fuck you extra hard when [NameDesc of M] is having extra trouble coming up with a pun. They might be a relief if they weren't so terrible.[at random]";
	say "[speech style of M]'[one of]I think your [if F is asshole]ass[otherwise][cunt][end if] needs some airing out!'[or]After this ravaging, I think you'll be SOREing! Haha, get it?'[or]Aww, I'm sorry to burst your bubble, but I think I might have punctured your body! Don't worry, I'll be sure to fill you back up!'[or]I hope you don't feel under pressure to perform!'[or]It may be painful now, but if you get any wounds, you can always HELIUM.'[or]It looks like you[']re really full of hot air!'[or]It's a bird! It's a plane! It's a dick in your [if F is asshole]ass[otherwise][cunt][end if]! Hahaha!'[or]The amount of time you spend getting fucked[if the player is not female] in the ass[end if] must be pretty *high up*!'[or]I'd love to talk about a vortex, but sluts like you only care about more sex!'[in random order][roman type][line break][if the sex-length of M is 3 and the reaction of the player is 0]Despite [his of M] awful puns, you still feel humiliated, and you are continuously getting more sore.[line break][end if]"; [There will be puns.]
	if M is penetrating asshole, ruin asshole;
	otherwise ruin vagina;
	decrease the sex-length of M by 1.

To compute anal sex of (M - an aeromancer):
	compute fuckhole sex of M.

To compute vaginal sex of (M - an aeromancer):
	compute fuckhole sex of M.

To compute unique climax of (M - an aeromancer) in (F - asshole):
	let N be the air volume of belly;
	let HI be the total volume of hips;
	compute creampie of M in F;
	if (N + 5 < the air volume of belly) or (HI + 2 < the total volume of hips):
		say "[big he of M] gleefully scribbles something in a small notebook and turns away. Looks like [he of M][']s finished.";
	otherwise:
		say "[big he of M] writes something in a small notebook and turns away. Looks like [he of M][']s finished.";
	bore M;
	FavourUp M;

To say CreampieFlav of (M - an aeromancer) in (F - asshole):
	if inflation fetish is 1, say "You feel the tentacles throb in unison, groaning involuntarily as they take turns filling up your belly with gush after gush of compressed air. [BigNameDesc of M] screams with delight at your rapidly burgeoning belly, sloppily dropping you on your back before walking over to inspect [his of M] handiwork.";
	otherwise say "You feel the tentacles throb in unison, groaning involuntarily as they take turns filling up your innards with gush after gush of compressed magic air. You feel the magic make its way to your [AssDesc] where it seems to [if the silicone volume of hips > 0]cause your buttcheek implants to expand in size[otherwise]take the form of silicone buttcheek implants[end if]!".

To compute (M - an aeromancer) finishing in (F - asshole):
	if inflation fetish is 1, AssFill (the semen load of M) air;
	otherwise AssImplantsUp the semen load of M.

To compute unique climax of (M - an aeromancer) in (F - vagina):
	compute creampie of M in F.

To say CreampieFlav of (M - an aeromancer) in (F - vagina):
	say "[BigNameDesc of M] screams with delight as [his of M] magical tentacles climax, taking turns flooding your [vagina] with warm, glittery [semen]. [big he of M] releases [his of M] hold on your body as the gooey fluid soaks into your skin, causing a strange tingling feeling to travel up your torso and into your chest. You watch with [horror] as [if inflation fetish is 0 and the silicone volume of breasts is 0]silicone implants manifest themselves inside your chest, and [otherwise if inflation fetish is 0] your silicone implants are forced to expand, and [end if]your boobs balloon in front of you!";
	cutshow figure of aeromancer cutscene 5 for M;
	say "[BigNameDesc of M] rather sloppily drops you on the ground, [one of]gleefully [or][stopping]writing something in [his of M] notebook before losing interest.".

To compute (M - an aeromancer) finishing in (F - vagina):
	if inflation fetish is 1, BustInflate (a random number between 3 and 6);
	otherwise BustImplantsUp a random number between 2 and 4.

This is the aeromancer tries to curse the player rule:
	if there is a sex doll penetrating a body part and the latex-transformation of the player is 0 and inflation fetish is 1:
		say "[BigNameDesc of current-monster] sees what the doll is doing to you and chuckles sadistically. [line break][speech style of current-monster]'[one of]I've been waiting to try this spell out...'[or]Ooh, another slut I can help make their hobby into a full time occupation. Lucky you!'[stopping][roman type][line break]You feel [his of current-monster] magic flow from [him of current-monster] to the doll, and then from the doll to you. [one of]You feel different, but you can't put your finger on why. Maybe you feel a tiny bit... numb?[or]Once again you've been inflicted with the latex doll transformation curse![stopping]";
		now the latex-transformation of the player is 1;
		bore current-monster for 800 seconds;
		now the inflation-choice of current-monster is 2;
		rule succeeds;
	otherwise:
		compute the default taunting of current-monster;
		rule succeeds.
The monster fucked taunting rule of an aeromancer is usually the aeromancer tries to curse the player rule.

To compute the dildo stuck taunting of (M - an aeromancer):
	compute the default taunting of M.

To compute the default taunting of (M - an aeromancer):
	if the inflation-choice of M <= 1:
		now the inflation-choice of M is a random number between 2 and 4;
		if inflation fetish is 0, now the inflation-choice of M is a random number between 2 and 3;
		if the inflation-choice of M is 2:
			say "[BigNameDesc of M] points at your [BreastDesc] in a fit of giggles. [line break][speech style of M]'[one of]It's all in the air as to whether this will help you or not!'[or]It won't be plain sailing, but I think you'll end up over the moon thanks to these enhancements!'[in random order][roman type][line break]You feel [if inflation fetish is 0 and the silicone volume of breasts is 0]silicone implants appear inside your breasts,[otherwise if inflation fetish is 0]your silicone breast implants[otherwise]them[end if] inflating rapidly.";
			if inflation fetish is 1, BustInflate 6;
			otherwise BustImplantsUp a random number between 1 and 2;
		otherwise if the inflation-choice of M is 3:
			say "[BigNameDesc of M] points at your [AssDesc] whilst uncontrollably chuckling.[line break][speech style of M]'[one of]Improving people's bodies like this gives me such a lift! Although I'm afraid you might find it a bit of a drag...'[or]Don't worry baby, I'm sure your fashion style will take off soon.'[or]You're going on the only flight where excess baggage is not only allowed, but encouraged!'[in random order][roman type][line break]You feel [if inflation fetish is 0 and the silicone volume of hips is 0]silicone implants appear inside your [AssDesc],[otherwise if inflation fetish is 0]your silicone ass implants[otherwise]them[end if] inflating rapidly.";
			if inflation fetish is 1, AssInflate 5;
			otherwise AssImplantsUp a random number between 1 and 2;
		otherwise:
			say "[BigNameDesc of M] points at your [BellyDesc] whilst uncontrollably chuckling. [line break][speech style of M]'[one of]Improving people's bellies like this gives me such a lift! Although I'm afraid you might find it a bit of a drag...'[or]Don't worry baby, I'm sure your fashion style will take off soon.'[or]You're going on the only flight where excess baggage is not only allowed, but encouraged!'[in random order][roman type][line break]You feel it inflating rapidly.";
			AssFill 8 Air;
	otherwise if the inflation-choice of M is 2:
		say "[BigNameDesc of M] is still making your [BreastDesc] inflate!";
		if inflation fetish is 1, BustInflate 3;
		otherwise BustImplantsUp a random number between 1 and 2;
	otherwise if the inflation-choice of M is 3:
		say "[BigNameDesc of M] is still making your [ShortDesc of hips] inflate!";
		if inflation fetish is 1, AssInflate 3;
		otherwise AssImplantsUp a random number between 1 and 2;
	otherwise if the inflation-choice of M is 4:
		say "[BigNameDesc of M] is still making your [BellyDesc] inflate!";
		AssFill 3 Air.

The aeromancer unique punishment rules is a rulebook. The unique punishment rule of an aeromancer is usually the aeromancer unique punishment rules.

This is the aeromancer wind barrier rule:
	let M be current-monster;
	if (M is wand-empowered or the science history of M > 6) and asshole is occupied and (the player is male or vagina is occupied) and the number of barriers in the location of the player is 0:
		say "[BigNameDesc of M] creates a wall of air around the edges of the room.[line break][speech style of M]'This trick has a tiny margin of AIR-rer.'[roman type][line break]";
		now a random wind-wall is in the location of the player;
		rule succeeds.
The aeromancer wind barrier rule is listed in the aeromancer unique punishment rules.


This is the aeromancer settles for hip inflation rule:
	let M be current-monster;
	now the inflation-choice of M is 1; [Just in case]
	if asshole is occupied and (the player is male or vagina is occupied):
		say "[BigNameDesc of M] seems to settle for inflating your body. [big he of M] points at your [AssDesc] whilst uncontrollably chuckling.[line break][speech style of M]'[one of]Improving people's bodies like this gives me such a lift! Although I'm afraid you might find it a bit of a drag...'[or]Don't worry baby, I'm sure your fashion style will take off soon.'[or]You're going on the only flight where excess baggage is not only allowed, but encouraged!'[in random order][roman type][line break]You feel [if inflation fetish is 0 and the silicone volume of hips is 0]silicone implants appear inside your [AssDesc],[otherwise if inflation fetish is 0]your silicone ass implants[otherwise]them[end if] inflating rapidly.";
		if inflation fetish is 1, AssInflate 4;
		otherwise AssImplantsUp 2;
		satisfy M;
		rule succeeds.
The aeromancer settles for hip inflation rule is listed in the aeromancer unique punishment rules.

To compute (M - an aeromancer) attacking (C - a diaper):
	if asshole is actually occupied or C is perceived messed:
		say "[BigNameDesc of M] senses your situation with your [if C is perceived messed]messed[otherwise]already occupied [asshole] and[end if] diaper and decides against penetrating you. Instead [he of M] simply summons [if inflation fetish is 0 and the silicone volume of hips is 0]silicone implants inside your [AssDesc][otherwise if inflation fetish is 0]more silicone into your ass[otherwise]more air directly inside your belly[end if]!";
		if inflation fetish is 1, AssFill 5 Air;
		otherwise AssImplantsUp 2;
		say "[BigNameDesc of M] seems satisfied and leaves you alone.";
		distract M;
	otherwise:
		say "[BigNameDesc of M] stretches out [his of M] arms and hands towards you. You feel invisible tentacles made of compressed air shoot up your [asshole] with incredible speed. Somehow the magic sex organs are simply phasing through your [printed name of C][if asshole is actually occupied] and the [printed name of random thing filling asshole][end if]!";
		now M is penetrating asshole;
		now the sex-length of M is 3;
		ruin asshole.

To say PullAttempt of (M - an aeromancer) at (K - a clothing):
	say "".

To compute (M - an aeromancer) destroying (K - a clothing):
	say "With a flick of two of [NameDesc of M][']s fingers, sharp air slashes into your [printed name of K], severely damaging it.";
	say "Your [K] have been completely destroyed!";
	destroy K.

To compute (M - an aeromancer) displacing (C - a clothing):
	say "Using [his of M] magic manipulation of air, [NameDesc of M] pulls the [if C is skirted]skirt up, exposing your crotch[otherwise if C is trousers]waistband down to your knees[otherwise]crotch section to one side[end if]!";
	displace C.

To compute (M - an aeromancer) ripping (K - a clothing):
	say "Using [his of M] magic manipulation of air, [NameDesc of M] pulls at both sides of the crotch of your [printed name of K], trying to create a tear in the fabric! It rips easily!";
	now K is crotch-ripped.

To say WeakenFlav of (M - an aeromancer) on (K - a clothing):
	say "With a flick of two of [NameDesc of M][']s fingers, sharp air slashes into your [printed name of K], severely damaging it.".

This is the aeromancer monster convinced rule:
	if the latex-transformation of the player > 3:
		now the chosen-orifice of current-monster is asshole;
		say "[speech style of current-monster]'Time to give you a top-up!'[roman type][line break]";
		rule succeeds;
	if presented-orifice is a potential target:
		if a random number between 0 and the intelligence of the player > 1:
			say "[PresentAcceptanceFlav of current-monster]";
			now the chosen-orifice of current-monster is presented-orifice;
			rule succeeds;
		if presented-orifice is face and current-monster is intelligent and there is a worn tongue piercing:
			say "[BigNameDesc of current-monster] was about to ignore you, but it seems that your tongue piercing made your request extremely convincing!";
			now the chosen-orifice of current-monster is presented-orifice;
			rule succeeds;
	otherwise if presented-orifice is not nothing:
		say "[PresentRejectionFlav of current-monster]".

To say PresentAcceptanceFlav of (M - an aeromancer):
	say "[BigNameDesc of M] laughs at your request.[line break][speech style of M]'Fine by me. Let's do this!'[roman type][line break]".

To say PresentRejectionFlav of (M - an aeromancer):
	say "[BigNameDesc of M] laughs at your request.[line break][speech style of M]'Haha, no, that's not going to happen!'[roman type][line break]".

To say ThreesomePrep of (M - a monster) with (N - an aeromancer) in (F - asshole):
	say "A strong gust of wind spins you around, leaving you facing [NameDesc of N] as [NameDesc of M] pulls apart your [AssDesc].".
To say ThreesomePrep of (M - a monster) with (N - an aeromancer) in (F - vagina):
	say "A strong gust of wind spins you around, leaving you facing [NameDesc of N] as [NameDesc of M] spreads your legs.".

To say FoursomePrep of (M - a monster) with (N - an aeromancer) and (O - a monster) in (F - asshole):
	if M is intelligent, say "A wind pushes upward on your belly, forcing your hips toward [NameDesc of M] as [he of M] pushes apart your [AssDesc].";
	otherwise say "A strong wind pushes your hips toward [NameDesc of M] and forcibly spreads your cheeks.";
To say FoursomePrep of (M - a monster) with (N - an aeromancer) and (O - a monster) in (F - vagina):
	if M is intelligent, say "A strong wind flips you over and forces your legs apart, keeping you vulnerable as [NameDesc of M] grabs hold of your waist.";
	otherwise say "A strong wind pushes your hips toward [NameDesc of M] and forcibly spreads your legs.";

To say SpitroastPrep of (M - an aeromancer) with (O - a monster) in (F - asshole):
	say ThreesomePrep of M with O in F.
To say SpitroastPrep of (M - an aeromancer) with (O - a monster) in (F - vagina):
	say ThreesomePrep of M with O in F.

To say ThreesomePrep of (M - an aeromancer) with (N - a monster) in (F - vagina):
	say "[BigNameDesc of M] stretches one [his of M] arms and hands towards you, giggling uncontrollably as [his of M] wand begins to glow.".
To say ThreesomePrep of (M - an aeromancer) with (N - a monster) in (F - asshole):
	say "[BigNameDesc of M] stretches one arm towards you, giggling uncontrollably as [he of M] raises [his of M] wand above [his of M] head.".

To say FoursomePrep of (M - an aeromancer) with (N - a monster) and (O - a monster) in (F - asshole):
	say ThreesomePrep of M with O in F.

To say FoursomePrep of (M - an aeromancer) with (N - a monster) and (O - a monster) in (F - vagina):
	say ThreesomePrep of M with O in F.

To say TwosomePrep of (M - an aeromancer) in (F - asshole):
	say "[BigNameDesc of M] stretches out [his of M] arms and hands towards you. You yelp as you are suddenly forced several feet off the ground by a powerful gust of wind. Cackling with glee, the aeromancer uses [his of M] mastery of air to buffet you from one end of the [if M is in the Woods]clearing[otherwise]room[end if] to the other, eventually leaving you suspended in the centre, at just above waist height. [big he of M] takes a couple steps forward, barely containing [his of M] mirth as you [if the relevant sex addiction of M < 7]desperately try and fail to get purchase on the ground below[otherwise]look up at [him of M] in wide-eyed anticipation[end if].".

To say TwosomePrep of (M - an aeromancer) in (F - vagina):
	say TwosomePrep of M in asshole.[they're the same, so whatever]

To say PrepTaunt of (M - an aeromancer) in (F - a fuckhole):
	unless there is a live thing penetrating a body part:
		say "[speech style of M]'[one of]So, now that you've had some HANG time, I think you're ready for some WANG time!'[or]Uh oh, looks like a pretty strong breeze coming in from the south!'[or]Round and round [if the player is female]she goes, how she got that slutty[otherwise if the player is a sissy]she goes! How she became such a sissy[otherwise]he goes! How hard a fucking can he take[end if], nobody knows!'[or]The wind told me to tell you something! You[']re a slut! Hahahaha!'[in random order][roman type][line break]".

To say PenetrationFlav of (M - an aeromancer) in (F - asshole):
	say "The air around you compresses itself into shimmering tentacles, which take turns slapping your [AssDesc] before shooting one by one into your [asshole]. Wind lashes at your skin and clothes as [his of M] invisible tentacles begin to ruthlessly fuck you.".

To say PenetrationFlav of (M - an aeromancer) in (F - vagina):
	say "The air around you compresses itself into sparkling tentacles, which immediately shoot into your [vagina]. Wind lashes at your skin and clothes as [his of M] invisible tentacles begin to ruthlessly fuck you.".

To say FriendlyPenetrationFlav of (M - an aeromancer) in (F - asshole):
	say "The air around you compresses itself into shimmering tentacles, which take turns slapping your [AssDesc] as they shoot one by one into your [asshole].".

To say FriendlyPenetrationFlav of (M - an aeromancer) in (F - asshole):
	say "The air around you compresses itself into shimmering tentacles, which immediately shoot into your [vagina].".

Definition: an aeromancer is willing to let go: decide no.

To say PresentFriendlyAcceptanceFlav of (M - an aeromancer):
	say "[speech style of M]'Finally! A willing test subject!'[roman type][line break]".

To say FriendlySexReleaseRefusalSpeech of (M - an aeromancer):
	let F be a random fuckhole penetrated by M;
	say "[speech style of M]'[one of]There[']s no release form on this baby!'[or]Sorry, can't hear you over the sound of me fucking your [F]!'[or]We can[']t stop, I need to find a way to combat slut-borne horniness!'[or]I[']d say fuck you, but looks like I[']m doing that already! Hahahaha!'[or]If you[']re telling me to stop, you must be full of hot air. And if you[']re not, you[']re about to be!'[in random order][roman type][line break]".

To say StrikingSuccessFlav of (M - an aeromancer) on (B - a body part):
	say "An invisible whip made of air whacks you [TargetName of B]! Ouch!!".

To compute (S - a spike bra) damaging (M - an aeromancer):
	say "You see [NameDesc of M] flinch back in pain as [his of M] air whip strikes your [printed name of a random spike bra worn by the player]. The attack was somehow reflected!";
	decrease the health of M by 3;

To say StrikingFailureFlav of (M - an aeromancer) on (B - a body part):
	say "[BigNameDesc of M] tries to whip you with an invisible strand of air, but by listening to the sound you manage to jump to one side and dodge the strike!".

To compute tripping attack of (M - an aeromancer):
	say "A strong gust of wind flies past your [feet], threatening to trip you up and throw you to the ground!";
	let D be the tripping roll of M;
	if D >= the dexterity of the player and M is not-blinded:
		say "[MonsterTrippedFlav of M]";
		try kneeling;
		if the player is prone, check attack of M;
	otherwise:
		say "[MonsterFailedTripFlav of M]";
		if the blind-status of M > 0:
			decrease the blind-status of M by 1;
			if the blind-status of M is 0, say "[BigNameDesc of M] is no longer blind!".

To say MonsterTrippedFlav of (M - an aeromancer):
	say "You flail wildly [if the player is ankle bound]but you can't move your legs far enough apart to maintain your balance. You[otherwise]and[end if] fall to the ground!".

To decide which number is the tripping max of (M - an aeromancer): [Giving the aeromancer her own tripping max function since she doesn't use hair to trip the player.]
	if attack-type is 0 or attack-type is 1:
		if the trip hazard of the player <= 0, decide on 0;
		otherwise decide on 1; [if the player slapped or stood still they are not off-balance so tripping is always minimum likelihood]
	if the living belt of sturdiness is worn and the living belt of sturdiness is not cursed, decide on 0;
	let D be the difficulty of M;
	decrease D by the weight of the player;
	increase D by the trip hazard of the player;
	if the slipperiness of the location of the player > a random number between 1 and 5, say "The slipperiness of the floor is making it much more difficult to avoid falling!";
	if the player is ankle bound, increase D by 3;
	if attack-type is 2, now D is D / 4;
	if D < 1, decide on 1;
	decide on D.

To compute SelectionFailure of (M - an aeromancer):
	say "[BigNameDesc of M] finds [himself of M] unable to use you how [he of M] planned, and seems to settle for casting a simple spell. ";
	now the inflation-choice of M is 1;
	compute the default taunting of M;
	bore M.

Section 2 - Damage

To say CombatProvokedReaction of (M - an aeromancer):
		say "[BigNameDesc of M] [if M is uninterested]notices you and [end if]takes an aggressive stance![if M is friendly][line break][speech style of M]'Fuck you, bitch, I was going to leave you alone! Maybe you are looking for a fuck after all.'[roman type][line break][end if]".

To say DamageReactHealthy of (M - an aeromancer):
	say "[BigNameDesc of M] takes the hit, giggling!".

To say DamageReactDamaged of (M - an aeromancer):
	say "[BigNameDesc of M] takes the hit, wincing!".

To say DamageReactTired of (M - an aeromancer):
	say "[BigNameDesc of M] takes the hit, yelping!".

To say DamageReactWeak of (M - an aeromancer):
	say "[BigNameDesc of M] takes the hit, [if M is confident aeromancer]angrily fighting to[otherwise]tears streaming down [his of M] face [he of M] fights to[end if] maintain [his of M] balance!".

To say DamageReactSubmissive of (M - an aeromancer):
	say "[BigNameDesc of M] staggers, [if M is confident aeromancer]angrily shaking [his of M] wand as it spits out blue sparks[otherwise]whimpering as [his of M] wand spits out blue sparks[end if].".

To compute tax return of (M - an aeromancer):
	let P be a random off-stage golden phallus;
	if a random number between 1 and 2 is 1 and P is golden phallus:
		say "[BigNameDesc of M] points to [his of M] wand.[line break][speech style of M]'You want one of these?'[roman type][line break][BigNameDesc of M] manifests one out of thin air and tosses it to you.";
		now P is in the location of the player;
		compute autotaking P;
		say "You can tell it's just a replica, with no magic power. Perhaps you can still find a use for it though.";
	otherwise:
		loot M;
		say "[speech style of M]'This is better than cash - it doesn't devalue with INFLATION. Oh, forget it. You're no fun at all.'[roman type][line break]".

To say NastyTrapReactFlav of (M - an aeromancer):
	say "[BigNameDesc of M] bursts out laughing.[line break][speech style of M]'What a fucking airhead!'[roman type][line break]".

Part 5 - Dominant Sex

To decide which number is the mental dominance roll for (M - an aeromancer):
	let R be the intelligence of the player - the difficulty of M;
	if debugmode > 0, say "[input style]Aeromancer wand check = [R].[line break]";
	if R < 0 and the intelligence of the player < 8, decide on -99;[You can only have sex with the aeromancer if her wand is willing to accept you. Unless you're smarter than she is, you need an intelligence of 8 to dominate her]
	if debugmode > 0, say "[input style]Aeromancer chastity check...[line break]";
	if there is a worn research airhancer and player-fucker is penis, decide on -99;[Likewise, if she has you in her special chastity, you can't have sex with her either]
	decide on a random number between (the intelligence of the player / 2) and the dominance of the player.

To decide if (M - an aeromancer) is dominantSexReady:
	let G be the intelligence of the player - the difficulty of M;
	if (G < 0 and the intelligence of the player < 15) or there is a worn research airhancer, decide no;
	let X be ((the intelligence of the player / 2) + the dominance of the player) / 2;[that is to say, the average of strength and dominance]
	if the submissiveness base of M < X, decide yes;
	decide no.

To suggestFucker (F - a body part) for (M - an aeromancer):
	if F is penis:
		if watersports fetish is 1 and the player is desperate to pee:
			say "Do you want to piss on [his of M] face? It might be really difficult.";
			if the player is consenting:
				now player-fucker is F;
				now player-fuckchoice is FUCK-WATERSPORTS;
		if player-fucker is face:
			say "Do you want to fuck [his of M] [HoleDesc of M]? [if watersports fetish is 1 and the player is desperate to pee]It might still be hard[otherwise]It could be hard[end if]...";
			if the player is consenting:
				now player-fucker is F;
				now player-fuckchoice is FUCK-PENETRATION;
		if player-fucker is face:[You haven't chosen yet]
			say "Do you want to see if you can make [him of M] suck your [sexual-player-penis]?";
			if the player is consenting:
				now player-fucker is F;
				now player-fuckchoice is FUCK-BLOWJOB;
	otherwise if F is face:
		say "Do you want to see how [he of M] handles the wand being used on [his of M] ass?";
		if the player is consenting:
			now player-fucker is F;
			now player-fuckchoice is FUCK-UNIQUE;
		otherwise:
			say "You decide against it.".

To say DominanceSuccess of (M - an aeromancer):
	if player-fucker is penis:
		if player-fuckchoice is FUCK-WATERSPORTS:
			watersports dominate M;
		otherwise if player-fuckchoice is FUCK-BLOWJOB:
			oral dominate M;
		otherwise:
			if lady fetish is 2, anal dominate M;
			otherwise vaginal dominate M;
	otherwise:
		mercy dominate M.

To mercy dominate (M - an aeromancer):
	say "You force [NameDesc of M] onto [his of M] back, greedily yanking the wand out of [his of M] hands. It seems to react to your touch, crackling with energy as the aeromancer's clothes transform into a set of solid gold chains. You grin. [line break][variable custom style]'How about a taste of your own medicine?'[roman type][line break][big he of M] frantically shakes [his of M] head, but since you don't care about [his of M] opinion anyway, you immediately jam the fat end of the wand up [his of M] ass. You fuck [him of M] mercilessly, revelling in [his of M] groans of discomfort as air rushes inside of [him of M], visibly distending [his of M] belly. [big he of M] glares at you as you get back to your feet, leaving the wand sticking out of [his of M] butt.";
	say AfterDominationComment 0 of M;
	slightDignify;

To watersports dominate (M - an aeromancer):
	if sexual-penis-length >= 4, say "You force [NameDesc of M] to [his of M] knees, wresting the wand out of [his of M] hands. It seems to react to your touch, crackling with energy as a ring of solid gold forces [his of M] mouth wide open. You grin. [line break][first custom style]'If you can deepthroat, I'll give it back.'[roman type][line break]";
	if sexual-penis-length >= 9:
		say "[big he of M] seems more than a little intimidated at the size of your [SexDesc of penis], but after a moment [he of M] [if lady fetish is 2 and M is ballooned or the previously-ballooned of M > 0]slips out of [his of M] harness[otherwise if M is ballooned]pushes [his of M] huge tits together[otherwise if the previously-ballooned of M > 0]pushes up [his of M] naked breasts[otherwise]slowly unzips [his of M] jacket[end if] reluctantly opens [his of M] mouth. Not concerned with receiving a more formal invitation, you grab [him of M] by the hair and jam [him of M] face-first onto your [sexual-player-penis]. Tears well up in [his of M] eyes as your tip brushes the back of [his of M] throat, not even halfway there. You shake [him of M] back and forth like a rag doll, revelling in the sound of [his of M] gagging. Eventually you grow bored and shove [him of M] off your [sexual-player-penis]. [big he of M] gasps for air, eyes glued to the wand you still have clutched in your hand. [line break][first custom style]'You couldn't do it. Too bad.'[roman type][line break]you chuckle, releasing your hold on your bladder and directing a golden stream of [urine] into [his of M] face.";
		strongDignify;
		now player-fucking is DOMINANT-SUPER;
		say AfterDominationComment 1 of M;
	otherwise if sexual-penis-length >= 7:
		say "[big he of M] slowly nods, [if lady fetish is 2 and M is ballooned or the previously-ballooned of M > 0]slipping out of [his of M] harness[otherwise if M is ballooned]pushing [his of M] huge tits together[otherwise if the previously-ballooned of M > 0]pushing up [his of M] naked breasts[otherwise]unzipping [his of M] jacket[end if] for effect. Leaning forward, [he of M] takes your [SexDesc of penis] into [his of M] mouth, stalling out about halfway. The generous person you are, you decide to help. You take a handful of [his of M] hair and roughly slam [him of M] down, revelling in [his of M] lewd gagging noises as you force your [sexual-player-penis] deeper and deeper, until finally you feel [his of M] lips touch your sack. Satisfied, you shove [him of M] off and piss all over [his of M] face.";
		moderateDignify;
		say AfterDominationComment 2 of M;
	otherwise if sexual-penis-length >= 4:
		say "[big he of M] slowly nods, [if lady fetish is 2 and M is ballooned or the previously-ballooned of M > 0]slipping out of [his of M] harness[otherwise if M is ballooned]pushing [his of M] huge tits together[otherwise if the previously-ballooned of M > 0]pushing up [his of M] naked breasts[otherwise]unzipping [his of M] jacket[end if] for effect. Leaning forward, [he of M] takes your [SexDesc of penis] into [his of M] mouth, stalling out about three quarters of the way. The generous person you are, you decide to help. You take a handful of [his of M] hair and roughly slam [him of M] down, revelling in the lewd gagging noise [he of M] makes as [his of M] lips finally touch your balls. Satisfied, you pull [him of M] off, making sure to piss all over [his of M] face before tossing the wand at [his of M] feet.";
		moderateDignify;
		say AfterDominationComment 2 of M;
	otherwise:
		say "You force [NameDesc of M] to [his of M] knees, wresting the wand out of [his of M] hands. It seems to react to your touch, crackling with energy as [his of M] clothes disappear completely, leaving [if lady fetish is 2][him of M] naked except for a bright blue chastity cage[otherwise][him of M] naked[end if]. [line break][speech style of M]'Wait! That's mine!'[roman type][line break][big he of M] grabs for it, but you hold it just out of reach. [line break][variable custom style]'Come on, let me pee on you!'[roman type][line break][big he of M] seems really disgusted by the suggestion, but another glance at [his of M] wand is all it takes for [him of M] to sit there quietly as you shower [him of M] with fresh urine. Satisfied, you hand the wand back to [him of M].";
		slightDignify;
		say AfterDominationComment 2 of M;
	now the bladder of the player is 0;
	SportsGet.

To oral dominate (M - an aeromancer):
	if sexual-penis-length >= 4, say "You force [NameDesc of M] to [his of M] knees, wresting the wand out of [his of M] hands. It seems to react to your touch, crackling with energy as a pair of golden handcuffs materialise around [his of M] wrists. [line break][speech style of M]'But... that's mine...'[roman type][line break][big he of M] looks down at [his of M] bonds, crestfallen. [line break][first custom style]'If you want it back you have 30 seconds to make me cum.'[roman type][line break][big he of M] doesn't miss a beat, [if lady fetish is 2]not even looking up at you[otherwise if M is ballooned][his of M] huge breasts jiggling[otherwise if the previously-ballooned of M > 0][his of M] breasts jiggling[otherwise]not even looking up at you[end if] as [he of M] dives onto your [SexDesc of penis]. [run paragraph on]";
	if sexual-penis-length >= 9:
		say "[big he of M]'s [one of]surprisingly[or]mind-bogglingly[stopping] good at it, but you have more than enough stamina to endure until the time limit is up. Once it's established [he of M] can't handle things on [his of M] own, you grab [his of M] head with both hands, gagging [him of M] over and over again as you begin to brutally fuck [his of M] face. Still, [he of M] got you pretty close, and it only takes a few more seconds for you to shoot a massive load straight down [his of M] throat.";
		strongDignify;
		now player-fucking is DOMINANT-SUPER;
		say AfterDominationComment 3 of M;
	otherwise if sexual-penis-length >= 7:
		say "[one of]Surprisingly, [he of M]'s really good at it[or]It's still mind-boggling how good [he of M] is at it[stopping], and it's all you can do to endure past the first 15 seconds. You try to slow [him of M] down, but it's no use, and you lose control just before the time runs out, groaning through gritted teeth as your load fills [his of M] mouth. [big his of M] bondage disappears as [he of M] swallows it, and [he of M] smirks as [he of M] snatches the wand from your hand.";
		moderateDignify;
		now player-fucking is DOMINANT-NEUTRAL;
		say AfterDominationComment 4 of M;
	otherwise if sexual-penis-length >= 4:
		say "[one of]Surprisingly, [he of M]'s so good at it that[or]It's still mind-boggling how good [he of M] is at it, and[stopping] [his of M] bondage disappears as [he of M] brings you to the edge within mere moments. [BigNameDesc of M] pulls off just before you cum, leaning back and closing [his of M] eyes as you finish all over [his of M] face and [if M is ballooned]huge, balloon-like tits[otherwise]tits[end if]. You dejectedly hand the wand back to [him of M].";
		slightDignify;
		now player-fucking is DOMINANT-NEUTRAL;
		say AfterDominationComment 4 of M;
	otherwise:
		say "You force [NameDesc of M] to [his of M] knees, wresting the wand out of [his of M] hands. It seems to react to your touch, crackling with energy as [his of M] clothes disappear completely, leaving [if lady fetish is 2][him of M] naked except for a bright blue chastity cage[otherwise][him of M] naked[end if]. [line break][speech style of M]'Wait! That's mine!'[roman type][line break][big he of M] grabs for it, but you hold it just out of reach. [line break][variable custom style]'Come on, can't you make me cum first?'[roman type][line break][big he of M] takes one look at your [SexDesc of penis] and begins to giggle. [line break][speech style of M]'OK, sure.'[roman type][line break]You puff out your chest in satisfaction at having dominated [him of M], not noticing until too late as [big he of M] takes in an enormous gulp of air and releases a focused blast of wind at your crotch. A feminine moan escapes your lips as you instantly ejaculate, your [load] of [semen] splattering across your belly and thighs. You stand there dumbfounded as [he of M] yanks the wand from your hands.";
		CumThighsUp 1;
		CumBellyUp 1;
		now player-fucking is DOMINANT-SHAMEFUL;
		say AfterDominationComment 4 of M;
	if sexual-penis-length >= 4, BlowGet;
	orgasm.

To vaginal dominate (M - an aeromancer):[TODO: Consolidate]
	if sexual-penis-length >= 4, say "You force [NameDesc of M] onto [his of M] back, knocking the wand out of [his of M] hand. It seems to react to your touch, crackling with energy as solid gold chains appear all over the aeromancer's body, binding [him of M] up like a thanksgiving turkey. You smile from ear to ear, smacking [if M is ballooned][his of M] over-sized tits with your brand new magic stick[otherwise]the wand against your hand like your very own nightstick[end if]. [line break][speech style of M]'What are you going to do with me?'[roman type][line break]You offer a silent answer, lining up your [sexual-player-penis] with [his of M] slit.";
	if sexual-penis-length >= 9:
		say "[line break][speech style of M]'But you're... y-you're huge! C-couldn't you just use my ass? I'll even let you keep my wand.'[roman type][line break]Go for [his of M] ass instead?";
		if the player is consenting:
			anal dominate M;
		otherwise:
			say "Nope. You throw the wand over your shoulder, revelling in [his of M] screech of pain as your [sexual-player-penis] sinks into [his of M] incredibly tight pussy. [big he of M] treats you to a sweet song of frustrated swear words as you fuck [his of M], eventually succumbing to the sensation as [he of M] creams all over your [sexual-player-penis]. You laugh menacingly and slow down slightly. [line break][first custom style]'Where are your manners, bitch. You're not supposed to cum before I do.'[roman type][line break][big he of M] opens [his of M] mouth to answer, but you smack [him of M] in the face. It's punishment time baby! You give [his of M] the most brutal fucking you can muster, holding back your orgasm until you know [he of M]'s nearing the edge, and slam your [sexual-player-penis] in as far as it will go. [big he of M] squirms as you unload into [his of M] pussy, [his of M] shrieks tinged with desperate pleasure. You don't stop until you literally can't fit any more of your cum inside [his of M], pulling out and painting [his of M] naked stomach with a [load]. [big he of M] trembles from head to toe, gulping in air as the chains disappear along with the rest of [his of M] clothes.";
			say AfterDominationComment 5 of M;
			obsceneDignify;
			FuckGet;
	otherwise if sexual-penis-length >= 7:
		say "[line break][speech style of M]'What!? U-um, my ass is better, [please], I'll even let you keep my wand!'[roman type][line break]Go for [his of M] ass instead?";
		if the player is consenting:
			anal dominate M;
		otherwise:
			say "Nope. You throw the wand over your shoulder, revelling in [his of M] yelp of frustration as your [sexual-player-penis] sinks into [his of M] tight pussy. That, combined with the sweet song of [his of M] whimpering, brings you to the edge in a short time. You grab [his of M] hips, sinking yourself deeper and deeper until your balls slap the nape of [his of M] ass. [big he of M] shudders as you cum, [his of M] eyes wide and [his of M] teeth clenched as you shoot rope after rope of nice hot [semen] straight into [his of M] defenceless honeypot. You pull out and wipe your [sexual-player-penis] on [his of M] inner thigh when you're done. The chains disappear along with the rest of [his of M] clothes.";
			say AfterDominationComment 5 of M;
			strongDignify;
			FuckGet;
	otherwise if sexual-penis-length >= 4:
		say "[line break][speech style of M]'O-oh. Haha. W-well, my ass is way better. I promise I'll let you keep my wand.'[roman type][line break]Go for [his of M] ass instead?";
		if the player is consenting:
			anal dominate M;
		otherwise:
			say "Nope. You throw the wand over your shoulder, revelling in the sound of [his of M] expletives as your [sexual-player-penis] sinks into [his of M] tight pussy. [big he of M] whimpers through the rough fuck, completely powerless to stop you as you jack-hammer yourself to a gut clenching orgasm. You howl in pleasure as you unload, burying yourself to the hilt so every drop of your [load] ends up in [his of M] pussy. [big he of M] shudders as you pull out and wipe your [sexual-player-penis] on the side of [his of M] leg. The chains disappear along with the rest of [his of M] clothes.";
			say AfterDominationComment 5 of M;
			strongDignify;
			FuckGet;
	otherwise:
		say "You force [NameDesc of M] onto [his of M] back, knocking the wand out of [his of M] hand. It seems to react to your touch, crackling with energy as solid gold chains appear all over the aeromancer's body and bind [his of M] up like a thanksgiving turkey. You smile from ear to ear, smacking the wand against your hand like your very own nightstick. [line break][speech style of M]'Uh... what exactly do you think you're going to do with me?'[roman type][line break][big he of M] asks, a noticeable hint of mirth in [his of M] voice. You offer a silent answer, lining up your [sexual-player-penis] with [his of M] slit. [line break][speech style of M]'Look. There's no way you're getting out of here with my wand. So why don't you just give it back, and then I'll let you fuck my ass. Sound good?'[roman type][line break]Go for [his of M] ass instead?";
		if the player is consenting:
			anal dominate M;
		otherwise:
			say "[line break][speech style of M]'Woooow... OK, whatever. Just don't cum inside[if M is ballooned and lady fetish < 2]-and don't touch my boobs[end if].'[roman type][line break]You decide that's pretty fair, emitting a feminine grunt as you push forward, allowing your [sexual-player-penis] to slightly part [his of M] folds. [big he of M] sighs and moans here and there, just tight enough to feel you, but in the same way that [he of M] would probably feel a finger or the end of a sharpie. It's much more intense for you, though, and before long you pull out and spray [his of M] bare stomach and breasts with your [load]. [big he of M] sits up when the chains disappear, yanking the wand from your hand.";
			say AfterDominationComment 6 of M;
			moderateDignify;
			FuckGet;
			orgasm.

To anal dominate (M - an aeromancer):
	if sexual-penis-length >= 9:
		if lady fetish is 2, say "You throw [NameDesc of M] to the ground, ripping off [his of M] shorts and [his of M] panties in one motion. [big his of M] eyes widen as the catches a glimpse of your [if penis is penis-erect]rock hard[otherwise]hardening [sexual-player-penis][end if], and suddenly [his of M] wand begins to crackle with energy. [big his of M] face sinks as it flies through the air and lands in your hands. [line break][speech style of M]'W-what?! You're betraying me?! But I was only looking!'[roman type][line break]";
		say "Ready for [him of M] to shut up, you flip [him of M] onto [his of M] stomach, spitting on your [SexDesc of penis] before roughly slamming it into [his of M] ass. [big he of M] arches [his of M] back and moans in pleasure as you begin to thrust. [big his of M] enthusiasm gets to you pretty quickly, and before you're really able to enjoy yourself, you emit a powerful groan as you blow your load deep in [his of M] belly.";
		say AfterDominationComment 7 of M;
		moderateDignify;
		now player-fucking is DOMINANT-SUPER;
	otherwise if sexual-penis-length >= 7:
		if lady fetish is 2, say "You throw [NameDesc of M] to the ground, ripping off [his of M] shorts and [his of M] panties in one motion. [big his of M] wand crackles with energy as [he of M] points it at you, and [his of M] face visibly sinks as it flies through the air and lands in your hands. [line break][speech style of M]'This blows. Oh well. At least do me a favour and fuck me, alright?'[roman type][line break]";
		say "[big he of M] rolls over onto [his of M] hands and knees, reaching back and pointing your [sexual-player-penis] at [his of M] sphincter. It's refreshing to see so much enthusiasm, so you grab [him of M] by the hips and groan as you slide your [sexual-player-penis] into [his of M] [asshole]. [big he of M] does all the work, panting with mixed arousal and exertion as [he of M] slowly brings you to orgasm. It doesn't take long, but [he of M]'s covered in a fine sheen of sweat by the time you finally do fire off your [load] into [his of M] ass.";
		say AfterDominationComment 7 of M;
		moderateDignify;
		now player-fucking is DOMINANT-SUPER;
	otherwise if sexual-penis-length >= 4:
		if lady fetish is 2, say "You throw [NameDesc of M] to the ground, ripping off [his of M] shorts and [his of M] panties in one motion. [big his of M] wand crackles with energy as [he of M] points it at you, and [his of M] face visibly sinks as it flies through the air and lands in your hands. [line break][speech style of M]'This blows. Oh well. At least do me a favour and fuck me, alright?'[roman type][line break]";
		say "[big he of M] rolls over onto [his of M] hands and knees, reaching back and pointing your [sexual-player-penis] at [his of M] sphincter. It's refreshing to see so much enthusiasm, so you grab [him of M] by the hips and groan as you slide your [sexual-player-penis] into [his of M] [asshole]. [big he of M] does all the work, panting from exertion as [he of M] works [his of M] hips back against you. You don't last long, groaning with pleasure as you pull out and jizz all over [his of M] back.";
		say AfterDominationComment 7 of M;
		slightDignify;
		now player-fucking is DOMINANT-SUPER;
	otherwise:
		if lady fetish is 2, say "You force [NameDesc of M] onto [his of M] back, pulling down [his of M] shorts and ripping off [his of M] panties. [big he of M] begins to raise [his of M] wand, but you immediately yank it out of [his of M] hands. It seems to react to your touch, crackling with energy as [his of M] clothes disappear completely, leaving [him of M] naked except for the bright blue cage between his legs. [big he of M] puts [his of M] hand on your shoulder as you line up your [SexDesc of penis] with [his of M] asshole. [line break][speech style of M]'Look, I know you're trying to dominate me and all, but I'm really going to need my wand back. Now.'[roman type][line break][big he of M] grins as you hand it back to [him of M].[line break][speech style of M]'Thanks a lot. OK, go ahead.'[roman type][line break]";
		otherwise say "[big he of M] grins as you hand the wand back to [him of M].[line break][speech style of M]'Thanks a lot. OK, go ahead.'[roman type][line break]";
		say "[big he of M] lays down on [his of M] stomach, pulling apart [his of M] ass cheeks as you push your [sexual-player-penis] into [his of M] asshole. You lay back and let [him of M] do all the work, moaning in pleasure as [he of M] brings you to orgasm in a very short time.";[no dignity bonus]
		now player-fucking is DOMINANT-NEUTRAL;
		say AfterDominationComment 8 of M;
		Calm M;
	AnalGet;
	orgasm.

To say AfterDominationComment (N - a number) of (M - an aeromancer):
	say "[speech style of M]";
	if N is 0:
		say "'[one of]I'll get you back for this, jerk!'[or]You're going to pay for this, jerk!'[in random order]";
	otherwise if N is 1:
		say "'[one of]S-so I guess the wand is yours then...'[or]D-did you really have to pee on me?'[in random order]";
	otherwise if N is 2:
		say "'[one of]UGH, I'll get you back for this.'[or]GROSS! You're SO going to pay for that.'[in random order]";
	otherwise if N is 3:
		say "'[one of]I'll get my wand back, you know. S-someday...'[or]I c-can't believe I lost my wand...'[in random order]";
	otherwise if N is 4:
		say "'[one of]I'm going to have LOTS of fun experimenting on you later.'[or]Watch out. Now you've really put some wind in my sails...'[or]The experiments I have planned for you later are going to blow you away.'[in random order]";
	otherwise if N is 5:
		say "'[one of]T-this isn't over.'[or]I w-won't forget this.'[in random order]";
	otherwise if N is 6:
		say "'[one of]See you later, idiot.'[or]Later, idiot.'[in random order]";
	otherwise if N is 7:
		say "'[one of]When I get my wand back, watch out.'[or]Enjoy my wand while you can.'[in random order]";
	otherwise:
		say "'[one of]I have experiments to plan. See you.'[or]Later.'[in random order]";
	say "[roman type][line break]";

To say DominationEscapeFlav of (M - an aeromancer):
	if player-fucking is not DOMINANT-SUPER:
		say "A gust of wind picks up [NameDesc of M] and whisks [him of M] away!";
	otherwise:
		say "[BigNameDesc of M] crawls away as soon as [he of M] has the strength. You've got a feeling you won't be seeing [him of M] again for a while.";

To replace (M - an aeromancer) after domination:
	if player-fucking is not DOMINANT-SUPER:
		if debugmode > 0, say "Regionally placing [M].";
		distract M;
		regionally place M;
	otherwise:
		destroy M.

To say DominanceFailed of (M - an aeromancer):
	say "[line break]A gust of wind picks up [NameDesc of M] and carries [him of M] away, leaving you to stew in your own embarrassment as your chains dissolve into thin air.".

To compute unique dominance reward of (M - an aeromancer):
	compute default dominance reward of M;
	if player-fucking is DOMINANT-SUPER:
		now a random magic wand is held by the player;
		DifficultyUp M by 4;
	DelicateDown 1.

To say DominanceFailure of (M - an aeromancer):
	say "You shove [NameDesc of M] to the ground and wrench the wand from [his of M] hand. It heats up in your gasp, emitting blue sparks as golden chains explode from the tip, twisting rapidly in the air before coiling tightly around your body. [BigNameDesc of M] smirks as the wand floats back to her, forcing you to your knees with [if M is confident aeromancer]a tiny flick[otherwise]an exaggerated flourish[end if] of [his of M] wrist.".

To compute failed dominance punishment of (M - an aeromancer):
	if the size of penis is 0:
		repeat with C running through worn total protection clothing:
			say "[BigNameDesc of M] tears through your [printed name of C] with a strong gust of wind![line break]";
		bore M;
		if there is a worn insertable thing penetrating asshole:
			let P be a random insertable thing penetrating asshole;
			say "[speech style of M]What I have planned for you is pretty corked up![roman type] [BigNameDesc of M] taps your [printed name of P] with [his of M] wand, [if P is expansion and inflation fetish is 1]causing your belly to suddenly expand with what feels like a lot of air[otherwise]causing your plug to suddenly expand, shunting a lot of air into your belly[end if].";
			if P is expansion:
				if inflation fetish is 1, AssFill 5 Air;
			otherwise:
				SizeUp P by 1;
				if inflation fetish is 1, AssFill 1 Air;
				now P is expansion;
		otherwise:
			say "[speech style of M]This next experiment is really going to [if belly liquid types > 0]suck[otherwise]blow[end if]![roman type] [BigNameDesc of M] presses the tip of [his of M] wand to your belly button, laughing uncontrollably as your belly expands audibly with a rush of air.[if belly liquid types > 0] You hear a gurgle as the liquid contents of your belly are shunted out the other end![end if]";
			SemenPuddleUp the semen volume of belly;
			MilkPuddleUp the milk volume of belly;
			UrinePuddleUp the urine volume of belly;
			empty belly liquids;
			AssFill 10 Air;
			strongHumiliate;
	otherwise if the size of penis < 3 or a random number between 1 and 7 < the science history of M:
		humiliate 50;
		compute tornado experiment of M;
	otherwise:
		let T be a random off-stage research airhancer;
		if T is actually summonable:
			say "[speech style of M]'I think you[']ll find my methods to be airtight!'[roman type][line break][BigNameDesc of M] touches [his of M] wand to your [ShortDesc of penis], whistling as air swirls around your length. You watch as a semi-transparent sheet of compressed air layers itself over your shaft, causing your [if the player is a bit horny]erection[otherwise]half-erection[end if] to slowly go away as a golden bracelet materialises around your wrist.[line break][speech style of M]I call this my research airhancer. Get it? AIR-hancer?[roman type] [big he of M] pauses to laugh uncontrollably. [line break][speech style of M]So, this thing monitors the air pressure in your belly, and if it dips too low, it should keep your dick from getting hard. No more sex for you unless you're a good little test subject and help out with my experiments! I'm pretty sure I'm the only one who can take it off, but hey, I guess you can't blow it until you try! Hahaha!'[roman type][line break]";
			summon T;
			calm M;
		otherwise:
			say "[speech style of M]'This experiment-... You won't believe-... Ugh. You threw off my train of thought. I'll be back.'[roman type]";
			compute sissification;
			DifficultyUp M by 1;
			if the size of penis > 0:
				PenisDown 1;
				say "Your penis shrinks into a [ShortDesc of penis]!";
		bore M.

To compute tornado experiment of (M - an aeromancer):
	say "[speech style of M]I[']m sorry about this experiment. It really blows loads![roman type][line break]A tiny tornado flows out of the tip of [his of M] wand, grabbing your [ShortDesc of penis] and locking it in a prison of powerful suction. [run paragraph on]";
	if the size of penis >= 9 or the health of M < 3:
		say "It feels incredible for a moment, but the cone dissipates after only a couple seconds. [line break][speech style of M]'Wow, looks like I[']m gonna have to turn up the juice!'[roman type][line break][BigNameDesc of M] furrows [his of M] brow as [he of M] raises [his of M] wand again, whistling forcefully as a second wind tunnel twice as large as the original slowly flows from the tip of [his of M] wand, sucking in air from all around you as it assaults your penis with a rapidly intensifying vortex of pressure. The aeromancer struggles to maintain the spell, clothes ruffling in the wind and eventually tearing off as the suction builds and builds, torturing you with an ever mounting onslaught of pleasure.";
		if the science history of M > 4 or M is confident aeromancer or M is ballooned or the size of penis < 3:[worse punishment from the skilled aeromancer]
			say "[line break]You suddenly lose control, groaning as your [ShortDesc of penis] explodes into the cone, which sends your [semen] flying across the room in every direction. [BigNameDesc of M] stands up slowly[if bukkake fetish is 1], thoroughly coated in your load[otherwise], [one of]obviously surprised at[or]pleased with[stopping] [his of M] own strength[end if].";
			SemenPuddleUp the size of penis;
			if bukkake fetish is 1:
				CumFaceUp 1;
				CumTitsUp 1;
				CumThighsUp 1;
				CumBellyUp 1;
			Satisfy M;
		otherwise:
			say "[line break][speech style of M]Oh Shi-![roman type] [BigNameDesc of M] suddenly loses control, screaming as [he of M] is pulled face first into the vortex and directly onto your rock hard cock. [big he of M] gags lewdly as your [ShortDesc of penis] slams into the back of [his of M] throat, which is that last little push that finally sends you over the edge. You groan as your cock unloads into [his of M] mouth, filling [his of M] belly with wave after wave of your [semen]. [big he of M] collapses in front of you, [if bukkake fetish is 1]lines of white rolling down [his of M] chin[otherwise]shivering[end if] as [he of M] clutches [his of M] heavily distended belly.";
			BlowGet;
			Bore M;
		orgasm;
	otherwise:
		say "It feels incredible! The aeromancer makes sure not to let you enjoy it though, deviously manipulating the width of the tunnel according to the intensity of your moans. [if the size of penis >= 7][big he of M] holds your dick hostage for what feels like an eternity, cruelly releasing you from the spell just before you're able to cum[otherwise][big he of M] holds your dick hostage for what feels like an eternity, cruelly releasing you from [his of M] spell just after you go over the edge, ensuring that your orgasm is as short and unsatisfying as possible[end if]. You can't help your [if the delicateness of the player < 7]infuriated[otherwise]pleading[end if] stare as [he of M] slowly climbs to [his of M] feet.";
		if the size of penis < 7:
			orgasm;
		Arouse 3000;
		satisfy M;
	increase the science history of M by 1.

Part 6 - Conversation

Section 1 - Greeting

To say FirstResponse of (M - an aeromancer):
	say "[speech style of M]'Well hello there. You look quite... unique.'[roman type][line break]";
	alwayscutshow figure of aeromancer interact 15 for M.

To say RepeatResponse of (M - an aeromancer):
	say "[speech style of M]'[if M is buddy][one of]Oh it's you again. Sup.'[or]Hey. Got any good puns to do with air?'[or]Good to see you again.'[at random][otherwise][one of]Oh it's you. I thought I smelled something funny.'[or]Oh it's only you.'[or]We just keep bumping into each other, don't we. You're not stalking me, are you?'[at random][roman type][line break]";
	alwayscutshow figure of aeromancer interact 16 for M.

To say SubmissiveResponse of (M - an aeromancer):
	if the class of the player is faerie:
		say "[speech style of M]'[one of]Hmm, most fairies are obsessed with getting pregnant, but it seems like all you care about is sex!'[or]I knew you[']d love my experiments, lucky for you I'm close to a blow through! Hahaha!'[then at random][roman type][line break]";
	otherwise if the class of the player is vixen:
		say "[speech style of M]'[one of]Wow, you again? I thought you[']d be wearing a disguise after I embarrassed you like that. You must be really confident.'[or]Wow, it's you! Sorry, but have you ever thought about how awful you are at running away?'[at random][roman type][line break]";
	otherwise:
		say "[speech style of M]'[one of]Hmm, strange decision to show your face here again.'[or]Ready for some more science?'[or]Hahaha... your eagerness to be a test subject [please]s me greatly!'[at random][roman type][line break]";
	alwayscutshow figure of aeromancer interact 2 for M.

To say AttentionResponse of (M - an aeromancer) with (N - a monster):
	say "[speech style of M]'[if the class of the player is faerie]You're talking to me? Just like a fairy to be carefree in a situation like this...'[otherwise]Why are you talking to me? Seems to me like you have bigger fish to fry right now...'[end if][roman type][line break]";
	alwayscutshow figure of aeromancer interact 2 for M.

To say UnAnnoyedResponse of (M - an aeromancer):
	say "[speech style of M]'[one of]You just inspired me to come up with another pun!'[or]You're distracting me, but luckily I already finished my next pun.'[or]That's nice. More importantly, I came up with more puns!'[at random][roman type]";

To say MildAnnoyedResponse of (M - an aeromancer):
	say "[speech style of M]'[one of]That's nice. Now be quiet, I need to come up with another pun.[or]Cool, now be quiet, I'm thinking of another pun.'[or]Shh, I'm thinking of more puns.'[at random][roman type][line break]";
	alwayscutshow figure of aeromancer interact 17 for M.

To say AnnoyedResponse of (M - an aeromancer):
	say "[speech style of M]'[one of]Quit interrupting me, I[']m trying to come up with another pun![or]Shut up, I'm trying to come up with another pun.'[or]Ugh, you just ruined a really good pun!'[or]Stop interrupting, I need to come up with another pun.'[at random][roman type][line break]";
	alwayscutshow figure of aeromancer interact 17 for M.

To say TauntAccepted of (M - an aeromancer):
	if M is wand-empowered:
		say "[speech style of M]'There's no way you're stealing my wand again! I'm out of here!'[roman type][line break]A gust of wind blows through the room, whisking [NameDesc of M] away.";
		regionally place M;
	otherwise:
		say "[speech style of M]'Oh yeah, w-well...What if I just leave then?'[roman type][line break][BigNameDesc of M] blushes slightly and backs away.";

To say TauntRejected of (M - an aeromancer):
	say "[speech style of M]'[one of]Stop blowing out your mouth when I should be blowing up your ass!'[or]If you[']re going to hiss at me, I want to hear it from your other end!'[at random][roman type][line break]";
	alwayscutshow figure of aeromancer interact 9 for M.

Section 2 - Questioning

To compute annoyance of (M - an aeromancer):
	if M is unfriendly:
		say "The aeromancer ignores your question. [line break][speech style of M]'Too much talking, not enough science.'[roman type][line break]";
	otherwise:
		say "[speech style of M]'Okay that's enough questions now. I'm a busy woman, you know.'[roman type][line break]";
	alwayscutshow figure of aeromancer interact 17 for M.

To compute teaching of (M - an aeromancer):
	if playerRegion is Woods and inflation fetish is 1 and the player is a june 2019 top donator:
		teach safefloating from M;
	otherwise:
		say "[speech style of M]'Are you a fan of alchemy? If I tell you a secret you have to promise not to tell anyone...'[roman type][line break]";
		cutshow figure of aeromancer interact 17 for M;
		teach fastcrafting;
	if the questioned of M <= the mild-annoyance threshold of M:
		ModerateConvoFatigue M;
	otherwise:
		HeavyConvoFatigue M.

To say WhereAnswer of (M - an aeromancer):
	say "[speech style of M]'[if the class of the player is faerie]You wouldn[']t remember the answer if I told you.'[otherwise]I believe we are currently in dimension C-137.'[end if][roman type][line break]";
	alwayscutshow figure of aeromancer interact 18 for M.

To say WhoAnswer of (M - an aeromancer):
	say "[speech style of M]'I'm nobody of importance. Just a humble travelling scientist.'[roman type][line break]";
	alwayscutshow figure of aeromancer interact 6 for M.

To say StoryAnswer of (M - an aeromancer):
	say "[speech style of M]'That's too long a tale to explain right now. Maybe one day it'll get made into a TV series though.'[roman type][line break]";
	alwayscutshow figure of aeromancer interact 18 for M.

To say EscapeAnswer of (M - an aeromancer):
	say "[speech style of M]'I think you have to defeat some kind of [']final boss['], whatever that means.'[roman type][line break]";
	alwayscutshow figure of aeromancer interact 5 for M.

To say AdviceAnswer of (M - an aeromancer):
	say "[speech style of M]'[one of]If there's a room you might need to spend a lot of time on your knees, for example a room with furniture, maybe it would make sense to not risk opening the container in that room, in case it's trapped and releases pink smoke everywhere.'[or]Pretty much every living thing in this world seems to like being given shiny jewellery. Even the mindless ones like the sex dolls.'[or]I hear there's a machine somewhere that gives you magic tattoos depending on what you donate it. I bet that giving it a potion you've crafted might get you a tattoo that makes you smarter!'[in random order][roman type][line break]";
	alwayscutshow figure of aeromancer interact 16 for M.

Section 3 - Drink Requesting

To compute friendly drink of (M - an aeromancer):
	say "[speech style of M]'I'm sorry, I've got nothing!'[roman type][line break]";
	alwayscutshow figure of aeromancer interact 4 for M.

To compute unfriendly drink of (M - an aeromancer):
	say "[speech style of M]'Shut up, I'm trying to think of another pun!'[roman type][line break]";
	alwayscutshow figure of aeromancer interact 17 for M;
	now M is interested;
	now the boredom of M is 0.

Part 7 - Variants

Section 1 - Confident Aeromancer

confident aeromancer is an aeromancer. The text-shortcut of confident aeromancer is "mae".
To say MediumDesc of (M - confident aeromancer):
	say "smirking [if M is ballooned]massive-breasted [end if]aeromancer".

Definition: confident aeromancer is dungeon dwelling: decide no.

The previously-ballooned of confident aeromancer is usually 1.

This is the spawn initial woods aeromancer rule:
	if the number of alive aeromancers in the woods is 0 and inflation fetish is 1:
		let M be a random off-stage confident aeromancer;
		summon M in the woods.
The spawn initial woods aeromancer rule is listed in the setting up woods monsters rules.

To compute appearance assessment of (M - confident aeromancer):
	FavourDown M by the science requests of M * 2;
	let A be the air volume of belly + the air volume of breasts + the air volume of belly;
	if A >= 15:
		say "[speech style of M]'[one of]WOW, what wind elemental fucked YOUR brains out? I probably shouldn[']t bother asking, since you[']re obviously a slut for getting blown up like a balloon, but how would you like to help me with an experiment?'[or]You look kind of bloated. Did you wake up on the wrong side of a djinn[']s cloud buster? Hahaha! Help me out with an experiment... if you want. *snrt*'[or]Hey, you probably get this a lot, but you look JUST like this balloon I fucked in college. Hahaha! Want to help me out with an experiment?'[at random][roman type][line break]";
	otherwise if the class of the player is schoolgirl:
		say "[speech style of M]'[one of]So, freshman. Want to help out with one of my experiments, or am I going to have to fog you.'[or]Hey, you like tentacles right? OK, so I have this experiment I want to try out, but if you say no, I'm going to use my magic to make you my bitch. Win win for both of us, right?'[or]You obviously have no magical talent, so you'd really have no chance of taking me on in a fight. So, agree to help me out with an experiment, or I'm going to use my magic to torture you until I get bored! Sound good?'[at random][roman type] [line break]";
	otherwise if the player is exposed:
		say "[speech style of M]'[one of]Wow, a wench outside the dungeon! You don't see that every day! [or]My motto is: ['][if vagina is lewdly exposed][cunt][otherwise if penis is lewdly exposed and penis is tiny][sissy] clitty[otherwise if asshole is lewdly exposed]butthole[otherwise if penis is lewdly exposed]willy[otherwise]nipples[end if] on display, fucked by guards all day!['] [then at random]FYI I'm pretty powerful, so I'm going to experiment on you either way, but I'll go easier on you if you accept willingly. Sound good?[roman type][line break]";
	otherwise:
		say "[speech style of M]'[one of]Hey, I've been looking for a new research subject, sooo... you're hired![or]I can tell by your heavy breathing, you[']re perfect for this next experiment![or]Hey if it isn't my favourite research subject![stopping] I'm pretty strong, so you don't have much of a choice, but I'll go easier on you if you cooperate. Sound good?[roman type][line break]";
	if M is interested:
		if the player is bimbo consenting:
			FavourUp M;
			compute aeromancer science of M;
			now the science requests of M is 0;
			if M is unfriendly, satisfy M;
		otherwise if A < 15 or the science requests of M > 2:
			say "[speech style of M]'[one of]OK! Hope this doesn[']t blow up in your face!'[or]An airhead like you should really go back to the dungeon, but since you're here...'[or]Open air isn't good for stupid people. Trust me, inside air will work way better on you.'[at random][roman type][line break]";
			now the science requests of M is 0;
			anger M;
		otherwise:
			say "[speech style of M]'[one of]Oh. That's pretty cheeky of you, considering I've been so friendly. You probably don't get how powerful I am, but I'll really blow up if you breeze me like this again.'[or]Hahaha! That's SO funny. It's like your head is full of hot air, you fucking bitch! HAHAHA! Don't refuse me again.'[or]WOW, do you have any idea how powerful I am? I can do anything I want! Nobody fucking says no to me. Don't this I'll let a mistake like this slide again...'[at random][roman type][line break]";
			increase the science requests of M by 1;
			bore M.

To compute aeromancer science of (M - confident aeromancer):
	increase the science history of M by 1;
	let N be the science history of M;
	if N > 5, now N is 5;
	let R be a random number between 0 and N;[TODO: summons wasp]
	say "[speech style of M]'[one of]Smart! OK, let's see...' [or]Good choice! Here we go...' [or]That was the right move. Now, stay still...' [at random][roman type]Pointing [his of M] wand towards you, [NameDesc of M] concentrates. ";
	if R is 0:
		say "You feel your whole body exploding outwards!";
		if the largeness of breasts < max breast size, BustInflate 12;
		AssFill (belly limit - the total fill of belly) air;
		if the total volume of hips < max ass size, AssInflate 7;
	otherwise if R is 1:
		if the raw strength of the player < 10:
			say "You feel your muscles inflate! The bizarre sensation leaves you feeling stronger but also [if the player is a bit horny]even hotter on the inside[otherwise]you feel like you're getting hotter inside[end if].";
			StrengthUp 1;
		otherwise:
			say "Nothing physical changes, but you feel a weird, strong heat growing at your crotch!";
		arouse 3000;
	otherwise if R is 2:
		let K be a random off-stage pump plug panties;
		let C be a random worn knickers;
		if K is actually summonable:
			say "A [ShortDesc of K] materialises on and inside of you! [line break][variable custom style][if the openness of asshole < 3]Ouch![otherwise if the openness of asshole < 6 or the anal sex addiction of the player < 4]Eek![otherwise]Ooh![end if][roman type][line break]";
			summon K cursed with quest;
		otherwise if the bladder of the player > 0:
			say "Air fills your bladder, putting immense pressure on it! You can't help but start to wet yourself.";
			now delayed urination is 1;
			try urinating;
		otherwise if C is transformable clothing:
			say "Your [C] is suddenly hit by a beam of light from [his of M] wand!";
			potentially transform C;
		otherwise:
			say "Air suddenly forces its way inside your [asshole], stretching your sphincter as it makes its way in!";
			gape asshole times 1;
			AssFill 5 air;
	otherwise if R is 3:
		say "Tentacles of air spill from the tip and begin to whip around you, hitting you from all sides with stinging strikes!";
		PainUp 1;
		if unlucky is 1:
			let N be the number of worn clothing;
			repeat with C running through worn currently uncovered tearable clothing:
				say "A tentacle disappears into your [printed name of C], which explodes into a cloud of shredded [the clothing-material of C] confetti!";
				destroy C;
			if the number of worn clothing is N, DelicateUp 1;
	otherwise: [Selkie: it'd be sweet if she could add a step or two to a latex-doll transformation that was underway]
		say "A beam flies straight from [his of M] wand to your face!";
		if a random number between 1 and 3 > 1 and (the raw largeness of hair + 1) < max hair length:
			say "Your hair grows and rapidly shifts in colour!";
			HairUp 2;
		if a random number between 1 and 3 > 1 and the make-up of face < 3:
			say "Your make up gets thicker!";
			FaceUp 1;
		if a random number between 1 and 4 > 1:
			say "You feel smarter!";
			IntUp 2;
		if a random number between 1 and 3 > 1 and the lips of face < 2 + artificial enhancements fetish:
			say "Your lips get plumper!";
			LipsUp 1;
		say "Your head feels a bit more giddy!";
		OralSexAddictUp 1;
		SexAddictUp 1;
	say "[speech style of M]'[one of]Whew, that was awesome!'[or]Thanks for your help.'[or]Interesting...'[or]Well that was unexpected...'[or]Curiouser and curiouser.'[in random order][roman type] [BigNameDesc of M] [one of]jots a short note[or]smirks at you and writes just a word or two[or]makes a quick note[or]writes a scribble[at random] in [his of M] pocket book and then closes it.".

To compute unique climax of (M - confident aeromancer) in (F - asshole):
	compute creampie of M in F;
	say "[BigNameDesc of M] releases [his of M] hold on you rather abruptly, chuckling as you smack the ground. [big he of M] loses interest.".

To say CreampieFlav of (M - confident aeromancer) in (F - asshole):
	say "[BigNameDesc of M] fucks you harder and harder, wild gusts of wind screaming through the trees as [his of M] magical phallus pulses in climax. You groan involuntarily as your belly fills up with torrent after torrent of compressed air, each one leaving a wider smirk on the aeromancer's face.";

To say CreampieFlav of (M - confident aeromancer) in (F - vagina):
	say "[BigNameDesc of M] fucks you harder and harder, screaming with delight as [his of M] magical phallus floods your [vagina] with warm, glittery [semen]. [big he of M] releases [his of M] hold on your body as the gooey fluid soaks into your skin, causing a strange tingling feeling to travel up your torso and into your chest. You watch with [horror] as your breasts suddenly balloon with air!";
	cutshow figure of aeromancer cutscene 5 for M;
	say "[BigNameDesc of M] drops you on your back, taking a brief moment to smirk at [his of M] handiwork before losing interest.".

To say TwosomePrep of (M - confident aeromancer) in (F - asshole):
	say "[BigNameDesc of M] stretches out [his of M] arms and hands towards you. You yelp as you are suddenly forced several feet off the ground by a powerful gust of wind. Cackling with glee, the aeromancer uses [his of M] mastery of air to buffet you from one end of the [if M is in the Woods]clearing[otherwise]room[end if] to the other, eventually leaving you suspended in the centre, at just above waist height. [big he of M] takes a couple steps forward, barely containing [his of M] mirth as you [if the relevant sex addiction of M < 7]desperately try and fail to get purchase on the ground below[otherwise]look up at [him of M] in wide-eyed anticipation[end if].".

[CURRENTLY UNUSED]
[To say FuckholePenetrationFlav of (M - confident aeromancer):
	say "[BigNameDesc of M] stretches out [his of M] arms and hands towards you. You yelp as you are suddenly forced several feet off the ground by a powerful gust of wind. Cackling with glee, the aeromancer uses [his of M] mastery of air to buffet you from one end of the [if M is in the Woods]clearing[otherwise]room[end if] to the other, eventually leaving you suspended in the centre, at just above waist height. [big he of M] takes a couple of steps forward, barely containing [his of M] mirth as you [if the relevant sex addiction of M < 7]desperately try but fail to get purchase on the ground below[otherwise]look up at [him of M] in wide-eyed anticipation[end if].";
	say "[speech style of M]'[one of]So, now that you've had some HANG time, I think you're ready for some WANG time!'[or]Uh oh, looks like a pretty strong breeze coming in from the south!'[or]Round and round [if the player is female]she goes, how she got that slutty[otherwise if the player is a sissy]she goes! How she became such a sissy[otherwise]he goes! How hard a fucking can he take[end if], nobody knows!'[or]The wind told me to tell you something! You[']re a slut! Hahahaha!'[in random order][roman type]".]

To say PenetrationFlav of (M - confident aeromancer) in (F - asshole):
	say "The aeromancer raises [his of M] wand, which glows brightly as the air around you compresses itself into a massive, disembodied [manly-penis], only visible from the sheer speed at which it shoots up your [asshole]. Shrieking gusts of wind lash at your skin and clothes as the magical sex organ begins to ruthlessly fuck you.".

To say PenetrationFlav of (M - confident aeromancer) in (F - vagina):
	say "The air around you compresses itself into a massive, disembodied [manly-penis], trailing a shimmering trail of blue sparks as it shoots into your [vagina]. Shrieking gusts of wind lash at your skin and clothes as the magical sex organ begins to ruthlessly fuck you.".

To say FriendlyPenetrationFlav of (M - confident aeromancer) in (F - asshole):
	say PenetrationFlav of M in F.

To say FriendlyPenetrationFlav of (M - confident aeromancer) in (F - vagina):
	say PenetrationFlav of M in F.

Aeromancer ends here.
