Demoness by Monster begins here.

A demoness is a kind of monster. A demoness is intelligent. The favour of a demoness is usually 8. The leftover-type of a demoness is usually 105. A demoness can be soul-seeking. A demoness can be soul-interested. A demoness has a number called channelling. A demoness can be penis-mode or heel-mode. A demoness is usually heel-mode.

Definition: a demoness is woods dwelling: decide yes.

Definition: a demoness is raunchy: decide yes.
Definition: a demoness is infernal: decide yes.
Definition: a demoness is wenchy: decide yes.
Definition: a demoness is human: decide yes.
Definition: a demoness is father material: decide yes.

A demoness has a number called excitement. The excitement of a demoness is usually 0.

Definition: a demoness is willing to do anal: decide yes.

Definition: a demoness (called M) is willing to do vaginal:
	if diaper quest is 1, decide no;
	if M is soul-seeking or M is soul-interested or the vaginalvirgin of the player is 0, decide yes;[she can't fuck virgins unless they specifically ask for it]
	if presented-orifice is vagina, decide yes;
	decide no.

Definition: a demoness is willing to do oral:
	if diaper quest is 1, decide no;
	decide yes.

Definition: a demoness is willing to charm snakes:
	if diaper quest is 1, decide no;
	decide yes.

Definition: a demoness is willing to urinate: decide yes.

To decide which number is the freebie-reluctance of (M - a demoness):
	decide on 10.

Understand "demon" as demoness.

To say ShortDesc of (M - a demoness):
	if lady fetish is 2, say "demon";
	otherwise say "demoness".

To say SoulDesc of (M - a demoness):
	if M is power-peaked, say "greater ";

Figure of Demoness is the file "NPCs/Forest/Demoness/demoness1.png".

Figure of demoness interact 1 is the file "NPCs/Forest/Demoness/cutscene-demoness-interact1.png".
Figure of demoness interact 2 is the file "NPCs/Forest/Demoness/cutscene-demoness-interact2.png".
Figure of demoness interact 3 is the file "NPCs/Forest/Demoness/cutscene-demoness-interact3.png".
Figure of demoness interact 4 is the file "NPCs/Forest/Demoness/cutscene-demoness-interact4.png".
Figure of demoness interact 5 is the file "NPCs/Forest/Demoness/cutscene-demoness-interact5.png".
Figure of demoness interact 6 is the file "NPCs/Forest/Demoness/cutscene-demoness-interact6.png".
Figure of demoness interact 7 is the file "NPCs/Forest/Demoness/cutscene-demoness-interact7.png".
Figure of demoness interact 8 is the file "NPCs/Forest/Demoness/cutscene-demoness-interact8.png".
Figure of demoness interact 9 is the file "NPCs/Forest/Demoness/cutscene-demoness-interact9.png".
Figure of demoness interact 10 is the file "NPCs/Forest/Demoness/cutscene-demoness-interact10.png".

Figure of demoness cutscene 4 is the file "NPCs/Forest/Demoness/cutscene-demoness-heat1.png".
Figure of demoness cutscene 14 is the file "NPCs/Forest/Demoness/cutscene-demoness-strut1.png".

To decide which figure-name is the monster-image of (M - a demoness):
	decide on figure of demoness.

To decide which figure-name is the anal-sex-monster-image of (M - a demoness):
	decide on figure of demoness cutscene 2.

To decide which figure-name is the vaginal-sex-monster-image of (M - a demoness):
	if futanari fetish is 1, decide on figure of demoness cutscene 13; [futa with balls]
	decide on figure of Missing NPC.

To decide which figure-name is the oral-sex-monster-image of (M - a demoness):
	if futanari fetish > 0, decide on figure of demoness cutscene 8; [futa with or without balls]
	decide on figure of demoness cutscene 7.

infernaler demoness is a demoness. The text-shortcut of infernaler demoness is "ide". Understand "infernal" as infernaler demoness.
To say MediumDesc of (M - infernaler demoness):
	say "[SoulDesc of M]infernal demoness".

cackling demoness is a demoness. The text-shortcut of cackling demoness is "cde".
To say MediumDesc of (M - cackling demoness):
	say "[SoulDesc of M]cackling demoness".

An fiery demoness is a demoness. The text-shortcut of fiery demoness is "fde".
To say MediumDesc of (M - fiery demoness):
	say "[SoulDesc of M]fiery demoness".

An unholy demoness is a demoness. The text-shortcut of unholy demoness is "ude".
To say MediumDesc of (M - unholy demoness):
	say "[SoulDesc of M]unholy demoness".

To say MonsterDesc of (M - a demoness):
	if lady fetish is 2:
		say "An aura of terrifying evil surrounds this [man of M]. [big his of M] lithe, statuesque features are [if diaper quest is 1]covered up by shiny red clothing[otherwise]a bit too perfect, and so much heat is emanating from [him of M] that the air around [him of M] shimmers. [big he of M] is wearing an extremely provocative shiny red dress and tall black heels with glass dildos for stilettos. Two [DemonSkin of M] horns rise up from [his of M] long blonde hair[end if][if doomed is 5]. Pink lightning ominously crackles around [him of M]...[otherwise].[end if]";
	otherwise:
		say "An aura of terrifying evil surrounds this [man of M]. The demoness has a statuesque humanoid figure[if diaper quest is 1] and shiny red clothing[otherwise]. [big his of M] body is just a bit too perfect, and so much heat is emanating from [him of M] that the air around [him of M] slightly shimmers. [big he of M] is wearing an extremely provocative shiny red dress, and tall black heels with glass dildos for stilettos. Two [DemonSkin of M] horns rise up from [his of M] long blonde hair[end if][if doomed is 5]. Pink lightning ominously crackles around [him of M]...[otherwise].[end if]";
	if M is power-peaked, say "[line break][big his of M] aura has completely changed ever since [he of M] took your soul.";

To say MonsterDesc of (M - an abyssal demoness):
	if lady fetish is 2:
		say "An aura of terrifying evil surrounds this [man of M]. [big he of M] has the body of an Olympian swimmer, coupled with blue skin and curved [DemonSkin of M] horns that give [him of M] a decidedly otherworldly appearance. [big he of M] is wearing a pair of tall black high heels with glass dildos for stilettos, a provocative black bikini top, and a matching nylon miniskirt, which does nothing to conceal the [DemonSkin of M] [manly-penis] hanging between [his of M] legs. The air around [him of M] seems to shift and morph as if he were surrounded by a bubble of moving water. Pinpricks of [if doomed is 5]magenta[otherwise]yellow[end if] light are visible behind the veil covering [his of M] face.";
	otherwise:
		say "An aura of terrifying evil surrounds this [man of M]. [big he of M] [if pregnancy fetish is not 1]has the body of an Olympian swimmer[otherwise]has a statuesque and clearly pregnant figure[end if] coupled with blue skin and curved [DemonSkin of M] horns that give [him of M] a decidedly otherworldly appearance. [if pregnancy fetish is 1][big he of M] is completely naked except for a pair of tall black high heels with glass dildos for stilettos[otherwise][big he of M] is wearing a pair of tall black high heels with glass dildos for stilettos, a provocative black bikini top, and a matching nylon miniskirt, which only barely covers [his of M] crotch[end if]. The air around [him of M] seems to shift and morph as if [he of M] were surrounded by a bubble of moving water. Pinpricks of [if doomed is 5]magenta[otherwise]yellow[end if] light are visible behind the veil covering [his of M] face.";
	if M is power-peaked, say "[line break][big his of M] aura has completely changed ever since [he of M] took your soul.";

Definition: a demoness is power-peaked:
	if soul gem is carried by it, decide yes;
	decide no.

To say DemonSkin of (M - a demoness):
	if M is power-peaked, say "fiery-orange";
	otherwise say "candy-red".

To say DemonSkin of (M - an abyssal demoness):
	if M is power-peaked, say "ebony";
	otherwise say "midnight-blue";

To say MonsterComment of (M - a demoness):
	if diaper quest is 0:
		if M is power-peaked:
			say "[variable custom style][one of]I've made a huge mistake...[or]I can't believe I let [him of M] take it...[or]There's a way to get it back, right?[in random order]";
		otherwise if the class of the player is worshipper:
			say "[variable custom style][one of]Submission is... my only option?[or]My mind is telling me I can't possibly resist [his of M] will.[or]I can't oppose [him of M]. I don't know how I know that, I just know I can't.[in random order]";
		otherwise if the class of the player is priestess:
			if M is penetrating a body part, say "A disappointed voice sounds in your head.[second custom style]'Sinful Sister, [if M is soul-seeking and (M is penetrating vagina or M is penetrating penis)]your purity may be gone forever, but your soul can still be saved! Escape, sister! Hurry!'[otherwise]your choices here cannot be redeemed. Escape now, with what little dignity you have left.'[end if]";
			otherwise say "A grave voice sounds in your head.[second custom style]'Diligent Sister, [one of][if the vaginalvirgin of the player is 1 and the player is possessing a vagina]you must never let [him of M] obtain your purity. There is no telling how powerful [he of M] might become!'[otherwise]you must never let [him of M] sample your flesh. There is no telling what could come of it!'[end if][or]you must oppose [him of M] will all your might!'[or][he of M] cannot resist your holy power. Banish [him of M] to whence [he of M] came![or]you must not let [him of M] take your soul!'[in random order]";
		otherwise if the bimbo of the player < 7:
			if the player is gendered male, say "[first custom style][one of][big he of M]'s smoking hot. I think it's a bad idea to ask if [he of M] wants to fuck, though.[or]This slut looks like [he of M]'s DTF.[or]I normally think eating [HoleDesc of M] is only for Beta cuckold virgins, but... this [if lady fetish is 2]sissy[otherwise]chick[end if] might be worth it.[or]Man, what is up with those heels? I'd hate to get hit with one of those.[or]Whoa, are those dildos on [his of M] heels? Maybe [he of M]'d let me stick one up [his of M] butt.[in random order]";
			otherwise say "[first custom style][one of]Wow, I can't believe how [he of M]'s dressed. Slut.[or]Even someone that beautiful has to play to the macho fantasies of this game. Ugh.[or]There is something supernatural about this [man of M].[or]What a disgusting outfit. How can [he of M] bear it?[or]Those heels look like they pack a punch, even if they look ridiculous.[or]There's something foreboding about this [man of M].[in random order]";
		otherwise if the bimbo of the player < 12:
			say "[variable custom style][one of][big he of M]'s stunning. I'm jealous.[or]Where did [he of M] get [his of M] outfit? It looks... comfy.[or]I don't think I'd win a fight against [him of M], but for some reason... I want to try anyway?[or]Something about [him of M] makes me want to get on my knees.[or][big he of M]'s so tall! If I want [him of M] to see me as an equal I'll have to find a way to get myself to [his of M] level.[or][big he of M] towers over me. I know it's only those heels, but it's strangely intimidating.[or]Something tells me I could be in a lot of pain if I don't submit to [his of M] wishes.[in random order]";
		otherwise if M is presenting as male:
			say "[second custom style][one of]Hee hee, I wonder if [his of M] cum is hot too?[or]Those heels look nice. I bet [he of M]'d be my friend if I had some of my own.[or][big he of M] looks like a skank. Just like me![or][big he of M]'s so tall in those heels! I bet [he of M]'d loves it when people go down on [him of M].[in random order]";
		otherwise:
			say "[second custom style][one of]Hee hee, I can almost see [his of M] chest![or]Those heels look nice. I bet [he of M]'d be my friend if I had some of my own.[or][big he of M] looks like a skank. Just like me![or][big he of M]'s so tall in those heels! Maybe looking down on guys is just as fun as going down on them?[in random order]";
		say "[roman type][line break]".

To set up (M - a demoness):
	reset M;
	now the monstersetup of M is 1;
	add balance-potion to the tradableItems of M, if absent;
	add balance-potion to the taxableItems of M, if absent;
	add infernal gem to the banishItems of M, if absent;
	add dildo-heels to the banishItems of M, if absent;
	now the raw difficulty of M is the starting difficulty of M;
	if doomed is 5, SilentlyDifficultyUp M by 1;
	now the health of M is the maxhealth of M;
	now the channelling of M is 0.

[Because demoness difficulty frequently varies massively up and down as the game progresses, and she needs to get appropriately harder when the player dominates her.]
To decide which number is the initial maxhealth of (M - a demoness):
	let X be 3;
	increase X by (the difficulty of M * 10) / 3;
	increase X by (the times-dominated of M * 10);
	decide on X.

To decide which number is the default favour of (M - a demoness):
	decide on 15.

This is the spawn initial demoness rule:
	if the number of alive demoness is 0:
		let M be a random woods dwelling demoness;
		summon M in the woods.
The spawn initial demoness rule is listed in the setting up woods monsters rules.

To decide which number is the girth of (M - a demoness):
	decide on 4.

To decide which number is the base semen load of (M - a demoness):
	let X be 2;
	increase X by (the excitement of M / 2);[if you don't resist, you have to deal with a much smaller load]
	if X < 0, now X is 1;
	if M is power-peaked, increase X by X;
	decide on X.

Definition: a demoness is concealment immune: decide yes. [Can the monster ignore salves of concealment, butt slut, etc.]

Definition: a demoness is able to remove cursed plugs: decide yes.[Can the monster remove all butt plugs?]

Definition: a demoness (called M) is willing to shag:
	if M is awake and the scared of M is 0 and the boredom of M < 120 and M is threatening and the difficulty of M > 4, decide yes;
	decide no.

To SilentlyDifficultyUp (M - a demoness) by (X - a number):
	while X > 0:
		if M is power-peaked and a random number between 1 and 2 is 1, increase the raw difficulty of M by 1;
		increase the raw difficulty of M by 1;
		decrease X by 1.

Part 1 - Misc Flavour

To say SummoningFlav of (M - a demoness):
	if the location of the player is Woods30, say "You hear a piercing shriek from inside the statue, followed by a rash of cruel laughter. The patch of grass between the statue's legs catches fire, and a [printed name of M] materialises in a burst of flames, licking... something off [his of M] lower lip.";
	otherwise say "You hear the sound of inhuman laughter.".

To say speech style of (M - a demoness):
	say first custom style.

To compute (M - a monster) stomping (N - a demoness):
	if M is in the location of the player, say "Before [he of N] can react, the [N] has been pinned to the wall by [NameDesc of M], and [his of M] [manly-penis] slid into [his of N] asshole. [big he of N] shrieks[line break][first custom style]'You dare defile me?!'[roman type][line break]but this turns into an undecipherable wail as [NameDesc of M] starts cumming. [big his of N] belly stretches to contain all the [semen]. After [he of N] is full, [NameDesc of M] tosses [he of N] to the ground, where [he of N] promptly faints.";
	otherwise say "You hear a demoness screech[line break][first custom style]'You dare defile me?!'[roman type][line break][if N is nearby]nearby, [otherwise]somewhere in the dungeon, [end if] followed by a wail of shame.";
	destroy N;
	let L be a random off-stage leftover;
	now L is in the location of M;
	now the leftover-type of L is the leftover-type of N.

To say LeftoverDesc (N - 105):
	say "An unconscious demoness on the ground has a [if pregnancy fetish is 1]pregnant looking[otherwise]fully stretched[end if] belly and [semen] slowly flowing out of [his of a random demoness] [asshole]. The gem around [his of a random demoness] neck has shattered.[line break]".

To say PissDrinkThreat of (M - a demoness):
	say "[speech style of M]'[one of]Drink my sacred nectar, mortal! And don't you dare disrespect me by spilling a single drop.'[or]This is my gift to you, young one... You must drink it all, now, or suffer my wrath.'[in random order][roman type][line break]".

To say SatisfiedFlav of (M - a demoness):
	if M is in the location of the player and M is not dying, say "[BigNameDesc of M] wanders away laughing, satisfied for now.".

To compute RockingReaction of (M - a demoness):
	if there is a worn diaper and rectum < 20 and diaper messing >= 3:
		say "[BigNameDesc of M] snickers and walks up to you. [big he of M] places one hand on your [ShortDesc of belly] and rubs is gently. You feel some infernal magic manifesting in [his of M] palm as [he of M] does.[line break][speech style of M]'Aww, silly baby, did you think this was your potty?'[roman type][line break]You watch with [horror the diaper addiction of the player] as your intestines bulk out with crazy amounts of poop!";
		now rectum is 20;
		say "Some of the magic seems to persist in your body.";
		MagicPowerUp 1;
	otherwise:
		say "[BigNameDesc of M] cackles as [he of M] watches you. [one of][line break][speech style of M]'Oh dear, you just look so pathetic!'[roman type][line break][or][line break][speech style of M]'Uh-oh, it would be awkward if you needed to go potty right now, wouldn't it?'[roman type][line break][or][or][or][cycling][moderateHumiliateReflect]".

To say PregGrowth of (M - a demoness):
	say "the demon spawn".

To compute labour to (M - a demoness):
	compute infernal birth.

To compute fatherhood to (M - a demoness):
	distract M.

Part 2 - Perception

To decide which number is the bimbo tolerance of (M - a demoness):
	decide on 14.

To decide which number is the outrage tolerance of (M - a demoness): [only used in DQ]
	decide on 7.

To decide which number is the cringe tolerance of (M - a demoness):
	decide on 8.

Definition: a demoness (called M) is loving the booty:
	if the thickness of hips > 4 and the number of worn cursed plug panties is 0 and the player is not diapered, decide yes;
	decide no.

Definition: a demoness (called M) is outrage disapproving:
	let A be the appearance of the player;
	let L be the latest-appearance of M;
	now the latest-appearance of M is A;
	if diaper quest is 1:
		if A > L and A > the outrage tolerance of M, decide yes;
	otherwise:
		if A > L and M is loving the booty, decide yes;
	decide no.

To say DisapprovalFlav of (M - a demoness):
	say "[BigNameDesc of M] [one of]narrows [his of M] eyes[or]widens [his of M] eyes[or]purses [his of M] lips[or]tuts[in random order].[line break][speech style of M]'[if diaper quest is 1][one of]Even though you are presenting yourself to me so lewdly, you don't really look like someone with any [maturity].'[or]Is this really how you present yourself in front of your superiors?!'[in random order][otherwise][one of]My my, how did I not notice how delicious your ass is?'[or]Oh my... If you show me your curves like that, I'm going to get all excited.'[in random order][end if][roman type][line break]".

To say BecomesAggressive of (M - a demoness):
	say "[big he of M] takes an offensive stance![line break][speech style of M]'[if the player is prone][one of]Stay down, mortal.'[or]Stay right there, weakling.'[or]I command you to remain on your knees, and prepare yourself for this...'[in random order][otherwise]Get on your knees at once, and prepare yourself...'[end if][roman type][line break]".

Definition: a demoness (called M) is objectifying the player:
	if the class of the player is cheerleader or M is not in the location of the player, decide no;
	if (the bimbo of the player >= 20 or the appearance of the player >= 20), decide yes;
	if the appearance of the player > the bimbo tolerance of M, decide yes;
	if the delicateness of the player > 6 + the favour of M / 4, decide yes;
	decide no.

Definition: a demoness (called M) is uniquely unfriendly:
	if M is friendly-fucking, decide no;
	if M is default uniquely unfriendly, decide yes;
	if the class of the player is priestess, decide yes;
	decide no.

Definition: a demoness is ally: decide no.

Definition: a demoness is guardian: decide no.

Definition: a demoness (called M) is dealing:
	if diaper quest is 1, decide no;
	[unless the player is souled, decide no;]
	if the player is possessing a vagina:[The demoness is really eager to do business with virgins. She also offers an emergency plan B for pregnant customers!]
		if the vaginalvirgin of the player is 1, decide yes;
		if the pregnancy of the player is 1, decide yes;
	unless M is willing to do oral, decide no;
	let S be the raw sex addiction of the player + the raw semen taste addiction of the player;[calculate once instead of twice]
	if S is 40, decide no;
	if S < the favour of M + 2, decide yes;
	if the class of the player is faerie, decide yes;
	decide no.

To compute perception of (M - a demoness):
	say "[BigNameDesc of M] notices you[if the player is sluttily dressed][end if]. "; [The output for if the player is sluttily dressed occurs within the check itself.]
	let T be 1;
	repeat with H running through worn heels:
		if H is dildo-heels or the heel-height of H > 3, now T is 0;
	if the current-errand of M is completed and M is not uniquely unfriendly:
		compute errand completion of M;
	otherwise if the latex-transformation of the player > 3:
		say "[big he of M] doesn't seem interested for some reason.";
		bore M;
	otherwise if M is uniquely unfriendly:
		anger M;
		if there is soiled-diaper carried by M or there is a dirty diaper carried by M:
			say "[speech style of M]'[one of]You there, you disgusting mortal! I'm sure it's you who left this for me to find! How vile[or]Vile mortal, stop leaving your horrendous used garments around for me to find[stopping]!'[roman type][line break]";
		otherwise if the class of the player is priestess:
			say "Immediately upon seeing you, [he of M] shrieks:[line break][speech style of M]Your holy aura has no power out here, mortal! Get on your knees and submit to me as your new [literalMistress of M], or I will make you!'[roman type][line break][if M is friendly]Apparently [he of M] doesn't like priestesses...[end if]";
			alwayscutshow figure of demoness interact 7 for M;
			say "Your holy aura does seem to have some effect against [him of M], as you are easily able to resist [his of M] dominating aura which tries to make you kneel on command.";
		otherwise:
			say "[speech style of M]'[if M is uninterested]You, whore! [otherwise]You know what? [end if][if the player is upright]Kneel down, I feel like ruining someone.'[otherwise]Stay down there, I'm going to punish you.'[end if][roman type][line break]Uh-oh...";
			alwayscutshow figure of demoness interact 8 for M;
			if a random number between 1 and 15 < the bimbo of the player and the player is upright and the player is not dildo stuck:
				say "[BigNameDesc of M] has such a powerful dominating aura that you mindlessly drop to your knees in front of [him of M][if the bimbo of the player > 8], nearly drooling at the thought of [his of M] heel drilling inside you[end if].";
				allocate 1 seconds;
				try kneeling;
	otherwise if T is 0 or the player-class is succubus:
		say "[speech style of M]'[if T is 0][one of]Oh wow, nice heels! Where did you get them from?'[or]Glad to see you're still wearing proper heels.'[stopping][otherwise]Ah, a fellow servant of the Master.'[end if][roman type][line break]";
		calm M;
		alwayscutshow figure of demoness interact 6 for M;
	otherwise if the player is prone:
		if M is loving the booty, FavourDown M;
		if M is unfriendly:
			say "[speech style of M]'Oh my, what a [tasty] looking ass you have. I might just have to use it.'[roman type][line break]Uh-oh...";
			alwayscutshow figure of demoness interact 8 for M;
		otherwise:
			compute appearance assessment of M; [if you look worthy of a deal, she'll be interested]
	otherwise if there are worn heels and T is 1:[we know by now that the player is upright]
		if M is friendly:
			say "[speech style of M]'Those heels are tiny. How pathetic.'[roman type][line break]";
			distract M;
			alwayscutshow figure of demoness interact 5 for M;
		otherwise:
			say "[speech style of M]'I cannot abide you walking around in those awful shoes! Get on your knees or face my wrath!'[roman type][line break]";
			alwayscutshow figure of demoness interact 9 for M;
			anger M;
			if a random number between 1 and 15 < the bimbo of the player and the player is not dildo stuck:
				say "[BigNameDesc of M] has such a powerful dominating aura that you mindlessly drop to your knees in front of [him of M][if the bimbo of the player > 8], nearly drooling at the thought of [his of M] heel drilling inside you[end if].";
				allocate 1 seconds;
				try kneeling;
	otherwise:[She's looking for suckers, not smart women who wear high heels.]
		compute appearance assessment of M.

To decide which number is the ass grope preference of (M - a demoness):
	if M is loving the booty, decide on 1000; [automatic choice]
	decide on 0.
To decide which number is the asshole grope preference of (M - a demoness):
	decide on 5.

To compute appearance assessment of (M - a demoness):
	say "[line break][big he of M] looks you up and down[run paragraph on]";
	if the player is top-wardrobe-malfunctioning:
		compute tq nip slip reaction of M;
	otherwise if M is groping:
		compute grope of M;
	otherwise if M is dealing:
		let R be a random number between 1 and 6;
		if the player is possessing a vagina and the vaginalvirgin of the player is 1:
			say ", unabashedly licking [his of M] lips as [his of M] eyes pass over your [vagina]. [one of][line break][speech style of M]'[if R < 3]You know, that cherry of yours... it's worth a lot. I'll buy if you're selling, baby.'[otherwise if R is 3]Hey. I know a virgin when I see one, baby. Let me break you in and... let's say I can make it worth your while.'[otherwise if R is 4]You're still pure, aren't you, baby. Must be stressful. Tell you what. I'll help you relax. I'll even pay you. Sound good?'[otherwise]Wow, that's a pretty cute cherry you've got there. Ever think about selling it? I'd buy...'[end if][or][speech style of M]Deal is still open. Never too early...'[stopping][roman type][line break]";
			now M is soul-interested;
			alwayscutshow figure of demoness interact 1 for M;
		otherwise if the pregnancy of the player is 1 and M is willing to do vaginal:
			say ", smoothly stepping toward you as [he of M] clicks [his of M] tongue.[line break][speech style of M]'[one of][if R < 3]Wow, knocked up, huh? You know, I could fix that if you let me fuck you.'[otherwise if R < 5]I bet that belly of yours is a burden. If you let me fuck you, I can make it go away.'[otherwise]Wow, I bet you're regretting all that unprotected sex now, right? Lucky for you, when I fuck without a condom I can make pregnant bellies... go away. Deal?'[end if][or]Deal is still open. I know that belly must be heavy.'[stopping][roman type][line break]";
			alwayscutshow figure of demoness interact 2 for M;
		otherwise if the player is possessing a penis and the penetrativevirgin of the player is 1:
			if virgincursed is 0:
				say ", unabashedly licking [his of M] lips as [his of M] eyes pass over your [player-penis]. [one of][line break][speech style of M]'[if R < 3]Hey. Wanna have your first time with a demoness? I'll pay you.'[otherwise if R is 3]That cock... it's virgin, isn't it. Ooh, I WANT it! Let me buy it from you!'[otherwise]That's a virgin cock, isn't it. Ever think about selling it? I'd buy...'[end if][or][speech style of M]Mmm, whenever I see that virgin cock I just wanna GOBBLE IT UP! Take the deal already!'[stopping][roman type][line break]";
				now M is soul-interested;
			otherwise:
				say ", frowning sympathetically as [his of M] eyes pass over your [player-penis]. [one of][line break][speech style of M]'[if R < 3]You're a virgin, aren't you. Don't worry, I'm not judging you. After all, you must feel so pitiful.'[otherwise if R is 3]It must be so hard to lose your virginity. Keep trying, ok?'[otherwise]You poor thing. It must have been so shocking when [he of analvirginity-taker] deflowered you like that.'[end if][or][speech style of M]Normally I'd offer you a deal where I'd take your virginity for a small price, but... Your suffering is just too delicious to stop. HAHAHAHA!'[stopping][roman type][line break]";
		otherwise:
			say ", smoothly stepping toward you with a smirk.[line break][speech style of M]'[one of][if R is 1]You know, if you need extra spending money, I could get you some. Or anything else, really. All you need to do is get on your knees and show me where you want it.'[otherwise if R is 2]Hey, if you're having trouble getting through here safely, I could help. All you need to do is get on your knees and tell me where you want it.'[otherwise if R < 5]Hey there, just letting you know... I have a way to help out if you feel a little overwhelmed... You'll just need to do a little job for me. Use whatever hole you want.'[otherwise]You're someone with very specific things to gain, am I right? Tell you what. Lend me your body and in return... I'll give you something you need.'[end if][or][if R is 5]My offer is still open, you know.'[otherwise if R is 1]I'm still up for that deal, if you are.'[otherwise if R is 2]Deal is still on, by the way.'[otherwise if R is 3]I have things you want. The price isn't even that high. I just want to see what you're is capable of.'[otherwise if R is 4 and M is willing to do oral]It'll be easy, I promise. Like sucking on a lollipop.'[otherwise if R is 5]Just think of what you gain. Loads of people have done this before, do you see any of them trapped in here?'[otherwise]What's so scary about a great deal? You're missing out on so many possibilities.'[end if][stopping][roman type][line break]";
			alwayscutshow figure of demoness interact 3 for M;
		calm M;
	otherwise:
		say "[if there are worn heels], pausing briefly on your heels before losing interest.[otherwise], glancing at your feet before losing interest.[end if]";
		alwayscutshow figure of demoness interact 4 for M;
		distract M.

To compute DQ perception of (M - a demoness):
	say "[BigNameDesc of M] notices you. ";
	if the player is flying:
		say "The demoness has noticed the player flying, this should be impossible since [he of M] lives in the woods. Report the bug to Aika please!";
		anger M;
	otherwise if M is uniquely unfriendly:
		anger M;
		if there is soiled-diaper carried by M or there is a dirty diaper carried by M:
			say "[speech style of M]'[one of]You there, you disgusting mortal! I'm sure it's you who left this for me to find! How vile[or]Vile mortal, stop leaving your horrendous used garments around for me to find[stopping]!'[roman type][line break]";
		otherwise if the class of the player is priestess:
			say "Immediately upon seeing you, [he of M] shrieks:[line break][speech style of M]Your holy aura has no power out here, mortal! Get on your knees and submit to me as your new [literalMistress of M], or I will make you!'[roman type][line break][if M is friendly]Apparently [he of M] doesn't like priestesses...[end if]";
			say "Your holy aura does seem to have some effect against [him of M], as you are easily able to resist [his of M] dominating aura which tries to make you kneel on command.";
		otherwise:
			say "[speech style of M]'[if M is uninterested]You, child! [otherwise]You know what? [end if][if the player is upright]Kneel down, I feel like punishing someone.'[otherwise]Stay down there, I'm going to punish you.'[end if][roman type][line break]Uh-oh...";
			if a random number between 1 and 15 < the bimbo of the player and the player is upright and the player is not dildo stuck:
				say "[BigNameDesc of M] has such a powerful dominating aura that you mindlessly drop to your knees in front of [him of M].";
				allocate 1 seconds;
				try kneeling;
	otherwise if (there is a worn diaper or the diaper-duration of M > 0) and the player is immobile:
		say "[big he of M] seems to decide to leave you alone for now.";
		distract M;
	otherwise if M is aware that the player needs a change: [Unless she's diaper training you, the demoness only checks diapers she knows are going to need a change]
		compute diaper check of M;
	otherwise if the diaper-duration of M > 0:
		if there is a worn diaper:
			compute diaper check of M;
		otherwise:
			say "[big he of M] swiftly walks up to you and holds [if diaper messing < 3]a hand to the front[otherwise]hands to the front and back[end if] of your crotch, pushing firmly to get a good feel.[line break][speech style of M]'Did you really think it was wise to disobey me?! Did you think I wouldn't find out you have been ignoring my direct order to stay in diapers? Oh, I'm going to make you regret that decision, little one...'[roman type][line break]";
			FavourDown M by 4;
			anger M;
	otherwise if M is unfriendly:
		say "[speech style of M]'You have yet to demonstrate your capacity for adulthood, little one. There's only one proper way to treat someone like you...'[roman type][line break]";
		anger M;
		if a random number between 1 and 15 < the bimbo of the player and the player is not dildo stuck:
			say "[BigNameDesc of M] has such a powerful dominating aura that you mindlessly drop to your knees in front of [him of M].";
			allocate 1 seconds;
			try kneeling;
	otherwise if demoness-facesit is appropriate:
		say "[speech style of M]'Mortal! If I can sense your need to go to the toilet, then I am sure that you can! Why do you refuse to wear a diaper? I think you need to be taught a lesson...'[roman type][line break]";
		anger M;
	otherwise:
		compute DQ appearance assessment of M;
		if M is interested: [She hasn't finished talking]
			if M is friendly and permanent makeup is 1:
				say "You know, there's a powerful well somewhere in these woods that I bet could help you with the magic charm on your face, if you donate generously enough.'[roman type][line break]";
			otherwise if M is acquaintance:
				let CA be the cringe appearance of the player; [causes line break when checked]
				say "For now, I give you permission to remain and bask in my [if CA > 3][maturity] and [end if]glory.'[roman type][line break]";
			otherwise if M is friendly:
				say "You're not worth my trouble.'[roman type][line break][big he of M] turns to leave you alone.";
				distract M;
			otherwise:
				say "I believe it is my responsibility to teach you a lesson...'[roman type][line break][big he of M] turns aggressive!".

To compute DQ appearance assessment of (M - a demoness):
	if there is a worn currently visible messed knickers: [probably impossible to happen for now]
		say "[speech style of M]'[one of]Ugh, what a disgusting mess you've made for yourself! You mortals are so revolting. Don't expect me to ever treat you with respect again.'[or]You again! Did you not learn from what I said last time? How horribly revolting.'[stopping][roman type][line break][big he of M] turns to leave you alone.";
		FavourDown M by 6;
		distract M;
		if there is worn perceived unmessed knickers, compute state check of a random worn messed knickers;
	otherwise if the cringe appearance of the player > the cringe tolerance of M:
		if M is buddy, say "[speech style of M]'Hmm, I'm not used to being seen with mortals who dress so... childishly. I will excuse it this time, but I must demand that you change your attire soon. ";
		otherwise say "[speech style of M]'You look like a pathetic child, which is the only thing worse than a pathetic mortal adult. Bear that in mind before you disgust me further. ";
		FavourDown M by 2;
	otherwise if the appearance of the player > the outrage tolerance of M:
		say "[speech style of M]'Your slutty appearance betrays you, mortal. You do know how we punish whores in this region, right? I doubt you'd enjoy it. ";
		FavourDown M by 2;
	otherwise if the player is top-wardrobe-malfunctioning:
		compute dq nip slip reaction of M;
		say "[speech style of M]'You're not worth my trouble.'[roman type][line break][big he of M] turns to leave you alone.";
		distract M;
	otherwise:
		say "[speech style of M]'Oh look, a puny mortal, exhibiting barely enough [maturity] to be called an adult. ".

Part 3 - Seeking

To compute (M - a demoness) seeking (D - a direction):
	blockable move M to D;
	if M is in the location of the player and M is unfriendly and there is a worn heels:
		now the channelling of M is 0;
		say "[one of][line break][speech style of M]'Did you not hear me?! On your knees bitch before I end you!'[roman type][line break][or][stopping]";
	compute monstermotion reactions of M.

Part 4 - Combat

Carry out kneeling in the presence of a demoness:
	repeat with M running through dangerous demonesses in the location of the player:
		if M is abyssal demoness and the channelling of M is 1:
			now the channelling of M is 0;
			say "[BigNameDesc of M] finishes [his of M] spell, and steps toward you intimidatingly.";
		otherwise if the channelling of M is 1:
			now the channelling of M is 0;
			say "[BigNameDesc of M] stops channelling [his of M] energy into the floor, and it returns to its normal cold temperature.";
	repeat with H running through worn clothing:
		now H is not stuck;
	repeat with H running through clothing in the location of the player:
		now H is not stuck.

To compute kneeling reaction of (M - a demoness):
	say "[one of][BigNameDesc of M][']s lips break into a smug grin. Soon enough [NameDesc of M] is tapping [his of M] heel on the ground below with growing impatience. [big he of M] closes the gap between you two with a few steps, [his of M] hips swaying elegantly. There's a dominating aura around [NameDesc of M] that makes you feel quite [if the bimbo of the player < 4]scared[otherwise if the bimbo of the player < 8]uneasy[otherwise if the bimbo of the player < 12]interested[otherwise if the bimbo of the player < 16]excited[otherwise]enticed[end if]. You stare at [him of M] [if the bimbo of the player < 4]fearfully[otherwise if the bimbo of the player < 7]uneasily[otherwise if the bimbo of the player < 10]nervously[otherwise if the bimbo of the player < 13]anxiously[otherwise if the bimbo of the player < 16]hungrily[otherwise]eagerly[end if].[or][BigNameDesc of M] sighs, pulling a foot upwards behind [him of M] to adjust [his of M] heels. [big he of M] closes the gap between you and [him of M], those phallic heels digging against the dirt below yet somehow staying clean. [big he of M] slows to a stop in front of you, waiting for you to make the next move, not even threatened by your presence.[or][if the bimbo of the player < 4]You can't believe you're in such a humiliating situation as you keep your gaze fixed on the ground below, [NameDesc of M] snapping [his of M] fingers a few times to make sure you're paying attention.[otherwise if the bimbo of the player < 7]You glance over the demoness with a subtle interest in [his of M] presence; maybe this could be fun in some weird, twisted way... Right?[otherwise if the bimbo of the player < 10]You can't help but stare at [his of M] phallic heels for extended periods of time, a small amount of drool starting to pool in your mouth as you decide what to do next.[otherwise if the bimbo of the player < 13]You take a moment to admire [NameDesc of M][']s heels and gnaw at your lower lip in excitement. Your eyes fixate on those large phallic stilettos and you are unable to tear your gaze away, a steady stream of saliva pooling at your mouth as lewd thoughts start to creep into your mind, well, more so than usual.[otherwise if the bimbo of the player < 16][BigNameDesc of M] perks a brow down at you as [he of M] snaps [his of M] fingers to part your gaze from [his of M] heels. You hadn't even noticed how fixated you were until [he of M] tore your attention away from them.[line break][speech style of M]'So?'[roman type][line break][big he of M] says with growing impatience.[line break][speech style of M]'Present yourself!'[roman type][line break][otherwise]You can't fight back the dominating presence this [man of M] is projecting, your chest dips towards the ground as your elbows support it, and you absent-mindedly wiggle your hips and bits by extension. [BigNameDesc of M][']s grin couldn't be wider.[end if][in random order]";
	strongHumiliate.

To compute delay of (M - a demoness):
	say "[one of][BigNameDesc of M] continues to patiently tap [his of M] heel to the ground. You feel like [he of M]'s waiting for you to continue.[or][BigNameDesc of M] hovers [his of M] hands by [his of M] hips, letting you know [he of M]'s prepared if you try anything funny. [big he of M] just wants you to make the first move.[or][BigNameDesc of M] keeps a keen eye on your subtle movements, ready to stop you if you try to run.[or]You notice that [NameDesc of M] is waiting for your next move.[or][line break][speech style of M]'We haven't got all day, sugartits.'[roman type][line break][BigNameDesc of M] says with a wink.[line break][or][line break][speech style of M]'Go on, make my day.'[roman type][line break][or][line break][speech style of M]'Oh this is gonna be good. Now, give me your ass pathetic human.'[roman type][line break][or][line break][speech style of M]'[if the flesh volume of hips < 8]It's not the biggest butt, but I'm not complaining[otherwise]Now that's what I call a [tasty] butt[end if]. Hope you're not too sore!'[roman type][line break][in random order]".

To say WaitingFlav of (M - a demoness):
	if the player is not able to speak:
		say "[if the player is able to make sounds][line break][variable custom style][muffled sounds][roman type][line break][otherwise]You look up at [NameDesc of M] silently.[end if]";
	otherwise if the soreness of asshole > 7 and the times-submitted of M > 0:
		say "You [if the anal sex addiction of the player < 4]shiver with dread[otherwise]hesitate[end if] - you are worried that your [asshole] is much too sore right now for another round with [NameDesc of M]!";
	otherwise if the anal sex addiction of the player < 4:
		say "[one of]You stare up at the demoness, still in shock.[or]You pause and wonder if staying downstairs would be the better option.[or]You turn away with a sway of your hips.[line break][first custom style]'Hmmph.'[roman type][line break][or][line break][first custom style]'Please don't do that thing you clearly want to do.'[roman type][line break][or]You look away, knowing full well you have no chance of escape.[or][line break][first custom style]'[if the player is gendered male]Look, I'm not really into weird otherworldly creatures.'[otherwise]I'd rather be on top.'[end if][roman type][line break][or][line break][first custom style]'[if the player is gendered male]I like women and stuff, but this is just too freaky for me.'[otherwise]I'm not some sort of slut that'll just do as [he of M]'s told.'[end if][roman type][line break][or][line break][first custom style]'[if the player is gendered male]Look, just don't let those heels anywhere near me.'[otherwise]I'd never fuck some freak like you.'[end if][roman type][line break][or][line break][first custom style]'I'm sorry, all right? Please let me go, just this once.'[roman type][line break][in random order]";
	otherwise if the anal sex addiction of the player < 7:
		say "[one of]You bite your lip, embarrassed by your own excitement.[or]You wait obediently, but only because [NameDesc of M] is really threatening you.[or]A small part of you seems to get a rush out of following [his of M] orders.[line break][first custom style]'Just don't get me too dirty, all right?'[roman type][line break][or][line break][first custom style]'It's just sex. Don't get too into it.'[roman type][line break][or][if the player is gendered male]You try to stifle some decidedly 'submissive' thoughts.[otherwise]You focus on keeping your hands away from your [vagina].[end if][or][line break][second custom style]'[if the size of penis < 5]Does my [sissy-penis] not bother you?[otherwise if the player is possessing a penis]Does my [manly-penis] not bother you?'[otherwise]Am I a slut for letting [him of M] do what [he of M] wants?'[end if][roman type][line break][or][if the player is gendered male]You can't help but feel excited at the thought of [NameDesc of M] treating you like [he of M] is.[otherwise][line break][variable custom style]'You'll be gentle, right?'[end if][roman type][line break][in random order]";
	otherwise:
		say "[one of]You feel thoroughly ready to get fucked any way the demoness pleases.[or][line break][second custom style]'I'll do anything for you, sexy.'[roman type][line break][or][line break][second custom style]'We're both horny, so do whatever you want to me. I'm sure I'll like it.'[roman type][line break][or][line break][second custom style]'It feels good anywhere!'[roman type][line break][or][line break][second custom style]'Don't be afraid to be rough, baby. I love a rough fuck!'[roman type][line break][or][line break][second custom style]'[if the size of penis > 3]I hope [he of M] doesn't mind my small [manly-penis]!'[otherwise]I'm a [man of the player], so my opinion doesn't matter, hee hee!'[end if][roman type][line break][or][if the player is gendered male]Hee hee, [he of M]'s going to make me sore![otherwise]You jill yourself vigorously, eager to be used like the slutty tart you are.[end if][roman type][line break][or][line break][second custom style][if the player is gendered male]I'm the submissive [sissy slut], so I should wait to find out what [he of M] wants most.[otherwise if the player is possessing a vagina]I really feel like getting fucked in my pussy, but [he of M]'s the dominant so [he of M] should choose.[end if][roman type][line break][or][line break][second custom style]'I don't know what I want, teehee!'[roman type][line break][or][line break][second custom style][big he of M]'s the dominant, [he of M] should choose.[roman type][line break][or][line break][second custom style]'I'm always up for a good fuck, doesn't matter what type it is!'[roman type][line break][in random order]".

To say SexSubmissionFlav of (M - a demoness):
	if diaper quest is 0:[TODO: fix this for futa sex]
		say "[if the bimbo of the player < a random number between 8 and 13][one of]You lie still and accept the invasion.[or]You submit to being used as a plaything.[or]You don't resist being used.[in random order][otherwise][one of]You purposefully loosen up and accept the demoness's thrusts to easily slide fully in and out.[or]You push back at the dildo footwear enthusiastically in the same rhythm that [he of M] is fucking you.[in random order][end if]";
		say "[variable custom style][one of][if the relevant sex addiction of M > 11]'Fuck me, baby!'[otherwise if the vaginalvirgin of the player is 1 and the player is possessing a vagina]At least I still have my virginity.[otherwise]Maybe if I relax, this will hurt less?[end if][or][if the relevant sex addiction of M > 12]This feels sooooo good![otherwise if the bimbo of the player > 5]Why am I letting [him of M] do this? Am I a whore?[otherwise]Owwww, it still hurts![end if][or][if the relevant sex addiction of M > 13]'That feels good! Go faster! Nnnf, fuck!'[otherwise if the bimbo of the player > 7]Maybe I really am a slut?[otherwise]Please, just let [him of M] finish quickly...[end if][or][if the relevant sex addiction of M > 14]'Fuck me harder!'[otherwise if the relevant sex addiction of M > 8]Am I actually enjoying this?[otherwise if there is a demoness penetrating asshole and the player is possessing a vagina]At least [he of M]'s not abusing my pussy...[otherwise]'Oh just please finish fast! I can't take much more.'[end if][purely at random][roman type][line break]";
	otherwise:
		say "[one of]You lie still, submitting to the superior being[or]You obediently allow [him of M] to continue[stopping].";
	increase the excitement of M by 1.

To say MercyReaction of (M - a demoness):
	say "[BigNameDesc of M] just laughs, almost like [he of M] is getting off on your pain!".

To set up sex length of (M - a demoness) in (B - penis):
	let N be 5;
	decrease N by the excitement of M / 3;
	if N < 2, now N is 2;
	set up sex length N of M in B.

To say ErectionDemand of (M - a demoness):
	if M is friendly-fucking or presented-orifice is penis:
		say "[BigNameDesc of M]'s eyes glint as [he of M] looks down at your crotch.[line break][speech style of M]'[one of]It seems a little afraid of me, but I don't mind. [or]Still soft, huh? It's okay to be intimidated, you know. [or]Oh, still limp? I hope it's not frightened... [or]Oh? I thought you'd be hard by now. The poor thing must be afraid... [in random order] Heheheh...'[roman type][line break]";
	otherwise:
		say "[BigNameDesc of M]'s eyes glint as [he of M] looks down at your crotch.[line break][speech style of M]'[one of]Your poor little penis seems terrified of me, but that's ok. That's how it's supposed to feel, after all.'[or]Get hard for me, mortal. Don't get intimidated, or I'll have to torture you~!'[or]I'll be making use of your penis, but the poor thing seems so afraid of me. If nothing changes, I'll have to stick with my original plan and torture you...'[or]I need you rigid for what comes next. Don't be afraid. Definitely don't be afraid...'[at random][roman type][line break]";

To compute unerect taunting of (M - a demoness):
	if penis is able to get erect: [When the penis is super small, she mocks you, forces an erection with magic, and flips you over.]
		if the size of penis < 3 and asshole is an actual target:
			say "A couple of seconds pass, and your [sissy-penis] grows to its full, unimpressive [the size of penis]-inch length. [BigNameDesc of M] stares at it a moment[one of] before bursting into laughter[or], biting [his of M] lips in disbelief[or], sniggering cruelly while shaking [his of M] head[in random order]. [speech style of M]'[one of]Ha! I thought there was a *tiny* chance that ridiculous specimen might have been a grower, but... Never have I been so cruelly disappointed!'[or]Is that even a real dick, or just some kind of toy grafted on?'[or]Is that real? It's quite large - for a clitoris!'[or]I guess we could have tried with that - if I'd brought my tweezers!'[at random][roman type][line break][big he of M][speech style of M]'Well, there's no point trying to use that nubbin for aught but rubbin['], so...'[roman type][line break][big his of M] makes a strange gesture with [his of M] other hand, and despite its minuscule size your dicklet glows with a pink light while tiny tingles spread through your little shaft.[speech style of M]'I think it's kind of cute to leave your little clit helplessly erect while I make use of your real sex organ.'[roman type][line break][big he of M] casually flips you over so your [AssDesc] is poking up, presented to its smirking gaze.";
			SexAddictUp 1;
			now penis is penis-erect;
			now chosen-orifice of M is asshole;
			now another-turn-flavour is the substituted form of "[BigFuckerDesc of M] casually holds you in place.";
			now another-turn is 1;
		otherwise:
			say "A couple seconds pass, and after it becomes clear that nothing is happening, [he of M] [if the size of penis < 4]pinches two fingers[otherwise]wraps a hand[end if] around your still-soft [player-penis].[line break][speech style of M]'Can't have that, now can we?'[roman type][line break][big his of M] makes a strange gesture with [his of M] other hand, and your penis suddenly glows with red light. A pronounced dirty feeling settles over you as tingles begin to spread through your shaft";
			SexAddictUp 1;
			compute M mounting erection;
			now penis is penis-erect;
	otherwise:
		if M is unfriendly:
			say "A couple seconds pass, and after it becomes clear that you aren't going to get erect, [NameDesc of M]'s face contorts into a savage grin.[line break][speech style of M]'I knew it! You can't get hard at all, can you? Hahaha, PITIFUL!'[roman type][line break][big he of M] laughs sadistically as [he of M] kicks you over onto your belly.";
			now chosen-orifice of M is asshole;
			now another-turn-flavour is the substituted form of "[BigFuckerDesc of M] holds you in place.";
			now another-turn is 1;
		otherwise:
			say "A couple of seconds pass, and after it becomes clear that you aren't going to get erect, [NameDesc of M]'s face contorts into a savage grin.[line break][speech style of M]'Ha. Heheheh... This is better than sex. Hahaha...'[roman type][line break]The glint in [his of M] eyes becomes a malicious red glow as [he of M] walks away, still laughing.";
			increase the excitement of M by the size of penis;
			FavourDown M by 2;
			Bore M.

To say ErectionPenetrationFlav of (M - a demoness):
	say "[BigNameDesc of M] lowers [himself of M] into your lap, supernatural heat radiating from [his of M] [HoleDesc of M] as [he of M] grinds it against your [if penis is penis-erect]rock-hard[otherwise]rapidly hardening[end if] [manly-penis]. [big he of M] grins menacingly as [his of M] tail wraps itself around your shaft and slowly guides it into [his of M] warm hole.";
	if the penetrativevirgin of the player is 1 and virgincursed is 0, now M is soul-seeking;[This is sex, but not "dominant sex". As such, it can't help you lose your virginity curse.]

To say ErectionUseFlav of (M - a demoness):
	say "[one of][BigFuckerDesc of M] cackles sadistically as [his of M] vice-like [HoleDesc of M] strangles your helpless [player-penis]![or][BigFuckerDesc of M]'s [HoleDesc of M] strangles your [player-penis] with vice-light tightness as [he of M] rides you.[or]Supernatural heat stings your [player-penis] as [FuckerDesc of M] aggressively bounces on your shaft.[or][BigFuckerDesc of M]'s eyes glint with excitement as [he of M] aggressively bounces on your [ShortDesc of penis]![or][BigFuckerDesc of M]'s nails dig into your flesh as [he of M] roughly impales [himself of M] on your shaft.[or]Scalding hot droplets of feminine moisture trickle down your shaft as [FuckerDesc of M] impales [himself of M] on you.[in random order]".

To say ErectionForceFlav of (M - a demoness):
	say "[one of][BigFuckerDesc of M] massages your [if the player is possessing a scrotum]balls[otherwise]taint[end if] with [his of M] tail, cooing seductively as [he of M] fucks your [ShortDesc of penis] with [his of M] super-tight [HoleDesc of M].[or][BigFuckerDesc of M] eagerly rides your shaft, allowing every [if the size of penis < 3]bit[otherwise]inch[end if] to experience the supernatural tightness of [his of M] [HoleDesc of M].[or]The supernatural warmth of [FuckerDesc of M]'s [HoleDesc of M] envelops your shaft as [he of M] fucks you, slowly but surely building up your pleasure.[or][BigFuckerDesc of M] moans sensually as [he of M] fucks [himself of M] with your [ShortDesc of penis]![or][BigFuckerDesc of M]'s [HoleDesc of M] spasms, briefly gripping your [ShortDesc of penis] with painful force, making it feel like an over-inflated balloon that could pop. You feel literally rock hard![or][BigFuckerDesc of M] grips your shoulders as [he of M] eagerly impales [himself of M] on your shaft, bearing down on you with supernatural tightness.[or]Supernatural warmth surrounds your shaft as [FuckerDesc of M] bounces on top of you.[in random order]".

[Note: the player's orgasm is technically still happening here, so this can potentially happen more than once during the same riding session.]
To compute erection orgasm of (M - a demoness):
	say "[line break][speech style of M]'[one of]Ah-ah, We're not done yet~'[or]Don't go getting ahead of yourself now~'[or]Tsk. Tsk. We can't have you cumming THIS early~'[in random order][roman type][line break][BigNameDesc of M]'s tail wraps itself around your shaft and viciously tightens. Your ejaculation is cut off forcefully, completely ruining your orgasm and causing your shaft to throb pointlessly with nothing coming out.";
	PainUp 10;
	arouse 2000;
	increase the excitement of M by 1;
	if the sex-length of M < 2, now the sex-length of M is 2.

To say ErectionLostFlav of (M - a demoness):[shouldn't really happen, but maybe the player goes soft for some reason OTHER than ejaculation.]
	if M is soul-seeking: [She's really mad, because she didn't get to steal your soul.]
		say "[BigNameDesc of M] looks down with fury in [his of M] eyes.[line break][speech style of M]'[one of]What?! Why are you soft?! What about my PAYMENT?!'[or]You're soft?! What about the-!'[or]FUCK! And after all the effort I put in-!'[at random][roman type][line break][big he of M] jumps to [his of M] feet, and shoves you onto your stomach.";
		now M is not soul-seeking;
		anger M;
		FavourDown M by 3;
		now chosen-orifice of M is asshole;
		now another-turn-flavour is the substituted form of "[BigFuckerDesc of M] holds you in place.";
		now another-turn is 1;
	otherwise:
		say "[BigNameDesc of M] looks down with a slightly surprised look on [his of M] face.[line break][speech style of M]'[one of]Oh. Well, I got what I wanted, so it doesn't matter.'[or]You went soft? Eh, who cares. I still got MY reward.'[or]Huh? That's strange, but hey, I still got mine.'[at random][roman type][line break][big he of M] climbs off you without another word and immediately loses interest.";
		SexAddictUp 1;
		SemenTasteAddictUp 1;
		FavourDown M by 1;
		Bore M;
		now the sex-length of M is 0.

To say ErectionNearingClimaxFlav of (M - a demoness):
	say "[one of][BigFuckerDesc of M]'s eyes glow ominously, [his of M] nails digging into your skin as [he of M] speeds up.[or][BigFuckerDesc of M] growls hungrily as [he of M] rides you harder and harder![or][BigFuckerDesc of M] seems to be speeding up![at random] [one of][big he of M] must be close[or][big he of M] must be close to climax[or][big he of M] must be ready to cum[at random]!";

To say ErectionClimaxFlav of (M - a demoness):
	if M is soul-seeking:
		say "[BigNameDesc of M] speeds up, [his of M] [if M is presenting as male]hips[otherwise]butt[end if] clapping against your thighs as [his of M] [HoleDesc of M] begins to glow with ominous blue light. Impossibly strong waves of pleasure overwhelm your senses, and you cry out as [if refractoryperiod > 0]your body instantly forgets its refractory period and an[otherwise]a powerful[end if] orgasm boils up from your loins. [big he of M] slams [his of M] hips down in the moment that you cum, cackling madly as you flood [him of M] with every last drop of your [load].[line break][speech style of M]'Wow, did that feel good? I had no clue you would come so hard your soul would come out all by itself. I WAS SURE I'D HAVE TO RIP IT OUT MYSELF! HAHAHA!'[roman type][line break][big he of M] holds up a bright blue gemstone as your softening [player-penis] slips out of [him of M], and as the waves of pleasure slowly begin to fade, a strange feeling of emptiness settles heavily in your chest.";
		orgasm quietly;
		compute M taking soul;
		DexUp 3;
		StrengthUp 3;
		IntUp 3;
		now M is not soul-seeking;
	otherwise:
		say "[BigNameDesc of M] throws [his of M] head back, gritting [his of M] teeth as [he of M] climaxes all over your [ShortDesc of penis].[line break][speech style of M]'[one of]Cum inside me, mortal! NOW!'[or]I want it all, mortal! NOW!'[or]Give me your cum, mortal! NOW!'[in random order][roman type][line break][big he of M] slams [his of M] hips down as a final, powerful blast of heat assaults your [player-penis], causing it to tingle from top to bottom as you feel an orgasm boil up from your loins. [if refractoryperiod > 0]Your body instantly recovers from its refractory period[otherwise]Your body succumbs immediately[end if], and you groan with pleasure as you fill [FuckerDesc of M]'s [HoleDesc of M] with every last drop of your [load].";
		orgasm quietly;
		compute happy reward of M.

Section 1 - Protect and Attack

To compute (M - a demoness) protecting against (X - a monster):
	if X is demoness and the class of the player is not succubus:
		say "[speech style of M]'I'm afraid I would ally with any of my sisters over an inconsequential mortal any day of the year!'[roman type][line break][BigNameDesc of M] stands next to the [X].";
		anger M;
	otherwise if X is unicorn:
		if (a random number between 1 and 2 is 1) or (the class of the player is succubus and a random number between 1 and 4 is 1):
			say "[speech style of M]'What do you think you're doing!? [if the class of the player is succubus]You're going to damage the horn, idiot[otherwise][caps he of X]'S MINE[end if]!'[roman type][line break][BigNameDesc of M][']s eyes turn red as [he of M] rounds on you.";
			anger M;
		otherwise:[She can resist, but not for very long]
			say "[BigNameDesc of M][']s eyes dart between you and [NameDesc of X], rage slowly building up in [his of M] features every time [he of M] looks your way.";
	otherwise:
		say "[speech style of M]'Don't go [if the player is at least partially monster stuck]having too much fun[otherwise]getting yourself caught[end if] now!'[roman type][line break][BigNameDesc of M] cackles and wanders off.";
		bore M.

To compute the orifice choosing of (M - a demoness):
	if M is unfriendly:
		now the chosen-orifice of M is asshole;
		if the excitement of M > 5 or doomed is 5 or demon lord is alive or M is power-peaked:[she has to be in the mood for vaginal sex]
			if the player is possessing a vagina and a random number between 1 and 2 is 1, now the chosen-orifice of M is vagina;

This is the demoness punishes diaper rule:
	let P be a random sex toy penetrating asshole;
	let D be a random worn diaper;
	let M be current-monster;
	if P is a thing:
		say "[BigNameDesc of M] cackles.[line break][speech style of M]'I can [if P is currently visible]see[otherwise]sense[end if] that toy you're wearing underneath your nappy, you know. You really are a pervert aren't you? Here, let me help you out...'[roman type][line break]";
		if the size of P < a random number between 6 and 10:
			say "Smirking, [NameDesc of M] uses [his of M] infernal magic to make your [P] grow inside of your [asshole]!";
			increase the size of P by 1;
			if the size of P > the openness of asshole, say "You're being stretched even wider than before!";
		otherwise if the player is able to get horny:
			say "With a snap of [his of M] fingers, the [P] begins twisting, shaking and vibrating violently! Your [if the anal sex addiction of the player < 5]poor [end if][asshole] is quickly overstimulated, and you shudder [if the humiliation of the player < 25000]with shame [end if] as you are brought to a quick and brutal climax.";
			anally orgasm shamefully;
			if the soreness of asshole < 7:
				say "Your [asshole] feels [if the soreness of asshole < 5]significantly [end if] worse for wear!";
				now the soreness of asshole is 7;
		otherwise:
			say "With a snap of [his of M] fingers, the [P] begins twisting, shaking and vibrating violently! Your [if the anal sex addiction of the player < 5]poor [end if][asshole] is powerfully stimulated.";
			ruin asshole times 2;
		say "[BigNameDesc of M] seems satisfied, and leaves you alone.";
		bore M;
		rule succeeds;
	otherwise if D is total protection and (the urine-soak of D > 0 or the player is diaper focused):
		compute prostate plugging of M;
		rule succeeds.
The diaper punishment rule of a demoness is usually the demoness punishes diaper rule.

To compute prostate plugging of (M - a demoness):
	let P be a random off-stage prostate massager plug;
	let D be a random worn diaper;
	if P is plug:
		say "[if D is messed and diaper quest is 0][BigNameDesc of M] has a sour expression on [his of M] face when [he of M] assesses the state of your [D].[line break][speech style of M]'Oh my word, you've actually crapped in your nappy? How disgusting, there is no way I'm touching that. Here's something to make sure that doesn't happen again...'[otherwise if the urine-soak of D > 0 and diaper quest is 0][BigNameDesc of M] has a sour expression on [his of M] face when [he of M] assesses the state of your [D]. [speech style of M]'Oh my word, you've actually used your nappy? How disgusting, there is no way I'm touching that. You know what? If you love pissing yourself so much, then this should make your life more interesting...'[otherwise][BigNameDesc of M] has a sour expression on [his of M] face when [he of M] looks at your [D]. [speech style of M]'Ugh, you disgust me. If you really are perverted enough to like using one of those rather than a grown up toilet, then this should make your life more interesting...'[end if][roman type][line break]";
		if D is perceived unmessed, compute state check of D;
		say "[big he of M] shapes [his of M] hands like claws and points them towards your diapered butt. You yelp as you feel an invasion inside your [asshole]! It feels like a plug but it's shaped weirdly, and it's pressing against sensitive spots on the inside of your body, including your bladder! [if the player is not bursting]You instantly feel you need to pee, but when you try to release, nothing comes out. You quickly realise it must be the plug! It's going to make it feel like you constantly need to go...[end if]";
		summon P cursed with quest;
		now the size of P is the openness of asshole;
		say "With a quick cackle, [NameDesc of M] seems satisfied, and leaves you alone.";
	otherwise if watersports fetish is 1:
		say "[speech style of M]'If you want to be treated like a toilet, I'll treat you like a toilet.'[roman type][line break][BigNameDesc of M] stands over you and grabs you by the head with a surprisingly strong hand, directing your face towards [his of M] crotch. Before long [he of M] lifts up [his of M] dress, and releases a torrent of piss over your hair and face.";
		FacePiss from M;
	otherwise:
		say "[BigNameDesc of M] looks at your [D] with distaste.[line break][speech style of M]'Sorry, but I only play with grown ups who can control their own bladder.'[roman type][line break]It look like [he of M]'s decided to leave you alone.";
	satisfy M.

To compute anal sex of (M - a demoness):
	if there is a worn chastity cage:[implies penis]
		say "[BigNameDesc of M] keeps fucking you with [his of M] dildo heel, [if the anal sex addiction of the player <= 3]every little shove of [his of M] foot driving the fat girth of phallic glass into you, forcing your ass to stretch uncomfortably as your locked [sissy-penis] is completely ignored.[otherwise if the anal sex addiction of the player <= 5]every little push of [his of M] heel into you making your body loosen up, and your [player-penis] leak in its cage.[otherwise if the player is sexed male]each shove smashing your[second custom style] slutty prostate,[roman type] causing you to stifle a moan as another stream of [second custom style]sissy juice[roman type] is milked from your locked away [sissy-penis].[end if][line break][if the delicateness of the player - the soreness of asshole < 6][line break][first custom style]Ouch ouch ouch...[otherwise][line break][second custom style]Mnngggg...[end if][roman type][line break]";
	otherwise:
		say "[BigNameDesc of M] keeps fucking you with [his of M] dildo heel, [if the anal sex addiction of the player <= 3]every little shove of [his of M] foot driving the fat girth of phallic glass into you, forcing your ass to stretch uncomfortably.[otherwise if the anal sex addiction of the player <= 5]every little push of [his of M] heel into you making your body loosen up, and your skin crawl.[otherwise]each shove of [his of M] heel into your body causing you to stifle a moan.[end if][line break][if the delicateness of the player - the soreness of asshole < 6][line break][first custom style]Ouch ouch ouch...[otherwise][line break][second custom style]Oof![end if][roman type][line break]";
	if the reaction of the player > 0:
		let R be a random number between 1 and 11;
		say "You relax your [asshole] and let [him of M] fuck you. [if R > 6]You manage to prevent yourself becoming any more sore.[otherwise]However [his of M] thrusting is so deep and strong that it's still constantly stimulating the inside of your poor [asshole].[end if]";
		if R < 7, ruin asshole;
		if the reaction of the player is 2:
			decrease the raw difficulty of M by 2;
		otherwise:
			if M is friendly-fucking, decrease the excitement of M by 1;
			otherwise decrease the excitement of M by 2;
	otherwise:[resisting makes it last twice as long, but you have a better chance of killing her when she's finished.]
		ruin asshole;
		decrease the raw difficulty of M by 1.

To decide which number is the rounds of sex left of (M - a demoness):
	unless M is penetrating asshole, decide on the sex-length of M;
	if the soreness of asshole < 10:
		if the excitement of M > 1 and the difficulty of M > 1, decide on 1;[She'll keep going as long as you're interesting enough to torture, and she has enough power]
	decide on 0.

To compute unique climax of (M - a demoness) in (F - asshole):
	TimesSubmittedUp M by 1;
	if M is friendly-fucking:
		say "[if bukkake fetish is 1][BigNameDesc of M] slows down, cackling as [he of M] removes [his of M] heel from your [asshole]. You think that's the end of it, but a portal opens up above your head, and you find yourself looking down the barrel of a huge [DemonSkin of M] [manly-penis] as it ejaculates all over your face.[otherwise][BigNameDesc of M] slows down, and you hear a hearty cackle as [he of M] removes [his of M] heel from your [asshole].[end if]";
		if bukkake fetish is 1:
			if the semen load of M > 6, CumFaceUp 6;
			otherwise CumFaceUp the semen load of M;
	otherwise if the excitement of M < 2 or the difficulty of M < 2:
		say "[if the excitement of M < the difficulty of M][BigNameDesc of M] slows down, and you[otherwise][BigNameDesc of M] looks exhausted! You[end if] feel the magic grip on your body fade all at once as [he of M] removes [his of M] heel from your [asshole].";
		cutshow figure of demoness cutscene 3 for M;
		let P be a random sex toy carried by M;
		if P is a thing and asshole is not actually occupied:
			say " [BigNameDesc of M] uses the last of [his of M] energy to magically force the [P] back into your [asshole], smugly bearing a grin at the resulting [if the anal sex addiction of the player <= 3]gasp[otherwise if the anal sex addiction of the player <= 5]moan[otherwise]squeal[end if].";
			now P is worn by the player;
			now P is penetrating asshole;
			if the girth of P > the openness of asshole + 2:
				say "[variable custom style]Oof! It's so big![roman type][line break]";
				ruin asshole;
		if the excitement of M > the difficulty of M, bore M;[otherwise we leave it to the default function to run Satisfy M]
	otherwise:
		say "Only once you have been reduced to a puddle of tears does [NameDesc of M] stop fucking your [asshole]. [big he of M] cackles again and starts to wander off.";
		if there is an insertable object carried by M:
			let P be a random insertable object carried by M;
			say "Before [he of M] does, [he of M] makes sure to magically force the [P] back into your [asshole].";
			only summon P;
			if the girth of P > the openness of asshole + 2:
				say "[variable custom style]Oof! It's so big![roman type][line break]";
				ruin asshole; [we don't want this to cause fainting]
		if the raw difficulty of M < the starting difficulty of M, now the raw difficulty of M is the starting difficulty of M;
		FavourUp M;
	now M is penis-mode.

To compute the dildo stuck taunting of (M - a demoness):
	if there are worn heels:
		say "[if the channelling of M is 1][BigNameDesc of M] stops channelling [his of M] energy into the floor, and it returns to its normal cold temperature.[line break][end if][BigNameDesc of M] cackles at your situation on the dildo, and mutters a curse while pointing at your heels.";
		now the channelling of M is 0;
		repeat with H running through heels worn by the player:
			now H is not stuck;
			if the heel-height of H >= 8:
				DexDown 1;
			otherwise if H is cursed:
				increase the heel-height of H by 1;
			otherwise:
				curse H;
	otherwise:
		say "[BigNameDesc of M] cackles at your situation on the dildo, and mutters a curse while pointing at your feet.";
		if a random number between 1 and 2 is 1:
			say "You feel more lethargic.";
			DexDown 1.

To compute the busy waiting of (M - a demoness):
	say "[BigNameDesc of M] seems to be channelling energy into the gem hanging from [his of M] neck... and [his of M] stare is getting more[one of][or] and more[stopping] intense.";
	SilentlyDifficultyUp M by 1.

To compute (M - a demoness) taking soul:
	now the player is soulless;
	now M is carrying soul gem;
	SilentlyDifficultyUp M by 2;
	ultraHumiliate.

The demoness unique punishment rules is a rulebook. The unique punishment rule of demoness is usually the demoness unique punishment rules.

This is the demoness steals soul rule:
	let M be current-monster;
	let C be 0;
	if vagina is exposed or penis is exposed, increase C by 1;
	if the class of the player is priestess, now C is 1;
	if the class of the player is virgin warrior, increase C by 1;
	if the virgin bonus of the player > 0, increase C by the virgin bonus of the player;
	if virgincursed > 0, decrease C by 1;
	if chastity-belt is worn, now C is 0;
	if there is a worn chastity cage and the player is not possessing a vagina, now C is 0;
	if the player is souled and presented-orifice is nothing and a random number between 0 and C > 0:
		now refractoryperiod is 0;
		if the class of the player is priestess or the class of the player is virgin warrior or the virgin bonus of the player > 0, say "[speech style of M]'Your soul shines so brightly... Perhaps it can sate my hunger!'[roman type][line break]";
		otherwise say "[speech style of M]'[one of]Your soul is just begging to be stolen! Become my nourishment!'[or]Oooh, just look at what your soul is wearing... It's BEGGING to be stolen!'[then at random][roman type][line break]";
		cutshow figure of demoness cutscene 1 for M;
		say "[BigNameDesc of M] places one hand on your chest and [if penis is exposed]seizes your [ShortDesc of penis][otherwise if the player is possessing a penis]touches [his of M] fingertips to your [player-penis][otherwise if the player is possessing a vagina]touches [his of M] fingertips to your clit[end if] with the other. Otherworldly waves of pleasure surge through your body as [he of M] begins [if penis is exposed]expertly jerking you off[otherwise]expertly diddling your delicate little buzzer[end if], and your jaw goes slack as you desperately try to muster the will to resist.";
		if penis is exposed, stimulate penis times 3;
		otherwise stimulate vagina times 3;
		if refractoryperiod > 0:
			say "[BigFuckerDesc of M][']s hand somehow passes through your chest in the middle of your orgasm, and [he of M] cackles as [he of M] yanks out a beautiful bright blue gemstone. A pronounced empty feeling settles in your chest as [he of M] releases you.";
			satisfy M;
			compute M taking soul;
		otherwise:
			say "Somehow, you manage to resist the urge to cum, and [FuckerDesc of M] releases you, looking spurned.";
			bore M;
		rule succeeds.
The demoness steals soul rule is listed last in the demoness unique punishment rules.

This is the demoness doesn't care for skinny bitches rule:
	let M be current-monster;
	if the thickness of hips < 5 and the bimbo of the player < 9 and a random number between 1 and 3 is 1 and presented-orifice is nothing:
		say "[speech style of M]'You're not even worth my trouble.'[roman type][line break][BigNameDesc of M] loses interest.";
		alwayscutshow figure of demoness interact 5 for M;
		bore M;
		rule succeeds.
The demoness doesn't care for skinny bitches rule is listed last in the demoness unique punishment rules.

This is the demoness monster convinced rule:
	let M be current-monster;
	if the class of the player is priestess and vagina is a reasonable target:
		if presented-orifice is vagina:
			say "[BigNameDesc of M] smirks. [line break][speech style of M]'That's right, you little bitch priestess. That's the perfect way to defile you!'[roman type][line break]";
			now the chosen-orifice of M is vagina;
			rule succeeds;
		otherwise if a random number between the charisma of the player and 0 < 3:
			say "[BigNameDesc of M] smirks. [line break][speech style of M]'I have an even better idea for how to defile you. That little holy [cunt] is MINE!'[roman type][line break]";
			now the chosen-orifice of M is vagina;
			rule succeeds;
	if presented-orifice is asshole:
		if the favour of M < 0 and vagina is a reasonable target and a random number between 1 and 2 is 1:
			say "[BigNameDesc of M] smirks.[line break][speech style of M]'Well, if punishment is what you want...I have even BETTER idea!'[roman type][line break]";
			now the chosen-orifice of M is vagina;
		otherwise:
			say "[BigNameDesc of M] laughs.[line break][speech style of M]'That's right, accept it like a good slut. Let's see if you can last as long as I can...'[roman type][line break]";
			now the chosen-orifice of M is asshole;
		rule succeeds;
	otherwise if presented-orifice is not nothing:
		if presented-orifice is vagina and the vaginalvirgin of the player is 1:
			if the class of the player is worshipper, say "[BigNameDesc of M] laughs.[line break][speech style of M]'Even when you know your soul is on the line, you still want me to take your virginity? This must be my birthday...'[roman type][line break]";
			otherwise say "[BigNameDesc of M] laughs.[line break][speech style of M]'Really, you'll let me have your virginity? Hahaha...No takebacks!'[roman type][line break]";
			now the chosen-orifice of M is vagina;
		otherwise if the class of the player is worshipper and presented-orifice is a reasonable target:
			if a random number between the charisma of the player and 0 < 1:
				say "[BigNameDesc of M] laughs. [line break][speech style of M]'It's more fun when I destroy your ass. Here, let me show you...'[roman type][line break]";
				now the chosen-orifice of M is asshole;
			otherwise:
				say "[BigNameDesc of M] rolls [his of M] eyes. [line break][speech style of M]'Fine.'[roman type][line break]";
				now the chosen-orifice of M is presented-orifice;
		otherwise:
			say "[BigNameDesc of M] scowls.[line break][speech style of M]'Insolent human, don't you dare try and tell me where I can and can't use you! Your ass is mine!'[roman type][line break]";
			now the chosen-orifice of M is asshole;
		rule succeeds.
The monster convinced rule of demoness is usually the demoness monster convinced rule.

This is the demoness monster fucked taunting rule:
	let M be current-monster;
	if the latex-transformation of the player > 4:
		compute SelectionFrustrated of M;
	otherwise if watersports fetish is 1 and the number of monsters penetrating face is 0:
		say "[speech style of M]'Drown bitch, drown.'[roman type][line break][BigNameDesc of M] stands over you and grabs you by the head with a surprisingly strong hand, directing your face towards [his of M] crotch. Before long [he of M] lifts up [his of M] dress, and releases a torrent of piss over your hair and face. As the warm liquid cascades down your visage you cough and splutter, struggling to keep your eyes open as little droplets of the yellow fluid stray from your lips and cheeks to splash at your peepers.";
		FacePiss from M;
		satisfy M;
	otherwise:
		say "[BigNameDesc of M] laughs hysterically and winds a hand back up above [his of M] head, before swinging it down to crash [his of M] palm over your ass with a sickening crack. Oww!";
		BodyRuin 1;
	rule succeeds.
The monster fucked taunting rule of a demoness is usually the demoness monster fucked taunting rule.

This is the demoness punishing occupied assholes rule:
	let M be current-monster;
	let T be a random thing penetrating asshole;
	if T is vibrating plug panties:
		say "[BigNameDesc of M] mutters a curse from under [his of M] breath. You yelp uncontrollably as you feel the plug in your [asshole] suddenly grow and increase in vibration speed. You howl and hold your hands to your ass, as if that could help.";
		ruin asshole times 2;
		say "Luckily the plug returns to its original size and vibration speed after [NameDesc of M] stops concentrating. [big he of M] seems to lose interest in you... for now.";
		FavourUp M;
		bore M;
	otherwise if T is insertable and the size of T < 10:
		say "[BigNameDesc of M] mutters a curse from under [his of M] breath. You yelp uncontrollably as you feel the plug in your [asshole] suddenly grow! [if the openness of asshole <= the size of T]You howl and hold your hands to your ass, as if that could help[otherwise]It now is a better fit for your [asshole][end if].";
		increase the size of T by 1;
		if the openness of asshole < the size of T, ruin asshole;
	otherwise if watersports fetish is 1 and the number of monsters penetrating face is 0 and the latex-transformation of the player <= 4:
		say "[speech style of M]'Drown bitch, drown.'[roman type][line break][BigNameDesc of M] stands over you and grabs you by the head with a surprisingly strong hand, directing your face towards [his of M] crotch. Before long [he of M] lifts up [his of M] dress, and releases a torrent of piss over your hair and face. As the warm liquid cascades down your visage you cough and splutter, struggling to keep your eyes open as little droplets of the yellow fluid stray from your lips and cheeks to splash at your peepers.";
		FacePiss from M;
		satisfy M;
	otherwise if the openness of asshole < 7:
		say "[BigNameDesc of M] smirks and mutters a curse from under [his of M] breath. [if the openness of asshole < 10]You yelp as you feel the very strange sensation of your [asshole] loosening without anything actually touching it. [end if][BigNameDesc of M] seems to lose interest in you for now.";
		gape asshole times 2;
	otherwise:
		compute SelectionFailure of M.

To compute SelectionFailure of (M - a demoness):
	say "[speech style of M]'Bah! You're not even worth my time.'[roman type][line break][big he of M] growls in irritation and then leaves you alone.";
	alwayscutshow figure of demoness interact 5 for M;
	bore M;
	SilentlyDifficultyUp M by 2.

The demoness insertion rules is a rulebook. The insertion rules of a demoness are usually the demoness insertion rules.

This is the demoness asshole insertion rule:
	if the chosen-orifice of current-monster is asshole, follow the demoness asshole insertion rules.
The demoness asshole insertion rule is listed in the demoness insertion rules.

The demoness asshole insertion rules is a rulebook.

This is the demoness too tired to attack rule:
	let M be current-monster;
	if the difficulty of M <= 4:
		compute the busy waiting of M;
		rule succeeds.
The demoness too tired to attack rule is listed last in the demoness asshole insertion rules.

This is the demoness attacking ass covering clothing rule:
	let C be a random worn top level ass protection clothing;
	if C is clothing:
		compute current-monster attacking C;
		rule succeeds.
The demoness attacking ass covering clothing rule is listed last in the demoness asshole insertion rules.

To compute (M - a demoness) attacking (C - a clothing):
	if C is indestructible:
		compute SelectionFrustrated of M;
	otherwise:
		say "[BigNameDesc of M] touches a finger to the crotch of your [ShortDesc of C] and you can feel the heat... [he of M][']s trying to burn them off!";
		let R be (a random number between the difficulty of M and 6) + (a random number between the difficulty of M and 6);
		if M is power-peaked, now R is 99;
		if debuginfo > 0, say ClothingAttackDebug of M on C with R;
		if R > the defence of C:
			say "[big he of M] burns them completely off!";
			destroy C;
		otherwise if R > the defence of C - 3 and C is rippable:
			ZipOrRip C;
			say "[big he of M] has managed to create a hole at the crotch of your [C]!";
		otherwise:
			say "[big he of M]'s slowly burning them off!";
			damage C.

This is the demoness removing butt plug rule:
	let C be a random worn insertable thing penetrating chosen-orifice of current-monster;
	if C is a thing:
		compute current-monster removing C;
		rule succeeds.
The demoness removing butt plug rule is listed last in the demoness asshole insertion rules.

To compute (M - a demoness) removing (P - a clothing):
	let O be chosen-orifice of M;
	say "Using [his of M] otherworldly powers, [NameDesc of M] pulls the [printed name of P] from your [variable O] without even touching it.[if the grip of P > 5 and O is asshole] Its size and shape means that it creates a lewd 'PLOP' sound as your [asshole]'s sphincter collapses on itself.[end if]";
	if P is cursed, now P is held by M;
	otherwise now P is in the location of the player;
	now P is not penetrating O.

To compute (M - a demoness) removing (P - an anal beads):
	let O be chosen-orifice of M;
	say "[BigNameDesc of M] catches the hooked end of your [printed name of P] with the spike of [his of M] heel, cackling cruelly as [he of M] yanks them out one by one. [if the grip of P > 5 and O is asshole]The last of them makes a lewd 'PLOP' sound as your [asshole][']s sphincter collapses in on the newly emptied space.[end if]";
	if P is cursed:
		now M is carrying P;
	otherwise:
		now P is in the location of the player;
	dislodge P.

This is the demoness penetrating asshole rule:
	compute current-monster entering anally;
	rule succeeds.
The demoness penetrating asshole rule is listed last in the demoness asshole insertion rules.

To compute (M - a demoness) entering anally:
	if asshole is not actually occupied:
		now M is heel-mode;
		if the excitement of M < the difficulty of M, now the excitement of M is the difficulty of M;
		if the player is possessing a penis:
			if there is a worn chastity cage:
				say "[big he of M] taps your chastity cage with [his of M] foot, laughing as your [sissy-penis] strains in its tight prison. [big he of M] then traces a finger around your [asshole][if the player is possessing a scrotum] and squeezes your balls[end if] as you squirm beneath [him of M].[line break][speech style of M]'[one of]You [if the player is gendered male]sissy [end if]mortals are so fun to crush...'[or]Awww is your [sissy-penis] all locked away? I hope you like anal, because that's all the sex you're getting from now on...'[or]I'm going to spread you out slut, try not to lose your mind.'[stopping][roman type][line break]";
			otherwise:
				if the player is possessing a scrotum, say "[big he of M][if the size of penis >= 8] gives your [ShortDesc of penis] a few generous pumps and runs [his of M] fingernails down your lower back.[otherwise] slaps your [AssDesc] and presses one of [his of M] heels into your dangling [sissy-penis] and balls, the long 8 inch heel reminding you of your sexual inadequacy.[end if][roman type][line break][speech style of M]'Get ready to be stretched out by your [literalMistress of M].'[roman type][line break]";
				otherwise say "[big he of M][if the size of penis >= 8] gives your [ShortDesc of penis] a few generous pumps and runs [his of M] fingernails down your lower back.[otherwise] slaps your [AssDesc] and presses one of [his of M] heels into your dangling [sissy-penis], the long 8 inch heel reminding you of your sexual inadequacy.[end if][roman type][line break][speech style of M]'Get ready to be stretched out by your [literalMistress of M].'[roman type][line break]";
		say "[BigNameDesc of M] lifts up one of [his of M] feet, on which are [his of M] unique black shoes with [one of]dulled[or]shiny[sticky random] glass dildos for heels. [big he of M] continues cackling and pushes the heel into your [asshole]! As the demoness sinks in, [he of M] curls [his of M] lips into a wicked grin, gritting [his of M] teeth and going wide-eyed. Clearly [he of M] enjoys [himself of M] behind you as a cackle rings out to [if M is abyssal demoness]echo off the walls[otherwise]rustle the trees[end if]. Either [he of M] is really pent up or just enjoys ruining the players. Some kind of magic grasp is preventing you from moving.";
		now M is penetrating asshole;
		if the soreness of asshole < 10, ruin asshole;
	otherwise:
		say "[BigNameDesc of M] sees that you are already occupied and loses interest.";
		Distract M.

This is the demoness mouth insertion rule:
	if the chosen-orifice of current-monster is face, follow the demoness mouth insertion rules.
The demoness mouth insertion rule is listed in the demoness insertion rules.

The demoness mouth insertion rules is a rulebook.

This is the demoness removing gag rule:
	let C be a random worn clothing penetrating face;
	if C is a thing:
		compute current-monster removing C;
		rule succeeds.
The demoness removing gag rule is listed last in the demoness mouth insertion rules.

This is the demoness penetrating mouth rule:
	compute current-monster entering mouth;
	rule succeeds.
The demoness penetrating mouth rule is listed last in the demoness mouth insertion rules.

This is the demoness vagina insertion rule:
	if the chosen-orifice of current-monster is vagina, follow the demoness vagina insertion rules.
The demoness vagina insertion rule is listed in the demoness insertion rules.

The demoness vagina insertion rules is a rulebook.

The demoness removing butt plug rule is listed last in the demoness vagina insertion rules.[remove any plugs]

This is the demoness penetrating vagina rule:
	compute current-monster entering vaginally;
	rule succeeds.
The demoness penetrating vagina rule is listed last in the demoness vagina insertion rules.

This is the demoness penis mounting rule:
	if the chosen-orifice of current-monster is penis, follow the monster penis insertion rules. [default]
The demoness penis mounting rule is listed in the demoness insertion rules.

The demoness attack rules is a rulebook. The attack rules of demoness is usually the demoness attack rules.

To decide which number is the melting point of (H - a clothing):
	let T be 1;
	if H is glass, now T is 6;
	if H is leather, now T is 4;
	if H is satin, now T is 3;
	if H is pvc, now T is 2;
	if H is latex, now T is 2;
	decide on T.

This is the greater demoness lockdown rule:
	let M be current-monster;
	if (M is power-peaked or M is abyssal demoness) and the number of barriers in the location of the player is 0:
		say "[BigNameDesc of M] places [his of M] hands on the ground and concentrates. A ring of bright [if M is abyssal demoness]blue[otherwise]red[end if] flames springs into existence around the edges of the room! [bold type]You're trapped![roman type][line break]";
		now flaming-wall is in the location of the player;
		rule succeeds.
The greater demoness lockdown rule is listed in the demoness attack rules.

floorHeatCharge is a number that varies.

This is the demoness floor heating rule:[This may seem unfair when paired with the "lockdown," but the demoness literally has no other way of attacking you]
	let M be current-monster;
	if M is not abyssal demoness:
		let H be a random worn heels;
		if the channelling of M is 0, say "[BigNameDesc of M] places [his of M] hands on the ground and concentrates. The floor suddenly turns bright red! [big he of M]'s making the ground uncomfortably hot!";
		otherwise say "[BigNameDesc of M] is still concentrating on making the floor hot!";
		cutshow figure of demoness cutscene 4 for M;
		increase floorHeatCharge by 1;
		if floorHeatCharge >= combatSpeed:
			now floorHeatCharge is 0;
			if H is heels:
				if H is cursed:
					say "Your cursed heels seem to magically conduct the heat perfectly, heating up the soles of your feet! You jump from foot to foot, but the heat is very quickly becoming unbearable!";
					if there are worn stockings, BodyRuin 1;
					otherwise BodyRuin 2;
				otherwise if a random number from 1 to the melting point of H is 1:
					if H is stuck:
						if the heel-height of H > 1:
							say "Your [printed name of H] continue to melt, and are getting shorter!";
							decrease the heel-height of H by 1;
						otherwise:
							say "Your [printed name of H] melt away into nothingness!";
							now H is not stuck;
							destroy H;
					otherwise:
						say "Your [printed name of H] start to melt, and are now stuck to the floor!";
						now H is stuck;
				otherwise if the channelling of M is 0:
					say "Your heels look like they might melt into the surface!";
			otherwise:
				say "You jump from foot to foot, but the heat of the ground on your [unless there are worn shoes]bare [end if]feet is very quickly becoming unbearable!";
				if there are worn stockings, BodyRuin 1;
				otherwise BodyRuin 2;
		now the channelling of M is 1.
The demoness floor heating rule is listed in the demoness attack rules.

To say FriendlySexReleaseRefusalSpeech of (M - a demoness):
	unless M is penetrating asshole:
		if futanari fetish > 0:
			say "[speech style of M]'[one of]Yes! Fight me! I love it when you fight!'[or]Ooh! Yeah! Fight me! Fucking fight me!'[or]You can't keep resisting forever! Hahaha!'[or]I always get what I want!'[or]Resist me, slut! Show me how pure you are!'[or]Ooh... you are going to taste so good!'[in random order][roman type][line break]";
			if M is penetrating face and futanari fetish is 1, cutshow figure of demoness cutscene 5 for M; [futa with balls]
		otherwise:
			say "[speech style of M]'[one of]Shhh...'[or]That's right, get all that fight out of your system...'[or]Sh-sh-shhh...'[or]That's right sweetie, keep fighting. [big he of a random tentacle monster] loves that.'[or]No running away now sweetheart...'[in random order][roman type][line break]";
	otherwise:
		say "[speech style of M]'[one of]I'm not stopping until you're in tears!'[or]Stop? No! I want to make you suffer!'[or]Yes! Suffer for me! Tell me how much you hate it!'[or]Oooh! Yes! Hate me! Tell me you hate me!'[or]Struggle harder! I want it to HURT!'[or]Why stop when I have so much pain to give?'[or]Never! HAHAHAHA!'[in random order][roman type][line break]";
		if futanari fetish is 1, cutshow figure of demoness cutscene 6 for M. [futa with balls]

Definition: a demoness is willing to let go: decide no.

To compute (M - a demoness) entering mouth:
	now the excitement of M is 0;
	if face is not actually occupied:
		if futanari fetish is 0:
			say "[BigNameDesc of M] kneels down next to you, [one of]drawing a glowing circle in the soil underneath you. [big he of M] holds you down as a [DemonSkin of M] tentacle emerges and shoves itself into your mouth.[or]using an incantation to open a portal on the ground underneath you. [big he of M] holds you down as a [DemonSkin of M] tentacle emerges and shoves itself into your mouth.[at random]";
			[cutshow figure of demoness cutscene 7 for M;]
		otherwise:
			say "[one of]You watch in [horror (the oral sex addiction of the player * 2)][or]You watch[stopping] as [NameDesc of M] lifts up [his of M] skirt, [his of M] clit throbbing and shaking as it swells into a massive [DemonSkin of M] penis, standing proudly erect from [his of M] hairless labia.";
			say FriendlyMouthPenetrationFlav of M;
			[cutshow figure of demoness cutscene 8 for M;]
		get facial penetration image for M;
		now the sex-length of M is 3;
		if M is power-peaked, increase the sex-length of M by 1;
		now M is penetrating face;
	otherwise:
		say "[BigNameDesc of M] sees that you are already occupied and loses interest.";
		distract M.

To say FriendlyOralRequest of (M - a demoness):
	if the oral sex addiction of the player < 4:
		say "[first custom style]'[one of]I'm taking the deal. That's all I'm doing. [if the player is gendered male]This isn't a gay thing.'[otherwise]Don't get any sick ideas.'[end if][or]I'll take the deal. [if bukkake fetish is 1]But don't you fucking dare cum on my face.'[otherwise]But I'm not going to pretend I enjoy sucking dick. Got it?'[end if][or]I'm hoping this deal isn't what I think it is...'[at random][roman type][line break]";
		cutshow figure of demoness cutscene 9 for M;
	otherwise if semen is craved:
		say "[second custom style]'[one of]Cum is part of my reward right? I'm desperate for a taste...'[or]I really need to wet my throat, give me whatever you want...'[or]Let me have a taste of your cum. I promise I'll take whatever reward you want...'[at random][roman type][line break]";
		cutshow figure of demoness cutscene 9 for M;
	otherwise if the oral sex addiction of the player < 7:
		say "[variable custom style]'[one of]I... I'll take your deal.'[or]So, all I have to do is suck your dick, right? That's really it?'[or]I guess if I get something out of it, it's OK...'[or]Alright, it's a deal. It's still on, right?'[or]I could really use your help. Sucking your dick is totally worth that.'[at random][roman type][line break]";
		cutshow figure of demoness cutscene 10 for M;
	otherwise:
		say "[variable custom style]'[one of]Looking for a throat to fuck[or]How would you like a sloppy blowjob[or]Care for me to swallow your load[or]Are you going to let me taste your [DickDesc of M][in random order], babe?'[roman type][line break]";
		cutshow figure of demoness cutscene 10 for M.

To say TakeMyVirginity of (M - a demoness):
	if M is unfriendly:
		if the anal sex addiction of the player < 3:
			say "[first custom style]'Please, whatever you do, just don't stick it in my butt. I'd even prefer you took my virginity...'[roman type][line break]";
		otherwise if the sex addiction of the player < 9:
			say "[variable custom style]'Go ahead, deflower me. It was only a matter of time anyway.'[roman type][line break]";
		otherwise:
			say "[second custom style]'I've been waiting a long time for the cock worthy of this [vagina]... alright, go ahead, take my virginity - break me in!'[roman type][line break]";
	otherwise:
		if the sex addiction of the player < 5:
			say "[first custom style]'[if the player is afraid of a creampie]Alright, I'm taking your deal, but you WILL NOT cum inside me.'[otherwise if the player is feeling dominant]I'll take your deal, even though it's probably not even worth it.'[otherwise]Ugh, if I'm going to lose my purity in this game I might as well get something for it.'[end if][roman type][line break]";
		otherwise if the vaginal sex addiction of the player < 6:
			say "[variable custom style]'[one of]I guess it's about time I lost my virginity. Might as well get something out of it...'[or]Most people would just take my virginity without asking, so I guess I should accept.'[at random][roman type][line break]";
		otherwise:
			say "[second custom style]'[one of]So I finally get to punch my V-card and I get a paycheck?! Sign me up, girl!'[or]I don't really care about your deal or whatever, I'm just dying to have you break me in!'[at random][roman type][line break]".

To say NearingClimaxOral of (M - a demoness):
	if futanari fetish > 0 or lady fetish is 2:
		say "[one of][BigNameDesc of M] grabs your head with both hands, leering down at you as [his of M] thrusts get closer and closer together...[or][BigNameDesc of M][']s face contorts into an evil grin as [he of M] begins to thrust faster and faster.[or][line break][speech style of M]'Get ready.'[roman type][line break][BigNameDesc of M] hisses, giving you a sick grin as [he of M] tightens [his of M] grip on your head.[or][BigNameDesc of M] tightens [his of M] grip on your head, grinning cruelly as [he of M] thrusts faster and faster...[in random order] [one of][big he of M] must be close[or][big he of M] must be close to climax[or][big he of M] must be ready to cum[at random]!";
	otherwise:
		say "[one of]The tentacle seems to be speeding up![or][BigNameDesc of M] chuckles, tightening [his of M] grip as the tentacle speeds up.[or][BigNameDesc of M] tightens [his of M] grip on your head, chuckling as the tentacle speeds up.[or][BigNameDesc of M] chuckles, pumping the muscular tentacle with one hand as it speeds up.[at random]".

To say FriendlySexResistFlav of (M - a demoness):
	if the player is able to speak, say "[variable custom style]'[if the player is in danger][one of]Wait, stop!'[or]Uh-oh. Please get off quickly, I need to deal with this!'[or]FUCK!'[at random][otherwise][one of]This was fun, but we need to stop now.'[or]I'm finished now, please let me go!'[or]I've changed my mind!'[or]Sorry, I'm not feeling it any more.'[at random][end if][roman type][line break]";
	otherwise say "[if the player is able to make sounds][line break][variable custom style][muffled sounds][roman type][line break][end if]";
	if M is penetrating face, say OralResisting of M;
	otherwise say "[one of]You tap [NameDesc of M] on the [if M is human]shoulder[otherwise]back[end if], trying to get [him of M] to stop.[or]You try to yank your [if M is penetrating a fuckhole]hips[otherwise if M is penetrating face]head[otherwise]body[end if] away from [NameDesc of M][']s grasp.[or]You try and pull [NameDesc of M] [if M is penetrating an orifice]out[otherwise]off[end if] of you.[or]You turn and try to push [NameDesc of M] off you.[purely at random]".

To say OralResisting of (M - a demoness):
	if futanari fetish is 0 and lady fetish < 2:
		say "[one of][BigNameDesc of M] ensures that your attempts to resist amount to nothing at all, cackling at your [if the oral sex addiction of the player < 4]pained[otherwise]weary[end if] expression[or][BigNameDesc of M] easily thwarts your attempts to escape with inhuman strength, [his of M] muscles barely straining as [he of M] effortlessly overpowers you.[or][BigNameDesc of M] whispers an incantation in your ear at the first sign of struggling, which instantly drains all fight from your body.[or][BigNameDesc of M] holds you tightly, preventing more than an inch of movement in any direction with inhuman strength.[at random]";
	otherwise:
		say "[one of]You try as hard as you can to pull away, but [his of M] grip is inhumanly strong![or][BigNameDesc of M] effortlessly holds you in place, forcing you to sit still.[or][if the oral sex addiction of the player < 3]You stay completely still, blatantly refusing to do anything at all to pleasure [him of M].[otherwise if the oral sex addiction of the player < 7]You stay completely still, knowing that if you willingly pleasure [him of M] you might like it and not stop.[otherwise]You stay completely still, hoping [he of M] might *punish* you for slacking off.[end if][in random order]".

To say OralResistingResponse of (M - a demoness):
	if futanari fetish is 0 and lady fetish < 2:[could be expanded some more]
		say "[one of][BigNameDesc of M] forces you to stay still as the tentacle jams itself in and out of your mouth[or]The tentacle continues to jam itself in and out of your mouth, seemingly unaware of your struggling[or]The tentacle continues thrusting without acknowledging your protests, lewd squelching noises ringing through the clearing as it aggressively pumps your throat.[or][line break][speech style of M]'[if the reaction of the player is 0]Fighting[otherwise]Begging[end if] won't help. This only ends when [he of a random tentacle monster]'s ready to cum,'[roman type][line break][NameDesc of M] whispers, holding you still as the tentacle continues to fuck your throat.[at random]";
	otherwise:
		SilentlyDifficultyUp M by 1;
		say "[one of][BigNameDesc of M] seems to be actively turned on by your lack of cooperation, thrusting faster and harder with every moment of resistance[or][BigNameDesc of M] maintains a firm grip on the back of your head, [his of M] [manly-penis] seeming to get harder with every attempt at resisting![or][BigNameDesc of M], as if [he of M] knew your intent before you acted on it, immediately grabs you and begins aggressively face-fucking you the instant you try to resist.[or][BigNameDesc of M] cackles, grabbing you with both hands and aggressively face-fucking you until the very idea of resisting makes you sick to your stomach.[or][BigNameDesc of M] thrusts with undisguised malicious intent, keeping your throat fully plugged with [manly-penis] any time you try to breathe in.[or][BigNameDesc of M] seems to thrust faster and harder in response to your protests![in random order]".

To say OralSubmissionResponse of (M - a demoness):
	if futanari fetish is 0 and lady fetish < 2:
		increase the throating of M by 1;
		say "[one of][BigNameDesc of M] holds the tentacle with one hand, helping it to repeatedly shove itself down your throat.[or][BigNameDesc of M] nibbles on your ear as the tentacle fucks your throat, distracting you with the practised ministrations of [his of M] tongue.[or][BigNameDesc of M] tweaks your nipples and nips at your ear as the tentacle fucks your throat, somehow turning the experience into something bordering on pleasurable.[or][line break][speech style of M]'That's right... Let [him of a random tentacle monster] use you,'[roman type][line break][NameDesc of M] whispers, gently groping your [BreastDesc] and teasing your nipples as the tentacle repeatedly jams itself down your throat.[at random]";
	otherwise:
		say "[one of]You bob your head up and down, [if the player is not a pervert]eyes screwed shut in shame[otherwise if the player is feeling dominant]avoiding eye contact[otherwise]looking up at [NameDesc of M][end if] as you submissively polish [his of M] shaft.[or]You make [if the oral sex addiction of the player < 3]quiet[otherwise if the oral sex addiction of the player < 6]distinct[otherwise]exaggerated[end if] slurping noises as you suck [NameDesc of M][']s [manly-penis], [if the oral sex addiction of the player < 4]determined to get this over and done with as soon as possible[otherwise if the oral sex addiction of the player < 6]determined to get [him of M] off as soon as possible[otherwise]determined to get [him of M] shooting off in your mouth as soon as possible[end if].[or][BigNameDesc of M] guides the movement of your head as you [if the oral sex addiction of the player < 3]quietly [otherwise if the oral sex addiction of the player > 6]noisily [end if] suck [his of M] [manly-penis], [if the oral sex addiction of the player < 4]making you feel even more like a dirty slut. If that was even possible.[otherwise if the oral sex addiction of the player < 6]silently assuring you that you're doing a good job.[otherwise]allowing you to do all the work like the dirty slut you are.[end if][or][BigNameDesc of M] rolls [his of M] hips to complement the [if the oral sex addiction of the player > 5]enthusiastic [otherwise if the oral sex addiction of the player < 4]slow [end if]bobbing of your head.[or][BigNameDesc of M] allows you to do most of the work, [if the player is not a pervert]picking up the slack whenever the shame gets to be too much[otherwise if the oral sex addiction of the player < 6]picking up the slack whenever you get tired[otherwise]grunting with pleasure as you drag your tongue up [his of M] shaft[end if].[in random order]".

To compute facial climax of (M - a demoness):
	TimesSubmittedUp M by 1;
	BlowCount;
	if futanari fetish is 0:[This means the demoness is having a tentacle facefuck you as part of your deal, and it always finishes in your mouth.]
		say "[BigNameDesc of M] grabs the tentacle as it tenses, pushing it in as deep as it can go as [one of]spurt after spurt[or]gush after gush[or]a huge amount of[at random] [tasted-semen] [one of]rushes[or]shoots[at random] down your throat, keeping it there until your gag reflex subsides and every last drop of its demonic seed has settled fully in your belly.";
		compute happy oral sex reward of M;
		now M is not penetrating face;
		StomachSemenUp the semen load of M;
	otherwise if the reaction of the player is 0:
		if M is willing to bukkake:
			compute failed facial dodging of M;
		otherwise if player-gagging is false:
			compute oral creampie of M;
		otherwise:
			compute deepthroat creampie of M;
	otherwise:
		if M is willing to bukkake:
			compute facial accepting of M;
		otherwise:
			compute deepthroat creampie of M;
	orgasm satisfy M.

Definition: a demoness (called M) is willing to bukkake:
	if the player is a blowjob slut or M is power-peaked, decide no;
	if bukkake fetish is 1 and a random number between 1 and 2 is 1, decide yes;
	decide no.

To decide which number is the condom resistance of (M - a demoness):
	decide on 99.

To get oral creampie image for (M - a demoness):
	if futanari fetish > 0, cutshow figure of demoness cutscene 11 for M. [Futa with or without balls]

To compute failed facial dodging of (M - a demoness):
	say FacialBrokenFree of M;
	say FailedFacialDodge of M;[demoness is too fast for you to dodge]
	CumFaceUp the semen load of M;
	check forgiveness of M.

To say FailedFacialDodge of (M - a demoness):
	say "[one of][BigNameDesc of M] grabs you again with inhuman speed, [his of M] [manly-penis] bobbing in your face as it paints you with rope after rope of sticky white [semen].[or][BigNameDesc of M] catches you with inhuman speed, forcing you to sit still as [he of M] ejaculates all over your face.[or][BigNameDesc of M] catches you with seemingly inhuman reflexes, groaning as [his of M] [manly-penis] unleashes its massive load all over your face.[or][BigNameDesc of M] catches you in an instant, cackling as [he of M] shoots rope after rope of sticky white [semen] all over your face.[or][BigNameDesc of M] catches you almost instantly, leaving you to [if the semen addiction of the player < 8]struggle in vain as [he of M] unloads all over your face.[otherwise if the semen addiction of the player < 12]half-heartedly struggle as [he of M] unloads all over your face.[otherwise]giggle to yourself as [he of M] unloads all over your face.[end if][at random]".

To say UnavoidedFacial of (M - a demoness):[in your mouth, then on your face.]
	say "[one of][BigNameDesc of M] moans with pleasure as [he of M] ejaculates, shooting several ropes of thick, warm [semen] straight down your throat before pulling out and finishing all over your face.[or][BigNameDesc of M] groans with pleasure, spurting in your mouth before shoving you off and finishing all over your face.[or][BigNameDesc of M] holds you down, forcing you to swallow as [his of M] [manly-penis] shoots directly into your mouth. You [if the semen taste addiction of the player < 7]sigh in relief[otherwise if the semen taste addiction of the player < 12]sigh[otherwise]emit a grunt of displeasure[end if] as [he of M] pushes you off, only to take the second half of [his of M] load all over your face.[at random]";

To say SwallowDemand of (M - a demoness):
	say "[speech style of M][one of]'Eat up. You want your reward, don't you?'[or]'Good sluts swallow cock, and [semen].'[or]'Gargle and swallow [semen] like the filthy slut you are!'[or]'I shouldn't have to tell you to swallow slut.'[in random order][roman type][line break]".

To compute happy reward of (M - a demoness):
	if M is friendly-fucking:
		let R be a random number between 1 and 5;
		let J be a random off-stage plentiful accessory;
		let A be a random number between 2 and 3;
		if M is not dealing or (R is 5 and J is not clothing) or (R is 3 and the strength of the player is 30) or (R is 4 and the dexterity of the player is 30):
			now R is 6;
		if debugmode > 0, say "Original choice is [R].[line break]";
		if R is 1 and the player is possessing a penis and the player is gendered male and M is not penetrating penis and the size of penis < 10:
			say "[speech style of M]'Such a good boy... You get confused for a girl a lot, don't you? It'll all change if your [manly-penis] gets a bit bigger. Trust me.'[roman type][line break] [BigNameDesc of M] points at your [ShortDesc of penis], which glows with purple light as it spontaneously grows.";
			let N be a random number between 2 and 3;
			if N + the size of penis > 10, now N is 10 - the size of penis;
			increase the size of penis by N;
		otherwise if R is 1 and M is not penetrating vagina and the player is possessing a vagina and the openness of vagina > 0:
			say "[speech style of M]'Good [boy of the player]. You remind me of myself before the dark lord made me into [his of demon lord] eternal servant.'[roman type][line break] [BigNameDesc of M] points at your [vagina], which glows with unnatural light as it spontaneously tightens.";
			let N be a random number between 2 and 3;
			PussyClose N;
		otherwise if R is 2 and M is not penetrating asshole and the openness of asshole > 0:
			say "[speech style of M]'[if the player is gendered male]Such a good boy... but with a loose hole like that it's obvious to everyone you make a better girl. I can keep a secret if you can.'[otherwise]Such a good girl... you deserve a fresh, tight asshole, don't you. It's not your fault if everyone wants to fuck you. I understand.'[end if][roman type][line break] [BigNameDesc of M] utters a short incantation, and you gasp as you feel your [asshole] spontaneously tighten.";
			let N be a random number between 2 and 3;
			AssClose N;
		otherwise if R is 3:
			say "[speech style of M]'[if the player is gendered male]Such a good [boy of the player]... I really think you need some nice, big sexy muscles. That's what I like.'[otherwise]Such a good [boy of the player]... but it must be tough getting overpowered by everybody that wants to fuck you. Let's fix that.'[end if][roman type][line break] [BigNameDesc of M] bends over and breathes a red mist over your body, which causes your muscles to suddenly bulge with new strength and definition.";
			StrengthUp A - 1;
		otherwise if R is 4:
			say "[speech style of M]'So obedient. I like that about you, but you don't have to be so rigid. Why don't I loosen you up a little?[roman type][line break] [BigNameDesc of M] lifts your chin, locking lips with you as thick, acrid smoke rushes into your mouth. A tingle moves up your spine as it fills your lungs, and you feel more flexible.";
			DexUp A - 1;
		otherwise if R is 5:
			say "[speech style of M]Good [boy of the player]. Now, as promised...[roman type][line break]";
			let N be a random number between 1 and 9;
			if N > 7, now J is pure diamond;
			otherwise now J is pink diamond;
			set shortcut of J;
			if J is actually summonable:
				say "[BigNameDesc of M] snaps [his of M] fingers, and a [printed name of J] materialises onto your [if J is ring]finger[otherwise]body[end if].";
				summon J;
			otherwise:
				say "[BigNameDesc of M] snaps [his of M] fingers, and a [printed name of J] materialises in front of you.";
				now J is in the location of the player;
		otherwise:
			say "[speech style of M]Good [boy of the player]. You always do as you're told. Come find me when you're ready to be my [if M is penetrating penis]dildo-[otherwise]cumdu-[end if]... I mean business partner again.'[roman type][line break][if M is penetrating vagina][BigNameDesc of M] scoops a bit of cum out of your [vagina] and sensually licks it off [his of M] fingers[otherwise if the semen coating of face > 0][BigNameDesc of M] uses a finger to wipe a bit of cum from your lower lip and sensually licks it off[otherwise][BigNameDesc of M] readjusts [his of M] clothes[end if] as [he of M] disappears in a burst of flames.";
			if M is penetrating vagina:
				decrease the semen volume of vagina by 1;
			otherwise if the semen coating of face > 0:
				decrease the semen coating of face by 1;
			distract M;
			regionally place M;
			FavourUp M by A;[Double the favour increase]
			now A is 0;
		SexAddictUp 1;
		SemenTasteAddictUp 1;
		check black lace transformation;
		FavourUp M by A.

To say ForgivenessFlav of (M - a demoness):
	say "[speech style of M]'Disobedient, but adorable. We can save your reward for next time, I suppose.'[roman type][line break][BigNameDesc of M] chuckles, disappearing in a burst of flames.";
	SilentlyDifficultyUp M by 2.

To compute angry punishment of (M - a demoness):
	if M is friendly-fucking:
		say "[speech style of M]'Oh well, I got what I wanted anyway. Hahahaha!'[roman type][line break][BigNameDesc of M] disappears in a burst of flames.[line break]";
		SexAddictUp 1;
		SemenTasteAddictUp 1;
		FavourDown M by 1;
	otherwise:
		say "[speech style of M]'Ingrate!'[roman type][line break][BigNameDesc of M] rakes [his of M] nails across your face.";
		PainUp 10.

This is the demoness friendly convinced rule:
	let M be current-monster;
	if presented-orifice is a breasts:
		if the player is soulless:
			say "[speech style of M]'[if M is carrying soul gem]I have your soul already, fool.'[otherwise]I'd love to take your soul, but you don't have one. Tch.'[end if][roman type][line break]";
		otherwise if the vaginalvirgin of the player is 1 and the player is possessing a vagina:[TODO: also make this exception for male virgins]
			say "[speech style of M]'[one of]You want me to take your soul? Let's make an event of it, then. Offer me your [pussy].'[or]No, offer me your [pussy]. I want to make sure you are rewarded properly when I take your soul.'[stopping][roman type][line break]";
		otherwise if the penetrativevirgin of the player is 1 and the player is possessing a penis:
			if virgincursed > 0, say "[speech style of M]'You want me to take your soul? [one of]That's so naive I could gobble you up right here and now... but your soul is worthless in its current state. Lose your virginity then come ask me again, ok?'[or]Ugh, I wish I got to you before you went and got your asshole deflowered. Ask me again when your curse is gone, ok?'[or]I'd love to, but you're cursed. We can talk once you're clean.'[at random]";
			otherwise say "[speech style of M]'[one of]You want me to take your soul? Let's make an event of it, then. Offer me your [player-penis].'[or]No, offer me your [player-penis]. I want to make sure you are rewarded properly when I take your soul.'[stopping][roman type][line break]";
		otherwise:
			say "[speech style of M]'[one of]You want me to take your soul?'[or]You're really just going to offer it up to me? Your soul?'[or]You want me to take your soul? Are you sure? I won't return it.'[or]Really? You're offering up your soul?'[at random]";
			if the player is consenting:
				say "[BigNameDesc of M] smirks, placing [his of M] hand on your chest and beginning to chant. A pronounced [i]empty[/i] feeling settles in your core as a bright blue gem materialises in [his of M] hand! [big he of M] then walks off, laughing.";
				FavourUp M;
				compute M taking soul;
			otherwise:
				say "[BigNameDesc of M] scoffs, immediately losing interest in you.";
				FavourDown M;
			Bore M;
			rule succeeds;
	otherwise if presented-orifice is a reasonable target and the refractory-period of current-monster <= 0:
		now the chosen-orifice of current-monster is presented-orifice;[This is on top so flavour can refer to chosen orifice.]
		say PresentFriendlyAcceptanceFlav of M;
		rule succeeds;
	otherwise if presented-orifice is not nothing:
		say PresentFriendlyRejectionFlav of current-monster.
The monster friendly convinced rule of a demoness is usually the demoness friendly convinced rule.


[This is the demoness monster convinced rule:
	let M be current-monster;
	if the class of the player is priestess and M is willing to do vaginal:
		if presented-orifice is vagina:
			say "[BigNameDesc of M] smirks. [line break][speech style of M]'That's right, you little bitch priestess. That's the perfect way to defile you!'[roman type][line break]";
			now the chosen-orifice of M is vagina;
			rule succeeds;
		otherwise if a random number between the charisma of the player and 0 < 3:
			say "[BigNameDesc of M] smirks. [line break][speech style of M]'I have an even better idea for how to defile you. That holy little [cunt] is MINE!'[roman type][line break]";
			now the chosen-orifice of M is vagina;
			rule succeeds;
	if presented-orifice is asshole:
		if M is willing to do vaginal and the favour of M < 0 and the player is possessing a vagina and a random number between 1 and 2 is 1:
			say "[BigNameDesc of M] smirks. [line break][speech style of M]'Well, if punishment is what you want...I have an even BETTER idea!'[roman type][line break]";
			now the chosen-orifice of M is vagina;
		otherwise:
			say "[BigNameDesc of M] laughs. [line break][speech style of M]'That's right, accept it like a good little slut. Let's see if you can last as long as I can...'[roman type][line break]";
			now the chosen-orifice of M is asshole;
		rule succeeds;
	otherwise if presented-orifice is not nothing:
		if presented-orifice is vagina and the vaginalvirgin of the player is 1:
			if the class of the player is worshipper, say "[BigNameDesc of M] laughs.[line break][speech style of M]'Even when you know your soul is on the line, you still want me to take your virginity? This must be my birthday...'[roman type][line break]";
			otherwise say "[BigNameDesc of M] laughs.[line break][speech style of M]'Really, you'll let me have your virginity? Hahaha...No takebacks!'[roman type][line break]";
			now the chosen-orifice of M is vagina;
		otherwise if the class of the player is worshipper and presented-orifice is a reasonable target:
			if a random number between the charisma of the player and 0 < 1:
				say "[BigNameDesc of M] laughs. [line break][speech style of M]'It's more fun when I destroy your ass. Here, let me show you...'[roman type][line break]";
				now the chosen-orifice of M is asshole;
			otherwise:
				say "[BigNameDesc of M] rolls [his of M] eyes. [line break][speech style of M]'Fine.'[roman type][line break]";
				now the chosen-orifice of M is presented-orifice;
		otherwise:
			say "[BigNameDesc of M] scowls. [line break][speech style of M]'Insolent human, don't you dare try and tell me where I can and can't use you! Your ass is mine.'[roman type][line break]";
			now the chosen-orifice of M is asshole;
		rule succeeds.
The monster convinced rule of demoness is usually the demoness monster convinced rule.]


To say PresentFriendlyAcceptanceFlav of (M - a demoness):
	unless presented-orifice is asshole:
		say "[speech style of M]'[one of]It's a deal.'[or]Heheheh... great.'[or]Good. Let's start with my payment.'[or]Haha, mortals are so stupid!'[or]You're a bit of an idiot, aren't you? Oh well.'[at random][roman type][line break]";
	otherwise:
		say "[speech style of M]'[one of]You think you can handle this? Cute.'[or]I exist to punish perverts like you!'[at random][roman type][line break]".

To say PresentFriendlyRejectionFlav of (M - a demoness):
	say "[speech style of M]'[if presented-orifice is a potential target]Not interested.'[otherwise]Not today, honey. I don't feel like it.'[end if][roman type][line break]".

To compute (M - a demoness) entering vaginally:
	now M is penis-mode;
	compute M entering vagina.

To compute unique penetration effect of (M - demoness) in (F - vagina):
	if M is soul-seeking:
		now the excitement of M is 10 + the virgin bonus of the player + the virginity-count of virginity-retention-quest;
		ruin vagina.

To say VaginalVirginityTaunt of (M - a demoness):
	say "[speech style of M]All gone! Hahaha![roman type][line break]".

To say PenPrep of (M - a demoness) in (F - vagina):
	if futanari fetish > 0 or lady fetish is 2:
		say "[one of]You watch in [horror (the vaginal sex addiction of the player * 2)][or]You watch[stopping] as [NameDesc of M] lifts up [his of M] skirt, [if lady fetish is 2][his of M] [DemonSkin of M] penis growing and throbbing as it [he of M] lines it up with your [vagina].[otherwise][his of M] clit throbbing and shaking as it swells into a massive [DemonSkin of M] penis, which stands proudly erect as [he of M] lines it up with your [vagina].[end if]";
	otherwise:
		say "[BigNameDesc of M] kneels down next to you, [one of]drawing a glowing circle in the soil underneath you.[or]using an incantation to open up a portal in the ground underneath you.[or]scratching a pentagram into the soil underneath you.[at random]".

To say VaginaPenetrationFlav of (M - a demoness):
	if futanari fetish > 0 or lady fetish is 2:
		say PenPrep of M in vagina;
		say PenetrationFlav of M in vagina;
	otherwise:
		say "[one of][big he of M] holds you down as a [DemonSkin of M] tentacle emerges and shoves itself into your [vagina][if the vaginalvirgin of the player is 1], removing your virginity forever[end if].[or][big he of M] holds you down as a [DemonSkin of M] tentacle emerges and shoves itself into your [vagina][if the vaginalvirgin of the player is 1], removing your virginity forever[end if].[at random]";
		if the vaginalvirgin of the player is 1, say VaginalVirginityTaunt of M;
	if the vaginalvirgin of the player is 1, now M is soul-seeking.[Tells the game that the demoness will take the player's soul at the end]

To say FriendlyVaginaPenetrationFlav of (M - a demoness):
	say FriendlyVaginaPenPrep of M;
	if futanari fetish > 0 or lady fetish is 2 or the vaginalvirgin of the player is 1:
		say PenetrationFlav of M in vagina;
	otherwise:
		say "[one of][big he of M] holds you down as a [DemonSkin of M] tentacle emerges and shoves itself into your [vagina][if the vaginalvirgin of the player is 1], removing your virginity forever[end if].[or][big he of M] holds you down as a [DemonSkin of M] tentacle emerges and shoves itself into your [vagina][if the vaginalvirgin of the player is 1], removing your virginity forever[end if].[at random]";
		if the vaginalvirgin of the player is 1, say VaginalVirginityTaunt of M;
	if the vaginalvirgin of the player is 1, now M is soul-seeking;

Definition: a demoness (called M) is virginity taking:
	if M is penis-mode, decide yes;
	decide no.

[We can't increase excitement here because this is called in the begging function]
To say (M - a demoness) rough sex (N - a number):
	let O be a random orifice penetrated by M;
	if futanari fetish is 0 and lady fetish < 2:
		say "[one of][BigNameDesc of M] forces you to stay still as the tentacle mercilessly pounds your [variable O][or]The tentacle continues to slam itself in and out of your [variable O], seemingly unaware of your struggling[or]The tentacle continues thrusting without acknowledging your protests, your abdomen bulging obscenely as it aggressively pumps your [variable O].[or][line break][speech style of M]'[if the reaction of the player is 0]Fighting[otherwise]Begging[end if] won't help. This only ends when [he of a random tentacle monster]'s ready to cum,'[roman type][line break][NameDesc of M] whispers, holding you still as the tentacle continues to fuck you senseless.[at random]";
	otherwise if N is 1:
		say sexRoughMoanFlav of M in O;
	otherwise if N is 2:
		say sexRoughGripFlav of M in O;
	otherwise if N is 3:
		say sexRoughMoanFlav of M in O;
	otherwise if N is 4:
		say sexRoughTittyFlav of M in O;
	otherwise if N is 5:
		say sexRoughFeelFlav of M in O;
	otherwise if N is 6:
		say sexRoughSplitFlav of M in O.

To say (M - a demoness) submission sex (N - a number):
	let O be a random orifice penetrated by M;
	if futanari fetish is 0 and lady fetish < 2:
		say "[one of][BigNameDesc of M] holds the tentacle with one hand, helping it to ream your [variable O].[or][BigNameDesc of M] nibbles on your ear as the tentacle pounds your [variable O], distracting you with the practised ministrations of [his of M] tongue.[or][BigNameDesc of M] tweaks your nipples and nips at your ear as the tentacle fucks your [variable O], somehow turning the experience into something bordering on pleasurable.[or][line break][speech style of M]'That's right... Let [him of a random tentacle monster] use you.'[roman type][line break][NameDesc of M] whispers, gently groping your [BreastDesc] and teasing your nipples as the tentacle reams your [variable O].[at random]";
	otherwise if N is 1:
		say sexSubmitFondleFlav of M in O;
	otherwise if N is 2:
		say sexSubmitPushFlav of M in O;
	otherwise if N is 3:
		say sexSubmitBiteFlav of M in O;
	otherwise if N is 4:
		say sexSubmitSqueezeFlav of M in O;
	otherwise if N is 5:
		say sexSubmitReflectFlav of M in O;
	otherwise if N is 6 or O is vagina:
		say sexSubmitEmbarrassFlav of M in O;
	otherwise:
		say sexSubmitSplitFlav of M in O.

To say sexSubmitNearingClimax of (M - a demoness) in (F - a fuckhole):
	if futanari fetish > 0 or lady fetish is 2:
		say "[one of][BigFuckerDesc of M] tightens [his of M] grip on your hips, [his of M] nails digging into your skin as [he of M] speeds up.[or][BigFuckerDesc of M] growls hungrily, tightening [his of M] grip as begins to thrust faster and faster.[or][BigFuckerDesc of M] seems to be speeding up![at random] [one of][big he of M] must be close[or][big he of M] must be close to climax[or][big he of M] must be ready to cum[at random]!";
	otherwise:
		say "[one of]The tentacle seems to be speeding up![or][BigNameDesc of M] chuckles, tightening [his of M] grip as the tentacle speeds up.[or][BigNameDesc of M] tightens [his of M] grip on your waist, chuckling as the tentacle speeds up.[or][BigNameDesc of M] chuckles, pumping the muscular tentacle with one hand as it speeds up.[at random] [one of]It must be close[or]It must be close to climax[or]It must be ready to cum[at random]!".

To compute sexBegging of (M - a demoness) in (F - a fuckhole):
	if the sex-length of M > 1, decrease the sex-length of M by 1;
	compute sexResist of M in F.

To decide if (M - a demoness) is willing to creampie (F - vagina):
	if there is a worn xavier's cunt tattoo, decide no;[she respects her master]
	if the reaction of the player is 0:
		let E be the excitement of M;
		if a random number between -1 and the excitement of M < 1, decide no;[if you struggle, you can rarely avoid a creampie.]
	if the pregnancy of the player > 0 and (the pregnancy of the player is 3 or the father is a demonic thing or the father is an infernal monster), decide no;[She won't end your pregnancy if it's one of her own]
	decide yes.

To compute unprotected climax of (M - a demoness) in (F - fuckhole):
	if M is willing to creampie F or (M is soul-seeking and the player is not soulless):
		cutshow figure of demoness cutscene 12 for M;[we don't override the creampie image function so we don't have to rewrite the default creampie of M code]
		if M is soul-seeking and the player is not soulless:
			compute soul creampie of M in F;
		otherwise if the pregnancy of the player is 1:
			compute pregnancy creampie of M in F;
		otherwise:
			compute creampie of M in F;
		if M is soul-seeking, now M is not soul-seeking;
	otherwise:
		compute M pulling out of F.

To compute soul creampie of (M - a demoness) in (F - vagina):
	if futanari fetish > 0 or lady fetish is 2:
		say "[BigNameDesc of M] speeds up, attacking your clit with two ominously glowing fingertips. Impossibly strong waves of pleasure overwhelm your senses, and a climax hits you like a wall of bricks as [semen] floods your [vagina] for the first time in your life.";
		vaginally orgasm shamefully;[This is repeated below, but the flavour output looks better this way.]
		compute M finishing in vagina;
		say "[line break][speech style of M]'Could you feel that, baby? I just fucked that juicy soul straight out of your body, and you just let it happen! HAHAHA! I HOPE IT WAS WORTH IT!'[roman type][line break][big he of M] pulls out, [his of M] [DickDesc of M] softening as [he of M] holds up a bright blue gemstone. The waves of pleasure slowly begin to fade, and [if the virgin bonus of the player < 0]a feeling of unimaginable shame[otherwise]a strong feeling of emptiness[end if] settles heavily in your chest.";
	otherwise:
		say "The tentacle slams itself in as far as it can go, huge bulges passing along its length as [NameDesc of M] attacks your clit with two ominously glowing fingertips. Impossibly strong waves of pleasure overwhelm your senses, and a climax hits you like a wall of bricks as [semen] floods your [vagina] for the first time in your life.";
		vaginally orgasm shamefully;
		compute M finishing in vagina;
		say "[line break][speech style of M]'Could you feel that, baby? [big he of a random tentacle monster] just fucked that juicy soul straight out of your body, and you just let it happen! HAHAHA! I HOPE IT WAS WORTH IT!'[roman type][line break][big he of M] holds up a bright blue gemstone, rolling it between [his of M] fingers as the tentacle slowly pulls out. The waves of pleasure slowly begin to fade, and [if the virgin bonus of the player < 0]a feeling of unimaginable shame[otherwise]a strong feeling of emptiness[end if] settles heavily in your chest.";
	compute M taking soul;
	IntUp 3;
	DexUp 3;
	StrengthUp 3.

To compute pregnancy creampie of (M - a demoness) in (F - vagina):
	if lady fetish is 2 or futanari fetish > 0:
		say "[BigNameDesc of M] [one of]roars with pleasure,[or]emits a drawn out moan[or]moans throatily[at random], tightening [his of M] grip as a wave of warmth enters your pussy and quickly spreads outward into your [ShortDesc of Belly]. You hear an ominous rumble, and with a snap of [his of M] fingers, your belly instantly shrinks down to normal. [big he of M] smirks, wiping the leftover cum off [his of M] [manly-penis] and licking it off [his of M] fingers as [he of M] pulls out.[line break][speech style of M]And now, I'll just take my payment![roman type][line break]";
	otherwise:
		say "[BigNameDesc of M] grabs the tentacle as it tenses, pushing it in as deep as it can go as [one of]spurt after spurt[or]gush after gush[or]a huge amount of[at random] warmth shoots into your [vagina] and quickly spreads outward into your [ShortDesc of Belly]. You hear an ominous rumble, and with a snap of [his of M] fingers, your belly instantly shrinks down to normal. [big he of M] licks [his of M] lips, eyes glinting red as the softening tentacle slips out of you.[line break][speech style of M]'Now then. I think I'll take my payment.'[roman type][line break]";
	let R be a random number between 2 and 4;
	SexAddictUp R;
	if R < 4, SlowSemenAddictUp R - 4;
	say "[big he of M] loses interest.";
	now the father is the throne;
	now the pregnancy of the player is 0;
	WombEmpty the womb volume of vagina.

To compute post climax effect of (M - a demoness) in (F - vagina):
	now the excitement of M is 0.

To say CreampieFlav of (M - a demoness) in (F - vagina):
	if lady fetish is 2 or futanari fetish > 0:
		say "[one of][BigNameDesc of M] grunts, [his of M] [manly-penis] throbbing as [he of M] unloads [his of M] lust directly into your [vagina]. [big he of M] sighs in satisfaction, raking a hand across your [AssDesc] as [he of M] pulls out.[or][BigNameDesc of M] tightens [his of M] grip, nails digging into your tender skin as [he of M] grunts in pleasure. [if the semen addiction of the player < 7]You shudder and look over your shoulder[otherwise if the semen addiction of the player < 15]You gasp and look over your shoulder[otherwise]You look over your shoulder and grin[end if] as piping hot [semen] flows into your [variable F]. [big he of M] leers back at you, pulling out with an exaggerated sigh of contentment.[or][BigNameDesc of M] coos and tightens [his of M] grip. You [if the semen addiction of the player < 7]whimper[otherwise if the semen addiction of the player < 11]sigh quietly[otherwise]moan happily[end if] as [his of M] [manly-penis] pumps wave after wave of hot, hot [semen] directly into your [variable F]. [big he of M] roughly squeezes your [AssDesc] as [he of M] pulls out.[at random]";
	otherwise:
		say "[one of][BigNameDesc of M] grabs the tentacle, pushing it in as deep as it can go as a huge amount of demonic [semen] flows into your [vagina].[or][BigNameDesc of M] aggressively kisses you on the lips as the tentacles forces itself in as deep as it can go, throbbing powerfully as it fills your [vagina] with demonic [semen].[or][BigNameDesc of M] fondles your [ShortDesc of breasts] as the tentacle slams itself in as deep as it can go, throbbing powerfully as it fills your [vagina] with wave after wave of demonic [semen].[at random]";
	if M is not friendly-fucking:
		if pregnancy fetish is 1 and the pregnancy of the player is 0:
			say "[line break][speech style of M]'That was high-quality cum [if lady fetish is 2 or futanari fetish > 0]I[otherwise]our friend[end if] just pumped into you. If you don't clean it out soon, you might regret it~'[roman type][line break][BigNameDesc of M] smirks as [he of M] gives your belly a gentle pat.";
		otherwise:
			say "[line break][speech style of M]'[if lady fetish is 2 or futanari fetish > 0]Ahhh, I feel so much better[otherwise]Mmm, thanks for helping us out. My friend was horny[end if].'[roman type][line break][BigNameDesc of M] grins cruelly as [he of M] returns to [his of M] feet.".

To compute (M - a demoness) pulling out of (F - vagina):
	if the pregnancy of the player > 0 and (the pregnancy of the player is 3 or the father is a demonic thing or the father is an infernal monster):
		say "[speech style of M]'Whoops, almost came inside you! Can't do that with the high quality bun in your oven!'[roman type][line break]";
		if asshole is not actually occupied and the number of worn top level ass protection clothing is 0, compute M messily pulling out of F;
		otherwise compute M cleanly pulling out of F;
	otherwise:
		get clean pull out image of M in F;
		say "You struggling pays off and [NameDesc of M][']s [DickDesc of M] pops out of your [vagina] at just the right moment, causing [his of M] [semen] to shoot out all over the ground.";
		SemenPuddleUp the semen load of M;
		consider angry punishment of M.

To say MessyPullOutFlav of (M - a demoness) in (F - vagina):
	say "[BigNameDesc of M] pulls out and immediately jams [his of M] [manly-penis] in your [asshole], flooding it with [semen] in only a few short pumps. [if the excitement of M > 3]It's thick, hot and in seemingly endless supply, thoroughly coating the inside of your belly as [he of M] pulls out with a hearty sigh[otherwise]It's thick and very hot, coating the inside of your belly in a warmth that lasts long after [he of M] pulls out[end if].".

To compute (M - a demoness) messily pulling out of (F - vagina):
	get messy pull out image of M in F;
	say MessyPullOutFlav of M in F;
	now M is not penetrating vagina;
	now M is penetrating asshole;
	compute M finishing in asshole.

To say PullOutFlav of (M - a demoness) in (F - vagina):
	say "[BigNameDesc of M] pulls out, emitting an exaggerated sigh of contentment as [he of M] finishes [himself of M] off in just a few short pumps...".

Section 2 - Damage

To decide which number is the damage modifier of (M - a demoness):
	[50% chance of +2 damage with priestess vs demoness]
	if the class of the player is priestess and M is demoness and a random number between 1 and 2 is 1:
		now critical is 1;
		decide on 2;

To compute damage reaction of (M - a demoness):
	if M is uninterested or M is friendly:
		say CombatProvokedReaction of M;
		now the sleep of M is 0;
	otherwise:
		say DamageReaction (the health of M) of M;
	if M is power-peaked, increase the excitement of M by 1;
	increase the excitement of M by 1.

To say CombatProvokedReaction of (M - a demoness):
	say "[big he of M] hisses and [his of M] eyes turn red!".

To say DamageReactHealthy of (M - a demoness):
	say "[big he of M] hisses, easily taking the hit!".

To say DamageReactDamaged of (M - a demoness):
	say "[big he of M] takes the hit with an ear-splitting shriek!".

To say DamageReactTired of (M - a demoness):
	say "[big he of M] wails at you with a piercingly high voice!".

To say DamageReactWeak of (M - a demoness):
	say "[big his of M] wailing seems to be weaker than before!".

To say DamageReactSubmissive of (M - a demoness):
	say "[big he of M] grunts, staring at your crotch with a calculating expression on [his of M] face.".

[If the player has magical power, there is a chance the demoness will stay around]
Definition: a demoness is automatically banishable:
	if the magic power of the player >= 2 and the divinationskill of the player is 1, decide no;
	decide yes.
Definition: a demoness is auto-banish-loot-dropping:
	if it is automatically banishable, decide no;
	decide yes.

Definition: a demoness is taxable:
	decide no.

[If the player has magic power, they can make the demoness stick around]
To say DefeatBrink of (M - a demoness):
	say "Thanks to what you learned from [NameDesc of witch], you can sense [NameDesc of M]'s essence beginning to disperse. If you use up some of your magic, you might be able to prevent [him of M] from being banished...";

To say BanishDesc of (M - a demoness):
	say "Just let [him of M] go.".
To compute forced banishment of (M - a demoness):
	compute automatic banishment of M.

To say BanishFleeFlav of (M - a demoness):
	say "[BigNameDesc of M] screams as [he of M] falls to the floor, and then you watch as [his of M] essence is sucked back into [his of M] home dimension.";

To compute banish drop of (C - dildo-heels) from (M - a demoness):
	if C is off-stage:
		now C is in the location of the player;
		now the raw-magic-modifier of C is a random number between 0 and 2;
		now C is kicking;
		now the heel-height of C is 4;
		say "[big his of M] dildo heels remain behind.";
		increase the loot dropped of M by 1;
		compute autotaking C.

To uniquely destroy (M - a demoness):
	repeat with S running through stuck clothing:
		now S is not stuck;
	now the channelling of M is 0.

To compute unique dislodging of (M - a demoness):
	repeat with C running through stuck shoes:
		now C is not stuck.

To say PityDesc of (M - a demoness):
	say "Replenish [his of M] power with kindness!".

To say PityOfferFlav of (M - a demoness):
	say "You place your hand on [NameDesc of M]'s Forehead and force some of your magical power into [him of M].";
	if the player is able to speak, say "[variable custom style]'[one of]Well fought, but I am the victor.'[or]I trust you will treat me with more respect from now on?'[or]If you promise not to do that again, we can still be friends...'[in random order][roman type][line break]";
	increase the magic-fatigue of the player by 2.

To say PityOfferResponse of (M - a demoness):
	if M is friendly, say "[speech style of M]'[one of]You've proven your point. Let's not do this again.'[or]Haha, you got me. How humiliating.'[or][if the appearance of the player >= the outrage tolerance of M]Maybe if you stop dressing like a whore[otherwise]Fair is fair[end if].'[in random order][roman type][line break]";
	otherwise say "[speech style of M]'[one of]I'm going to punish you twice as hard for this indignity.'[or]What a waste of your final victory over me.'[or]Listen closely. I don't take handouts from mortals.'[in random order][roman type][line break]".

To say PenisFuckDesc of (M - a demoness):
	say "Replenish [his of M] power with your [PenisFucker].".

To say VaginaRideDesc of (M - a demoness):
	say "Replenish [his of M] power with your [vagina].".

To say AssRideDesc of (M - a demoness):
	say "Replenish [his of M] power with your [asshole].".

To say PissFuckDesc of (M - a demoness):
	say "Replenish [his of M] power with your [urine]".

Part 5 - DQ

demoness-plug is a diaper punishment. The priority of demoness-plug is 5.
Definition: demoness-plug is appropriate:
	if current-monster is not demoness, decide no;
	if there is a worn unmessed diaper and there is an off-stage prostate massager plug and asshole is not actually occupied, decide yes;
	decide no.

To compute punishment of (P - demoness-plug):
	compute prostate plugging of current-monster.

demoness-facesit is a diaper punishment. The priority of demoness-facesit is 5.
Definition: demoness-facesit is appropriate:
	if current-monster is not demoness, decide no;
	if there is soiled-diaper carried by current-monster, decide no; [She should punish that instead.]
	if the player is pee protected or there is worn knickers, decide no;
	if the player is bursting or (the player is feeling full and the player is desperate to pee), decide yes;
	decide no.

To compute punishment of (P - demoness-facesit):
	let M be current-monster;
	say "[speech style of M]'[if there is soiled-diaper in the location of the player][one of]Let me get you properly acquainted with the smell you seem so keen to leave lingering around the place[or]Clearly you still need to be taught how badly a diaper can stink[stopping][otherwise][one of]Let me show you how to wear and use a diaper[or]Clearly you still need diaper use lessons, little one[stopping][end if].'[roman type][line break][BigNameDesc of M] places both hands around [his of M] gem and you watch with [horror diaper addiction of the player] as a giant pink disposable diaper with a white star pattern begins to materialise around [him of M]. With a flick of [his of M] wrist, your body flips 180 degrees so that you are lying on your back. [big he of M] stands over your head and them begins to lower [his of M] diapered rear towards your face. You only just have time to hold your breath before the padding envelops you, and you are robbed of your sight and forced to focus on your sense of hearing.[line break][speech style of M]'Come on now, I'm not going to let you up until you breathe in deep.'[roman type][line break]You are forced to relent and begin to breathe laboured, shallow breaths, getting what oxygen you can through the thick material.[line break][speech style of M]'Now, watch closely.'[roman type][line break][BigNameDesc of M] holds you by the [BellyDesc] as [he of M] [if diaper messing < 7]sighs and begins to tinkle[otherwise]grunts and pushes and begins to vacate [his of M] bowels[end if]. Within moments the smell assaults your nostrils, dominating your sensory receptors and overwhelming you. [if diaper messing >= 7]And yet it keeps coming, as [he of M] unloads an ungodly amount of mess into [his of M] padding, pushed right into your face. The gross sounds that accompany the tirade keep you acutely aware of all the noxious gas [he of M] is crop-dusting over your body. [end if]As [he of M] does this [he of M] pushes down on your belly, and you feel a weird tingle flow from [his of M] hands to your bladder. And then in the next moment, you are [one of][if the diaper addiction of the player > 7]surprised[otherwise]dismayed[end if] to find that you are wetting yourself[or]once again forced to wet yourself[stopping].";
	if diaper messing >= 7, cutshow figure of demoness cutscene 15 for M;
	now delayed urination is 1;
	now M is penetrating face; [stops the player from speaking]
	try urinating;
	say "Only after [NameDesc of M] has seen your wetting shame does [he of M] stand up, freeing your face. [speech style of M]'As [one of]I thought[or]we already knew[stopping], it's you who needs this diaper, not me.'[roman type][line break]";
	if diaper swapping >= 3 or (diaper swapping > 0 and diaper messing < 7):
		let D be a random massive diaper;
		only destroy D;
		if the number of worn knickers is 0 or (the player is diapered and D is DQBulkier):
			say "[big he of M] puts [his of M] hands together and concentrates. [big his of M] giant soiled diaper disappears from [his of M] crotch, and appears around yours!";
			if the player is diapered, DiaperAdd D;
			otherwise summon D cursed with quest;
			UrineSoakUp D by 10;
			if diaper messing >= 7:
				MessSet D to 20;
				now the foreign-mess of D is 20;
	satisfy M.

To compute diaper pail substitute punishment of (M - a demoness):
	compute soiled diaper dropping of M;
	compute punishment of demoness-facesit.

Definition: a demoness is willing to change diapers: decide yes.

To say DiaperChangeStart of (M - demoness):
	say "[BigNameDesc of M] forces you onto your back.[line break][speech style of M]'[if the number of worn diapers is 0 and there is worn knickers]Your attire offends me. It's time for a change...[otherwise if the number of worn diapers is 0]Let's get you into something more... fitting, shall we?'[otherwise if penis is not exposed and vagina is not exposed]Your humiliation begins with your stripping!'[otherwise]Your humiliation begins now!'[end if][roman type][line break]".

To say DiaperChangeFlav of (M - demoness):
	say "With a snap of [NameDesc of M][']s fingers, [if old-diaper is new-diaper]an identical (but clean) [ShortDesc of new-diaper][otherwise]a [ShortDesc of new-diaper][end if] appears around your loins.[line break][speech style of M]'[one of]Does it burn you, little one? Being diapered with no way to stop it?'[or]Yes, yes it fits oh so nicely... right where it belongs!'[or]Hear it crinkle child? Get used to that noise following you!'[in random order][roman type][line break]".

Definition: demoness is willing to double diapers: decide yes.

Definition: a demoness is diaper disciplining: decide yes.

To say DiaperChangeComment of (M - demoness):
	if the diaper-duration of M <= 0, say "[speech style of M]'And that will stay on unless you want punishment beyond words!'[roman type][line break]";
	otherwise say "[speech style of M]'[one of]That was far too easy - you're nothing but a baby[or]And another [man of the player] falls to the crinkly grip of a diaper~[or]Mmm yes, how adorable. I picked the right diaper for sure[in random order].'[roman type][line break]".

To say DiaperDonateComment of (M - demoness):
	say "[speech style of M]'And you'll wear diapers until I give you permission to wear grown-up panties again, or there'll be hell to pay! Literally! Hahaha...'[roman type][line break]".

Definition: a demoness is willing to masturbate:
	if there is a sex toy penetrating asshole or the player is possessing a penis or the player is very horny, decide yes;
	decide no.

Definition: a demoness is willing to punish untidiness: decide yes.

Definition: a demoness (called M) is able to carry out masturbation:
	repeat with N running through monsters grabbing the player:
		if N is not M, decide no;
	if refractoryperiod > 0, decide no;
	decide yes.

To say MasturbationDeclarationFlav of (M - a demoness):
	let S be a random sex toy penetrating asshole;
	if S is a thing:
		say "[speech style of M]'Let's take that [ShortDesc of S] for a spin, shall we?'[roman type][line break]";
	otherwise:
		say "";

To say MasturbationStartFlav of (M - a demoness):
	let S be a random sex toy penetrating asshole;
	if S is a thing:
		say "[BigNameDesc of M] focuses [his of M] mystical energy on your [S]. It begins vibrating!";
	otherwise:
		say "The mighty demoness snaps [his of M] fingers. Flames burst around you and snake around your limbs with astonishing speed. The flames dissipate to reveal black chains which bind you to the floor tightly, any muscle movement challenged by the iron locks. [BigNameDesc of M] cackles at your vain struggles and saunters over to you slowly, letting you take in [his of M] approach before [he of M] reaches out, groping your padding and squeezing in. After [he of M] gauges the thickness [his of M] digits massage rhythmically to feel through to your [genitals], with no sign of [him of M] stopping!".

To say MasturbationFlav of (M - a demoness):
	let S be a random sex toy penetrating asshole;
	if S is a thing:
		say "The vibrations in your [asshole] send erotic sensations through your body!";
	otherwise:
		say "[BigNameDesc of M] continues to masturbate you through your diaper. [one of]Somehow it's like you can feel [his of M] fingers as if you're touching skin-on-skin![or]It feels incredibly delicate and intimate.[or][he of M] is a master of [his of M] trade, bringing you heights of ecstasy with impressive speed![or][big his of M] powerful grip lets [him of M] squeeze you tightly through the thick padding.[in random order]".

To say MasturbationAfterFlav of (M - a demoness):
	let S be a random sex toy penetrating asshole;
	if S is a thing:
		say "[BigNameDesc of M] seems satisfied, and removes [his of M] mystical grip from your [ShortDesc of S].[if the player is a bit horny][MasturbationTeaseFlav of M][end if]";
	otherwise:
		say "[BigNameDesc of M] seems satisfied, and removes [his of M] strong grip from your groin.[if the player is a bit horny][MasturbationTeaseFlav of M][end if]".

To say DQMasturbationResistReactionFlav of (M - a demoness):
	say "[BigNameDesc of M] cackles.[line break][speech style of M]'[one of]Your defiance is sickening and arousing all at once. How do you do it, slave?'[or]I shall have your [if the player is possessing a penis]seed[otherwise]juices[end if] one way or another mortal, you will not be free until I get it!'[or]Does it shame you mortal? How I can pleasure you through such thick layers? Is this is why you resist me?'[or]Undermining me will only get you thicker diapers, AND thicker chains!'[in random order][roman type][line break]".

Definition: a demoness (called M) is eager to confiscate:
	if M is able to confiscate, decide yes;
	decide no.

Definition: a demoness is willing to confiscate: decide yes.

To say ConfiscationAfterFlav of (M - a demoness) on (C - a clothing):
	say "[speech style of M]'[one of]You should be thankful that I don't punish you further.'[or]Mortal babies don't get to double-guess the decisions of immortal adults.'[or]Silence, mortal! You have no rights compared to a being such as myself.'[in random order][roman type][line break]".

Definition: a demoness is willing to forcefeed: decide yes.

To compute forcefeed round (N - a number) of (M - a demoness):
	say "[one of]You gasp in surprise as [NameDesc of M][or][BigNameDesc of M][stopping] summons ";
	if diaper messing >= 3 and a random number between 1 and diaper lover > 1 and (the player is not thirsty or the stomach-food of the player < the stomach-liquid of the player):
		say "[one of]a block of chocolate[or]a large cube of watermelon[or]half a banana[or]a slice of pear[or]a digestive biscuit[in random order] out of thin air and makes it fly into your mouth. You are forced to chew and swallow it all down.";
		StomachFoodUp 1;
	otherwise:
		say "a floating, swirling ball of [if breast-milk-this-time is 1]warm breast milk[otherwise][one of]some kind of fruit juice[or]warm milk[or]warm black tea[in random order][end if] out of thin air and makes it shoot into your mouth. You are forced to swallow it all down.";
		if breast-milk-this-time is 1, StomachMilkUp 2;
		otherwise StomachUp 2.

To say DQFeedingResistReactionFlav of (M - a demoness):
	say "[speech style of M]'[one of]Yes, yes struggle for me baby, all in vain as I make your throat as wet as I'm getting!'[or]As if I needed a reason to pull that hair of yours~'[or]Oh, because this worked SO well before~'[or]Mmmmm, have some fight still? Precious, simply adorable...'[or]Maybe this squirming is energy better spent on something useful, like soiling that diaper of yours... or perhaps putting on a masturbatory show for your better~'[then at random][roman type][line break]".

Part 6 - Conversation

To say IdentifiablePosterReactionFlav of (M - a demoness):
	say "[BigNameDesc of M] looks at you, blinks, then looks back to the poster. Upon realising that it is you, [he of M] points at you and starts laughing uncontrollably.".

To say UnidentifiablePosterReactionFlav of (M - a demoness) with (P - a poster):
	say "[speech style of M]'Now that is one [tasty] piece of ass.'[roman type][line break]".

To say RewardFlav of (M - a demoness) for (T - a thing):
	say "[speech style of M]'[one of]Don't say I never do anything for you[or]A gift, from the demon plane[cycling].'[roman type][line break][BigNameDesc of M] summons a [T] on the ground in front of you.".

To say MonsterOfferAcceptFlav of (M - a demoness) to (T - a thing):
	if M is unfriendly:
		say "[BigNameDesc of M] smirks.[line break][speech style of M]'You hope to appease me with this? [if the bartering value of T for M + the favour of M > the aggro limit of M + 4]Fufufu, well, this time, you have read the room well[otherwise if the bartering value of T for M + the favour of M > the aggro limit of M]Perhaps for a while, it shall suffice[otherwise]You hope to buy yourself a few minutes['] grace with this? Go on then, run. Let's see how far you get[end if].'[roman type][line break]";
	otherwise:
		say "[BigNameDesc of M] nods approvingly.[line break][speech style of M]'I accept your tribute.'[roman type][line break]".

To say OfferFriendshipFlav of (M - a demoness):
	say "[speech style of M][if M is guardian]'Come now, pet, let us take a stroll together[otherwise if M is buddy]'I find my fondness for you is growing. Interesting[otherwise]'I suppose you're not the worst mortal I've ever [one of]met[or]encountered[or]known[stopping][end if].'[roman type][line break]".

Section 1 - Greeting

To say FirstResponse of (M - a demoness):
	say "[speech style of M]'Hey. Like my heels?'[roman type][line break]";
	cutshow figure of dildo-heels for M.

To say RepeatResponse of (M - a demoness):
	if M is unfriendly:
		if the player is a sissy:
			say "[speech style of M]'[one of]Come here looking for a dick to suck? How about I ruin your sissy ass instead?'[or]I can tell just by looking at you that you're going to love having your asshole ruined.'[or]Did you come all the way here for me to punish you, sissy?[or]I love crushing weaklings like you. Are you ready?'[at random][roman type][line break]";
		otherwise if the class of the player is priestess:
			say "[speech style of M]'[one of][if M is uninterested]YOU![otherwise]You will BURN![end if]'[or]You will suffer for your god, priestess.'[or]When I am finished torturing you... send the goddess my regards.'[or]Pray all you like, priestess, it will not help you now!'[or]So, the goddess sends another priestess for me to ruin. I'd be annoyed if it weren't so much fun.'[or]Say your prayers, priestess!'[or]So, you came here seeking to challenge me, but you did not bring a cross. You will pay dearly for that mistake.'[at random][roman type][line break]";
		otherwise:
			say "[speech style of M]'[one of]All mortals are beneath me, but especially vermin like you.'[or]If you are not intimidated by me already, I'll fix that.'[or]Addressing me directly... you'll suffer for that.'[or]I will cook your soul at a slow burn, mortal.'[or]The power of speech is wasted on creatures like you.'[at random][roman type][line break]";
	otherwise:
		say "[speech style of M]'[one of]Hi. Know any weaklings I can crush? I'm getting a bit bored.'[or]Hey. Do me a favour and don't give that witch anything.'[or]Hey there. Tell Xavier I said 'Hi'. You'll know [him of demon lord] when you see [him of demon lord].'[at random][roman type][line break]".

To say SubmissiveResponse of (M - a demoness):
	if M is unfriendly, say "[speech style of M]'[one of]Hmm, strange decision to show your face here again.'[or]Ready to get tortured again, are we?'[or]Hahaha... your eagerness for punishment [please]s me!'[or]I won't make you bleed... but you'll wish I did.'[at random][roman type][line break]";
	otherwise say "[speech style of M]'[one of]Hmm, strange decision to bring that up. Are you trying to tempt me to give you another round?'[or]Unless you want to get tortured again, I'd suggest talking about something else, child.'[at random][roman type][line break]".

To say NonEnthusiasmResponse of (M - a demoness):
	if a random number between 1 and 2 is 1, increase the excitement of M by 1;
	say "[speech style of M]'[one of]Didn't you know? Whining makes me horny.'[or]Your suffering is music to my ears...'[or]Beg for mercy and there's a chance I'll spare you.'[or]I'm going to ruin you!'[or]I'm not stopping until you're in tears!'[or]It's alright. I'm only trying to hurt you.'[or]You'll learn to like this pain... or you won't. Either way, I'm enjoying myself.'[or]Your suffering is *delicious*.'[or]Suffer, worm! I want TEARS...'[at random][roman type][line break]".

To say UnAnnoyedResponse of (M - a demoness):
	say "[speech style of M]'[one of]Shut up, you're annoying me.'[or]Ugh, I know you're slutty, now shut up.'[or]Silence![or]Shut up, I'm enjoying myself.'[at random][roman type][line break]".

To say AnnoyedResponse of (M - a demoness):
	say "[speech style of M]'[one of]Shut up already!'[or]Shut up, you're being so annoying!'[or]Are you ever going to shut up?!'[at random][roman type][line break]".

To say InvitationAccepted of (M - a demoness) with (N - a monster):
	say "[speech style of M]'Hm, I SUPPOSE I could go for some torture.'[roman type][line break]".

To say InvitationRejected of (M - a demoness) with (N - a monster):
	say "[speech style of M]'[one of]I'd love to torture you, but I'll leave you for now.'[or]I'll torture you another time. Don't worry.'[at random][roman type][line break]".

To say PleadingRejected of (M - a demoness) with (N - a monster):
	if M is unfriendly:
		if N is not penetrating asshole:
			say "[speech style of M]'[one of]Why help you when I could torture you?'[or]I can help you out of this bind. But instead I'm going to punish you. Haha!'[or]You look like you could use a good ruining.'[at random][roman type][line break]";
		otherwise if watersports fetish is 1:
			say "[speech style of M]'[one of]If it's help you want, I'm just going to punish you.'[or]I'm going to ruin you later, but I guess I can settle.'[or]I'm happy to contribute. Don't worry, this is just an appetiser for the ruining I'll give you later.[at random][roman type][line break]";
	otherwise:
		say "[speech style of M]'[one of]Haha. No.'[or]Haha. How ridiculous.'[at random][roman type][line break]".

To say AttentionExceeded of (M - a demoness) with (N - a monster):
	say "[speech style of M]'Attention whores are nothing but trouble. Why don't I show you.'[roman type][line break]".

To say AttentionAccepted of (M - a demoness) with (N - a monster):
	say "[speech style of M]'[one of]Interesting. Maybe I should torture you later...'[or]Quite the show. I'm planning a better one for you later.'[at random][roman type][line break]".

To compute taunt acceptance effect of (M - a demoness):
	increase the excitement of M by 1;
	increase the raw difficulty of M by 6;
	regionally place M.

To say TauntAccepted of (M - a demoness):
	say "[speech style of M]'You'll regret saying that. Very, very soon...'[roman type][line break][BigNameDesc of M] disappears in a burst of flame.".

To compute taunt rejection effect of (M - a demoness):
	increase the excitement of M by 3.

To say TauntRejected of (M - a demoness):
	say "[speech style of M]'Oh? Are you *sure* that's what you wanted to say?'[roman type][line break][BigNameDesc of M] seems positively delighted!".

To say PleadRejected of (M - a demoness):
	say "[speech style of M]'The time for apologies is OVER!'[roman type][line break]".

To say VanityAccepted of (M - a demoness):
	say "[speech style of M]'Hmmph. Fine.'[roman type][line break]".

To say VanityAnnoyed of (M - a demoness):
	say "[speech style of M]'Fine, if you stop bothering me.'[roman type][line break]".

Section 2 - Questioning

To compute teaching of (M - a demoness):
	say "[speech style of M]'Why not try strutting around in those heels like a proper whore? You might think that sluts just wave their ass around with fully stretched legs to attract the guys, but actually it's just the easiest way to walk. Sure you might look like a bimbo, but you'll find that your body is more free to move around.'[roman type][line break]";
	cutshow figure of demoness cutscene 14 for M;
	teach strutting.

To say WhereAnswer of (M - a demoness):
	say "[speech style of M]'The mortal realm. Is that not obvious?'[roman type][line break]".

To say WhoAnswer of (M - a demoness):
	say "[speech style of M]'A servant of malice and lust from the eternal realm[if the player-class is succubus], just like you are now[end if]!'[roman type][line break]";
	alwayscutshow figure of demoness interact 10 for M.

To say StoryAnswer of (M - a demoness):
	say "[speech style of M]'I have come to show unbearable pleasure and pain to all mortals!'[roman type][line break]".

To say EscapeAnswer of (M - a demoness):
	say "[speech style of M]'For me, if I lose too much energy I will be banished back to my home dimension[if the player-class is succubus]. It works a bit differently for you though.'[roman type][line break][big he of M] points to the stone in your chest.[line break][speech style of M]'The demon soul within that stone will devour your identity slowly if it thinks you are acting unbecoming one of us. If you make it mad enough, it'll completely erase whatever was left of you[end if]!'[roman type][line break]".

To say AdviceAnswer of (M - a demoness):
	say "[speech style of M][if the class of the player is worshipper]'Stay on your knees, and when one of your masters is ready to use you, make it fun by resisting as much as you can. I plan to test you on that in a little while, so don't forget.'[otherwise if the class of the player is not succubus]'Anything in your location when you are banished back to your home realm, will remain there and not disappear. Except creatures of course.'[otherwise]'It's very simple, just strut around devouring the souls of the weak, giving your service only to the mighty demon lord.'[end if][roman type][line break]".

Section 3 - Drink Requesting

To compute unfriendly drink of (M - a demoness):
	if M is unfriendly:
		say "[speech style of M]'Silence! Do you not understand what is happening here?!'[roman type][line break]";
		now the boredom of M is 0;
	otherwise:
		say "[speech style of M]'Do not attempt to talk to me, mortal.'[roman type][line break]".

To compute friendly drink of (M - a demoness):
	let H be a random worn heels;
	if (the class of the player is succubus or the class of the player is worshipper or H is clothing and the heel-height of H > 3) and M is dealing:[only a dummy would ask anything from a demoness!]
		say "[one of][BigNameDesc of M] seems surprised for a second and smirks.[line break][speech style of M]'I can do more than quench your thirst, you know. Get on your knees and open wide. I'll do the rest.'[roman type][line break][or][line break][speech style of M]'You're dumber than you look. Accept my deal and you get something to drink.'[roman type][line break][stopping]";
	otherwise if M is dealing:
		say "[speech style of M]'[one of]I don't give handouts. But I promise a drink and more if you lend me your mouth for a while.'[or]I told you about the deal already, don't waste my time if you aren't interested.'[stopping][roman type][line break]";
	otherwise if watersports fetish is 1:
		say "[speech style of M]'You don't really have anything I want, but I suppose it would be fun to watch you drink my urine. [if the player is upright]Kneel.[otherwise]Open wide.[end if]'[roman type][line break]";
		if the humiliation of the player > 17500 or the thirst of the player is 5:
			say "[if the player is upright]You instantly get on your knees. [end if]You [if the humiliation of the player > 17500]are happy to submit to the degradation[otherwise]are desperate enough to drink absolutely anything[end if].";
			DrinkPiss from M;
			if the player is upright, try kneeling;
		otherwise:
			say "You aren't [if the thirst of the player < 4]nearly [end if]thirsty enough to drink [his of M] [urine]!";
	otherwise if M is interested:
		say "[speech style of M]'You don't have anything I want.'[roman type][line break]";
	otherwise:
		say "[big he of M] doesn't seem to realise that you're talking to [him of M].".

Section 4 - Dominant Sex

To compute domination interference of (M - a demoness) for (N - a monster):
	if M is dangerous:
		say "[BigNameDesc of M] gets in your way and prevents you from dominating [NameDesc of the noun]!";
		now player-fucking is DOMINANT-FAILURE.

To say DominanceFailure of (M - a demoness):
	say "You grab [NameDesc of M] by the wrists, forcing your magic power into [him of M] as you try to pin [him of M] to the ground. Unfortunately, you only succeed in giving [him of M] a huge burst of strength, which [he of M] uses to completely overpower you.".

To compute failed dominance punishment of (M - a demoness):
	if the player is getting very unlucky and (the class of the player is priestess or the player is not able to speak or the times-dominated of M > the times-submitted of M):[summons imps to gangbang you]
		let N be a random imp;
		let C be the number of undefended orifices;
		say "[speech style of M]'You have a big heart for a mortal. I have to repay you somehow, but hmmmm, I can't think of anything. This won't do.'[roman type][line break][BigNameDesc of M] whistles sharply and at least a dozen tiny red [men of N] stampede [if playerRegion is Woods]out of the under brush[otherwise]through the door[end if] and form a loose circle around you.[line break][speech style of M]'While I think about it, would you mind entertaining my associates for a little while?'[roman type][line break]The imps don't waste any time crowding in around you, [unless there is a worn wrist bond]tying your hands behind your back[otherwise]holding you down[end if] and [if C is 1]moving your clothing out of the way[otherwise]snickering mischievously[end if] as they grope and fondle your body.";
		if lady fetish is 1:
			say "It's [if the player is gendered male]exciting[otherwise]almost comforting[end if] to be surrounded by so many [men of N], but as the first imp presents [his of N] wet, needy pussy, it becomes totally clear that in any hierarchy among them you're the definitive bottom. The taste of the first cunt is quickly replaced by a second, and a third after that. Your [if the delicateness of the player + the oral sex addiction of the player < 5]reluctance certainly[otherwise]eager obedience[end if] doesn't seem to affect anything, mischievous giggling filling your ears as the imps treat you as nothing but a simple plaything. Exploratory fingers enter your holes, followed by dildos, tongues, even vines they've pulled out of the ground!";
		otherwise:
			say "Being surrounded by so many naked [men of N] almost makes you feel special, but as the first imp slides [his of N] [LongDickDesc of N] into your mouth, it becomes totally clear that they see you as nothing more than a cheap cocksleeve. There's little time to breathe or even swallow after the first imp is finished, as another one immediately takes [his of N] place. [if the player is not possessing a vagina]Your [asshole] isn't[otherwise]Your holes aren't[end if] exempt from the treatment, and the imps take turns racing each other to see which end they can fill faster.";
		let X be 5;
		if the player is possessing a vagina, increase the fuck-count of the player by X;
		increase the anal-count of the player by X;
		if lady fetish is 1, increase the lick-count of the player by X;
		otherwise increase the blow-count of the player by X;
		StomachSemenUp X;
		if lady fetish is 1, now N is a random vine;
		now N is penetrating vagina;
		now N is penetrating asshole;
		if the player is possessing a vagina, PussyFill X;
		AssFill X;
		now N is not penetrating vagina;
		now N is not penetrating asshole;
		say "You're not sure how much time has passed by the time the [NameDesc of M] returns to shoo the tiny red bastards away.[line break][speech style of M]'Sorry I had you wait so long, but I couldn't think of anything. I hope you'll forgive me...'[roman type][line break][GotUnluckyFlav]";
		satisfy M;
	otherwise:
		say "[speech style of M]'That was nice of you. I really appreciate it.'[roman type][line break][BigNameDesc of M] kneels down in front of you, wearing a conspiratorial grin.[line break][speech style of M]'How about a nice kiss in return?'[roman type][line break][big he of M] maintains [his of M] vice-like grip on your wrists as [he of M] closes [his of M] eyes and puckers [his of M] lips.[line break][if the player is not able to speak][speech style of M]'Oh, oops. You can't...'[roman type][line break][otherwise]Do you 'bribe' [him of M] with a kiss?[end if]";
		if the player is able to speak and the player is bimbo consenting:
			say "You [if the sex addiction of the player < 4]hesitantly[otherwise]obediently[end if] lean forward and kiss [him of M]. [big his of M] tongue eagerly pushes its way into your mouth, and you feel a pronounced 'dirty' feeling settling over your mind as [he of M] unceremoniously shoves you away and gets to [his of M] feet.";
			SexAddictUp 1;
			satisfy M;
		otherwise:
			if the player is getting unlucky:
				say "[line break][speech style of M]'Well I have to repay you somehow... I know! How does a round of torture sound?'[roman type][line break][GotUnluckyFlav]";
				now another-turn-flavour is the substituted form of "[BigFuckerDesc of M] holds you in place.";
				now another-turn is 1;
			otherwise:
				say "[speech style of M]'Well if that wasn't good enough, I'll just have to repay you with THIS!'[roman type][line break][BigNameDesc of M] slaps you in the face, taking extra care to make sure [his of M] nails rake painfully across your cheeks. You can't help the tears that well up in your eyes as you struggle to handle the pain.";
				PainUp 10;
				Bore M.

To compute unique dominance reward of (M - a demoness):
	let R be a random number between 1 and 2;
	if the player is somehow possessing a penis:
		if R is 1, SpecialPenisUp 1; [#LXorDD]
		otherwise StrengthUp 1;
	otherwise:
		if R is 1, IntUp 1;
		otherwise StrengthUp 1;
	SilentlyDifficultyUp M by the times-dominated of M + 1;[the demoness doesn't have permanent difficulty, so her increases get larger and larger]
	FuckholeAddictDown 1.

To penetration dominate (M - a demoness):
	let C be a random bottom level protection clothing;
	say "You grab [NameDesc of M] by the wrists, forcing your magic power into [him of M] as you pin [him of M] to the ground. [big he of M] doesn't resist, seductively pushing out [his of M] chest as you [if C is not strapon-panties and C is clothing]pull out your[otherwise if penis is penis-erect]stroke your[otherwise]stroke your hardening[end if] [SexShaft].";
	if the sexual-penis-length > 8:
		say "[line break][speech style of M]'Generous mortals like you make me so hot. SCORCHING hot, even. I'll grant you the pleasure of fucking me, but-'[roman type][line break][big he of M] pauses mid-statement to grin maliciously, and you realise it's going to be forever before you get to fuck [him of M] if you keep listening. Oh well, [he of M] already said [he of M] was okay with it. You [if the player is a bit horny]slam[otherwise]slide[end if] your [SexDesc of penis] into [his of M] tight [HoleDesc of M] without waiting for [him of M] to continue, giving [his of M] taut [AssDesc] a good slap as you begin to thrust. [big he of M] shrieks in indignation, flinging curses at you as the heat radiating off [his of M] body grows from pleasant to mildly uncomfortable. You faintly remember something [he of M] said about 'scorching' you, but the harder you pound [him of M], the easier the heat is to deal with. [BigNameDesc of M] scowls at you as you violently jackhammer away, and the warmth from [his of M] furnace-like [HoleDesc of M] sinks through to your core, rapidly intensifying the pleasure until [if the player is not possessing a scrotum]you thoroughly empty yourself[otherwise]your balls thoroughly empty themselves[end if] inside [him of M].";
		obsceneDignify;
		orgasm;
		FavourDown M by 2;
		say AfterDominationComment 2 of M;
	otherwise if the sexual-penis-length > 5:
		say "[line break][speech style of M]'Generous mortals like you make me so hot. SCORCHING hot, even.'[roman type][line break][big he of M] pauses, grinning maliciously as [his of M] tail curls around the base of your [sexual-player-penis].[line break][speech style of M]'I'll grant you the pleasure of fucking me, but it COULD be bad if you don't pull out before you cum.'[roman type][line break] Agree to pull out? ";
		if the player is not very horny and the player is bimbo consenting:
			say "You nod slowly as you slide your [SexDesc of penis] into [his of M] tight [HoleDesc of M] and begin to thrust. The heat of [his of M] body is pleasant, but it grows more intense with every thrust you take, thoroughly permeating your skin as it gradually grinds your stamina away. It's impossible to pace yourself, and far too soon you have no choice but to pull out and finish on the ground between [his of M] legs.";
			slightDignify;
			now player-fucking is DOMINANT-NEUTRAL;
			say AfterDominationComment 0 of M;
		otherwise:
			say "You couldn't care less about [his of M] curse, smacking [his of M] ass as you slam your [SexDesc of penis] into [his of M] tight [HoleDesc of M]. The heat of [his of M] body is pleasant, but it grows more intense with every thrust you take, thoroughly permeating your skin as it gradually grinds your stamina away. You've barely had time to think about pacing yourself as you go over the edge, groaning with pleasure as you pump [NameDesc of M] full of fresh, creamy [semen]. [big he of M] smirks as your crotch is enveloped with ghastly red light, and [bold type]you feel a tiny shift in the back of your head as you become permanently more submissive.[roman type]";
			obsceneDignify;
			SilentlyDelicateUp 1;
			say AfterDominationComment 1 of M;
		orgasm;
	otherwise if the sexual-penis-length > 3:
		say "[line break][speech style of M]'Generous mortals like you make me so hot. SCORCHING hot, even.'[roman type][line break][big he of M] pauses, eyes glinting red as [his of M] tail curls around the base of your [sexual-player-penis].[line break][speech style of M]'I'll grant you the pleasure of fucking me, but it COULD be bad if you don't pull out before you cum.'[roman type][line break] Agree to pull out? ";
		if the player is not horny and the player is bimbo consenting:
			say "You decide it's worth listening to [his of M] warning, nodding at [him of M] as you gingerly slide your [SexDesc of penis] into [his of M] tight [HoleDesc of M]. The heat radiating off [his of M] body warms your skin, intensifying the sensation of every thrust and rapidly grinds your stamina way. You barely have enough time for a few thrusts before you have to stop and finish yourself off on the ground between [his of M] knees.";
			slightDignify;
			now player-fucking is DOMINANT-NEUTRAL;
			orgasm;
			say AfterDominationComment 0 of M;
		otherwise:
			say "You decide to ignore [his of M] warning, squeezing [his of M] ass as you push your [SexDesc of penis] into [his of M] tight [HoleDesc of M]. The heat of [his of M] body permeates your skin, intensifying the sensation of every nerve in your [SexShaft] and steadily grinding your stamina away. Ever more powerful waves of pleasure with every thrust, and within moments you find yourself groaning with pleasure as you flood [NameDesc of M][']s hungry cunt with several spurts of fresh [semen]. You feel a flash of pain as your crotch is enveloped in a red light, and [bold type]you realise you have become permanently more submissive![roman type]";
			severeDignify;
			orgasm;
			PainUp 30;
			say AfterDominationComment 1 of M;
	otherwise:[instant]
		say "[line break][speech style of M]Generous mortals like you make me so hot. Even if your [sexual-player-penis] is so tiny.[roman type][line break][big he of M] pauses, [if lady fetish is 2]stretching [his of M] sphincter with [his of M] thumb[otherwise]spreading [his of M] pussy lips[end if] with a malicious grin.[line break][speech style of M]'I'll be too hot for you to handle. Pull out before you cum.'[roman type][line break] Agree to pull out? ";
		if the player is not a bit horny and the player is bimbo consenting:
			say "You nod, eagerly pushing your [sissy-penis] into [his of M] [HoleDesc of M] and grabbing [his of M] hips as you begin to thrust. Even for a [if the bimbo of the player > 6]girl[otherwise]guy[end if] as tiny as you are, [he of M] is tight, and the strong heat that radiates off [his of M] body warms your skin, intensifying your pleasure and sapping your stamina. You're halfway through your second thrust when you realise you're already gone, immediately pulling out as your [semen] dribbles out in a pitiful puddle between [NameDesc of M][']s feet.";
			now player-fucking is DOMINANT-SHAMEFUL;
			orgasm;
			say AfterDominationComment 0 of M;
		otherwise:
			say "You're way too horny to agree to something like that, eagerly pushing your [sissy-penis] into [his of M] tight [HoleDesc of M]. [big he of M] was being literal when [he of M] mentioned the heat, which permeates through your skin to your core, pushing you over the edge as soon as you bottom out. [BigNameDesc of M] smirks as you fill [him of M] with your pitiful load, and what used to be a pleasant heat becomes unbearable as your crotch is enveloped with ghastly red light. [bold type]You realise you have become permanently more submissive![roman type]";
			moderateDignify;
			orgasm;
			PainUp 30;
			say AfterDominationComment 1 of M;
	FuckGet.

To facesit dominate (M - a demoness):
	say "You grab [NameDesc of M] by the wrists, forcing your magic power into [him of M] as you push [him of M] to [his of M] knees. [big he of M] doesn't resist, [his of M] eyes glinting bright red as [he of M] looks up at you with a sultry smile.[line break][speech style of M]'Oh, is it a trade you want. Your power in exchange for my mouth?'[roman type][line break][BigNameDesc of M] cocks an eyebrow.[line break][speech style of M]'Few things can compare to a woman's touch. But you know...I CAN offer those things to you. If you want.'[roman type][line break]Accept?";
	if the player is consenting:
		say "You decide to see what reward [he of M] had in mind, releasing your grip and allow [him of M] to catch [his of M] breath. [big he of M] blows a tiny cloud of smoke at you, which sends an invigorating chill up your spine as it dissipates against your body. You feel more flexible!";
		DexUp 1;
		now player-fucking is DOMINANT-NEUTRAL;
		say AfterDominationComment 4 of M;
	otherwise:
		if the player is possessing a vagina:
			say "[if the player is not able to speak]You shake your head. [otherwise if the sex addiction of the player < 7][line break][variable custom style]'I'm not letting you trick me.'[roman type][line break][otherwise if the sex addiction of the player < 12][line break][variable custom style]'Sorry, I just really need this.'[roman type][line break][otherwise][line break][variable custom style]'Come on, it'll be a lot of fun...'[roman type][line break][end if][BigNameDesc of M] nods, holding eye contact with you as [he of M] leans forward and plants a kiss on your clit. Ripples of heat spread out from the point of contact as [he of M] teases your folds with the very tip of [his of M] tongue, making sure to thoroughly cultivate your frustration before suddenly shoving you away.";
			heal vagina times 10;
			passively stimulate vagina from M;
		otherwise:
			say "[if the player is not able to speak]You shake your head. [otherwise if the sex addiction of the player < 7][line break][variable custom style]'I'm not letting you trick me.'[roman type][line break][otherwise if the sex addiction of the player < 12][line break][variable custom style]'Sorry, I just really need this.'[roman type][line break][otherwise][line break][variable custom style]'Come on, it'll be a lot of fun...'[roman type][line break][end if][BigNameDesc of M] nods, as [he of M] slips between your legs, chuckling to [himself of M] as [he of M] gently pushes your [AssDesc] apart. You feel [his of M] nails dig into you as [he of M] firmly plants [his of M] lips on your anal ring, and ripples of heat spread out around it. [big he of M] teases the inner edges of your sphincter with [his of M] tongue as arousal rapidly builds up inside you, making sure to thoroughly cultivate your frustration... only to suddenly duck under you and shove you away!";
			heal asshole times 10;
			passively stimulate asshole from M;
		severeDignify;
		say AfterDominationComment 3 of M;
		LickGet.

To watersports dominate (M - a demoness):
	say "You grab [NameDesc of M] by the wrists, forcing your magic power into [him of M] as you wrestle [him of M] to [his of M] knees.[line break][speech style of M]'No no NO! I won't allow it! I won't- I won't be made into some fucking mortal's toilet! Release me! Seriously, I'd rather go back to the fucking demon realm!'[roman type][line break]Release [him of M]?";
	if the player is consenting:
		say "You release [him of M], allowing [him of M] to return to [his of M] feet unmolested.";
		slightDignify;
		now player-fucking is DOMINANT-NEUTRAL;
		calm M;
		now the excitement of M is 1;
		say AfterDominationComment 4 of M;
	otherwise:
		say "You decide whatever 'wrath' [he of M] has in store for you isn't worth a trip to the loo, and roughly yank [his of M] face toward your crotch.[line break][variable custom style]'[if the player is gendered male and the bimbo of the player < 7]Don't worry, it will dry off...'[otherwise if the bimbo of the player < 12]When a girl's got to go...'[otherwise]I have to know what fun punishment you have in store for me...'[end if][roman type][line break][BigNameDesc of M] glares up at you as a stream of urine hits [his of M] face, visibly shivering with rage and humiliation. You release [him of M] when you're close to finished, allowing [him of M] to wipe off [his of M] face as the shower peters out.";
		ultraDignify;
		now the bladder of the player is 0;
		SilentlyDifficultyUp M by 2;
		FavourSet M to -99;
		say AfterDominationComment 5 of M;
		SportsGet.

To say AfterDominationComment (N - a number) of (M - a demoness):
	if N is 0:
		say "[speech style of M]'[one of]I will come back soon for my revenge. Cower in fear until I return.'[or]Wait here. I will come back later to exact my revenge.'[or]I will still have revenge, but I'll let you squirm first.'[in random order][roman type][line break]";
	otherwise if N is 1:
		say "[speech style of M]'[one of]Fool.'[or]I warned you.'[or]Foolish.'[in random order][roman type][line break]";
	otherwise if N is 2:
		say "[speech style of M]'[one of]You will know regret.'[or]I will not forget what you have done. You will pay.'[or]My vengeance will be like agony, mortal.'[in random order][roman type][line break]";
	otherwise if N is 3:
		say "[speech style of M]'[one of]I bet that felt good. It won't take much to make you cum now.'[or]It shouldn't be hard to find an orgasm now. You're welcome.'[or]You shouldn't have trouble finding a way to cum now. No need to thank me.'[in random order][roman type][line break]";
	otherwise if N is 4:
		say "[speech style of M]'...[one of]Smart[or]Smarter than you look[or]If you tell anyone I begged like that, you're DEAD[in random order].'[roman type][line break]";
	otherwise:
		say "[speech style of M]'[one of]You will DEARLY regret this, mortal!'[or]You will feel NOTHING but my fury!'[or]FOOL! You will NEVER be free from my vengeance!'[or]YOU will regret that FOREVER, fool!'[in random order][roman type][line break]".

Part 7 - Variants

Section 1 - Abyssal Demoness

abyssal demoness is a demoness. The text-shortcut of abyssal demoness is "ade".
To say MediumDesc of (M - abyssal demoness):
	say "abyssal demoness".

Definition: abyssal demoness is woods dwelling:
	if doomed >= 5 and diaper quest is 0, decide yes;
	decide no.

Definition: abyssal demoness is mansion dwelling:
	if doomed > 1 and diaper quest is 0, decide yes;
	decide no.

To compute perception of (M - abyssal demoness):
	now M is interested;
	say "[BigNameDesc of M] notices you[if the player is sluttily dressed][end if]. "; [The output for if the player is sluttily dressed occurs within the check itself.]
	let T be 1;
	if there are worn heels:
		repeat with H running through worn heels:
			if H is dildo-heels or the heel-height of H > 3, now T is 0;
	if the player is flying:
		say "What are you doing on my ceiling! Do you believe yourself ABOVE ME?! How dare you!";
		anger M;
	otherwise if the latex-transformation of the player > 3:
		say "[big he of M] doesn't seem interested for some reason.";
		bore M;
	otherwise if T is 0:
		say "[speech style of M]'[if T is 0][one of]Oh wow, nice heels! Where did you get them from?'[or]Glad to see you're still wearing proper heels.'[stopping][otherwise]Ah, a fellow servant of the Master.'[end if][roman type][line break]";
		calm M;
	otherwise if M is uniquely unfriendly:
		anger M;
		if the class of the player is priestess:
			say "Immediately upon seeing you, [he of M] shrieks:[line break][speech style of M]Your holy aura has no power out here, mortal! Get on your knees and submit to me as your new [literalMistress of M], or I will make you!'[roman type][line break][if M is friendly]Apparently [he of M] doesn't like priestesses...[end if]";
			say "Your holy aura does seem to have some effect against [him of M], as you are easily able to resist [his of M] dominating aura which tries to make you kneel on command.";
		otherwise:
			say "[speech style of M]'[if M is uninterested]You, whore! [otherwise]You know what? [end if][if the player is upright]Kneel down, I feel like ruining someone.'[otherwise]Stay down there, I'm going to punish you.'[end if][roman type][line break]Uh-oh...";
			if a random number between 1 and 15 < the bimbo of the player and the player is upright and the player is not dildo stuck:
				say "[BigNameDesc of M] has such a powerful dominating aura that you mindlessly drop to your knees in front of [him of M][if the bimbo of the player > 8], nearly drooling at the thought of [his of M] heel drilling inside you[end if].";
				allocate 1 seconds;
				try kneeling;
	otherwise if the player is prone:
		say "[speech style of M]'[if the class of the player is cultist]Servant.'[otherwise if the class of the player is succubus]Good practise, sister. Glad to see some of [his of demon lord] servants aren't idiots.'[otherwise]Get used to crawling, [boy of the player]; all will be servants eventually.'[end if][roman type][line break]";
		distract M;
	otherwise: [We know by know that the player must be upright.]
		if the class of the player is succubus:
			say "[speech style of M]'The mortals here are mine, sister. Do not forget that.'[roman type][line break]";
			distract M;
		otherwise:
			say "[speech style of M]'[if the class of the player is cultist][one of]You, servant. I don't recognise you, but then again you mortals all blend together for me. Standing in my presence is a direct challenge to my authority. Get on your knees. Now.'[or]KNEEL! KNEEL IN MY PRESENCE, PEON!'[stopping][otherwise]Kneel in my presence, mortal. Quickly, I wouldn't want to hurt you. HAHAHA!'[end if][roman type][line break]Obey?[line break]";
			if a random number between 3 and 22 < the delicateness of the player and the player is not dildo stuck:[I'm not sure if this is redundant.]
				say "[BigNameDesc of M] has such a powerful dominating aura that you mindlessly drop to your knees in front of [him of M][if the anal sex addiction of the player > 6], nearly drooling at the thought of what [he of M] could do to you with those heels.[end if].";
				allocate 1 seconds;
				try kneeling;
				calm M;
			otherwise if the player is not dildo stuck and the player is bimbo consenting:
				say "You drop to your knees.";
				allocate 1 seconds;
				try kneeling;
				calm M;
			otherwise:
				anger M.

This is the demoness ghost summoning rule:
	let M be current-monster;
	if M is abyssal demoness:
		if the channelling of M is 0, say "[BigNameDesc of M] stretches [his of M] hands out in front of [him of M], forming a triangle with [his of M] fingers as [he of M] concentrates. It's like [he of M]'s draining the heat from the air around you.";
		otherwise say "[BigNameDesc of M] is still concentrating on... whatever it is [he of M]'s doing!";
		repeat with G running through on-stage ghosts:
			interest G;
		increase creepiness by 10;
		FatigueUp 10;
		now the channelling of M is 1.
The demoness ghost summoning rule is listed in the demoness attack rules.

To compute the busy waiting of (M - abyssal demoness):
	say "[BigNameDesc of M] seems to be channelling energy into the gem hanging from [his of M] neck. The heavy feeling in the air is getting more[one of][or] and more[stopping] intense.";
	SilentlyDifficultyUp M by 1;
	increase creepiness by 3.

[Redundant. Will be deleted soon.
To compute (M - abyssal demoness) entering anally:
	now M is heel-mode;
	if the player is possessing a penis:
		if there is a worn chastity cage:
			say "[big he of M] taps your chastity cage with [his of M] foot, laughing as your [sissy-penis] strains in its tight prison. [big he of M] then traces a finger around your [asshole][if the player is possessing a scrotum] and squeezes your balls[end if] as you squirm beneath [him of M].[line break][speech style of M]'[one of]Your [if the player is possessing a scrotum]sissy balls are[otherwise][sissy-penis] is[end if] so fun to crush...'[or]Awww is your [sissy-penis] all locked away? I hope you like anal, because that's all the sex you're getting from now on...'[or]I'm going to spread you out slut, try not to lose your mind.'[stopping][roman type][line break]";
		otherwise:
			if the player is possessing a scrotum, say "[big he of M][if the size of penis >= 8] gives your [ShortDesc of penis] a few generous pumps and runs [his of M] fingernails down your lower back.[otherwise] slaps your [AssDesc] and presses one of [his of M] heels into your dangling [sissy-penis] and balls, the long 8 inch heel reminding you of your sexual inadequacy.[end if][roman type][line break][speech style of M]'Get ready to be stretched out by your [literalMistress of M].'[roman type][line break]";
			otherwise say "[big he of M][if the size of penis >= 8] gives your [ShortDesc of penis] a few generous pumps and runs [his of M] fingernails down your lower back.[otherwise] slaps your [AssDesc] and presses one of [his of M] heels into your dangling [sissy-penis], the long 8 inch heel reminding you of your sexual inadequacy.[end if][roman type][line break][speech style of M]'Get ready to be stretched out by your [literalMistress of M].'[roman type][line break]";
	say "[BigNameDesc of M] lifts up one of [his of M] feet, on which are [his of M] unique black shoes with [one of]dulled[or]shiny[sticky random] glass dildos for heels. [big he of M] continues cackling and pushes the heel into your [asshole]! As the demoness sinks in, [he of M] curls [his of M] lips into a wicked grin, gritting [his of M] teeth and going wide-eyed. Clearly [he of M] enjoys [himself of M] behind you as a cackle rings out to echo off the walls. Either [he of M] is really pent up or just enjoys ruining the players. Some kind of magic grasp is preventing you from moving.";
	now M is penetrating asshole;
	if the soreness of asshole < 10, ruin asshole.]

To say SummoningFlav of (M - abyssal demoness):
	if M is in the location of the player, say "The air around you grows unbearably cold and hot at the same time, as the mummy's wrappings darken, as if rapidly soaking up water. An [M] comes into view as the old fabric slowly unravels, laughing cruelly as the soggy cloth struggles to reform behind [him of M].";
	otherwise say "You hear the sound of inhuman laughter.".

Demoness ends here.
