Gladiator by Monster begins here.

A gladiator is a kind of monster. A gladiator is intelligent. The leftover-type of a gladiator is usually 106. A gladiator can be purified. A gladiator has a number called growth-target. A gladiator has a number called times-seeded. The times-seeded of a gladiator is usually 0. A gladiator has a number called curse-charge.

To say ShortDesc of (M - a gladiator):
	say "gladiator".

To say GladiatorCurse of (M - a gladiator):
	if M is male:
		say "[if lady fetish is 2]unbound [otherwise if futanari fetish is 1]futanari [otherwise]cursed [end if]";
	otherwise:
		say "[if M is purified]purified [otherwise][end if]".

Understand "futa", "futanari" as gladiator when the item described is male and lady fetish is not 2 and futanari fetish is 1.
Understand "unbound" as gladiator when the item described is male and lady fetish is 2.
Understand "cursed" as gladiator when the item described is male and lady fetish is not 2 and futanari fetish is 0.
Understand "purified" as gladiator when the item described is purified.

Definition: a gladiator is wenchy: decide yes.

Definition: a gladiator is raunchy:
	if it is male, decide yes;
	decide no.

Definition: a gladiator is father material:
	if it is male, decide yes;
	decide no.

Definition: a gladiator is willing to charm snakes:
	if diaper quest is 0, decide yes;
	decide no.

Definition: a gladiator is dark skinned: decide yes.

Definition: a gladiator is presenting as male:
	if lady fetish is 2, decide yes;
	decide no.

Definition: a gladiator is dungeon dwelling: decide yes.

Figure of Gladiator Interact 1 is the file "NPCs/MultiFloor/Gladiator/Cutscene/cutscene-gladiator-interact1.jpg".
Figure of Gladiator Interact 2 is the file "NPCs/MultiFloor/Gladiator/Cutscene/cutscene-gladiator-interact2.jpg".
Figure of Gladiator Interact 3 is the file "NPCs/MultiFloor/Gladiator/Cutscene/cutscene-gladiator-interact3.jpg".
Figure of Gladiator Interact 4 is the file "NPCs/MultiFloor/Gladiator/Cutscene/cutscene-gladiator-interact4.jpg".
Figure of Gladiator Interact 5 is the file "NPCs/MultiFloor/Gladiator/Cutscene/cutscene-gladiator-interact5.jpg".
Figure of Gladiator Interact 6 is the file "NPCs/MultiFloor/Gladiator/Cutscene/cutscene-gladiator-interact6.jpg".
Figure of Gladiator Interact 7 is the file "NPCs/MultiFloor/Gladiator/Cutscene/cutscene-gladiator-interact7.jpg".
Figure of Gladiator Interact 10 is the file "NPCs/MultiFloor/Gladiator/Cutscene/cutscene-gladiator-interact10.jpg".

Figure of Gladiator Cutscene 11 is the file "NPCs/MultiFloor/Gladiator/Cutscene/cutscene-gladiator-fuck9.png".
Figure of Gladiator Cutscene 12 is the file "NPCs/MultiFloor/Gladiator/Cutscene/cutscene-gladiator-event1.png".
Figure of Gladiator Cutscene 13 is the file "NPCs/MultiFloor/Gladiator/Cutscene/cutscene-gladiator-event2.png".
[Figure of Gladiator Cutscene 14 is the file "NPCs/MultiFloor/Gladiator/Cutscene/cutscene-gladiator-event3.png".]

Figure of Gladiator Cutscene 21 is the file "NPCs/MultiFloor/Gladiator/Cutscene/cutscene-gladiator-punish1.jpg".
Figure of Gladiator Cutscene 22 Female is the file "NPCs/MultiFloor/Gladiator/Cutscene/cutscene-gladiator-punish2a.jpg".
Figure of Gladiator Cutscene 22 Male is the file "NPCs/MultiFloor/Gladiator/Cutscene/cutscene-gladiator-punish2b.jpg".

Figure of Babified Gladiator is the file "NPCs/MultiFloor/Gladiator/gladiator6.jpg".

To decide which figure-name is the monster-image of (M - a gladiator):
	if M is male, decide on figure of futanari gladiator;
	otherwise decide on figure of gladiator.

To decide which figure-name is the vaginal-sex-monster-image of (M - a gladiator):
	if M is wild gladiator or M is enlightened gladiator:
		if playerRegion is Woods, decide on Figure of Wild Gladiator Cutscene 4;
		otherwise decide on Figure of Wild Gladiator Cutscene 2;
	decide on figure of gladiator cutscene 5.

To decide which figure-name is the anal-sex-monster-image of (M - a gladiator):
	if M is wild gladiator or M is enlightened gladiator:
		if playerRegion is Woods:
			if the player is possessing a penis and the largeness of breasts < 3, decide on Figure of Wild Gladiator Cutscene 3;
			otherwise decide on Figure of Wild Gladiator Cutscene 4;
		otherwise:
			if the player is possessing a penis, decide on Figure of Wild Gladiator Cutscene 1;
			otherwise decide on Figure of Wild Gladiator Cutscene 2;
	decide on figure of gladiator cutscene 6.

To decide which figure-name is the oral-sex-monster-image of (M - a gladiator):
	decide on figure of gladiator cutscene 7.

To decide which figure-name is the pacified-image of (M - a gladiator):
	if M is diaper-enslaved, decide on figure of babified gladiator;
	decide on figure of missing NPC.

Definition: a gladiator is willing to urinate: decide yes.

A stiff-gladiator is a kind of gladiator.
proud-gladiator is a stiff-gladiator. The text-shortcut of proud-gladiator is "pgl". Understand "proud", "gladiator" as proud-gladiator.
amazonian gladiator is a stiff-gladiator. The text-shortcut of amazonian gladiator is "agl".

A milky-gladiator is a kind of gladiator.
determined gladiator is a milky-gladiator. The text-shortcut of determined gladiator is "dgl".
topless gladiator is a milky-gladiator. The text-shortcut of topless gladiator is "tgl".

To say MediumDesc of (M - proud-gladiator):
	say "proud [GladiatorCurse of M]gladiator".

To say MediumDesc of (M - determined gladiator):
	say "determined [GladiatorCurse of M]gladiator".

To say MediumDesc of (M - amazonian gladiator):
	say "amazonian [GladiatorCurse of M]gladiator".

To say MediumDesc of (M - topless gladiator):
	say "topless [GladiatorCurse of M]gladiator".

To say LongDickDesc of (M - a gladiator):
	if lady fetish is 2 or futanari fetish is 1:
		say "huge 9-inch [manly-penis]";
	otherwise if gladiatorcurse is 1:
		say "demonic strap-on dildo";
	otherwise:
		say "magical strap-on dildo".

To say LongDickDesc of (M - a milky-gladiator):
	if lady fetish is 2 or futanari fetish is 1:
		say "big 8-inch [manly-penis]";
	otherwise if gladiatorcurse is 1:
		say "crimson strap-on dildo";
	otherwise:
		say "black strap-on dildo".

To say HoleDesc of (M - a gladiator):
	if M is male or lady fetish is 2, say "[asshole]";
	otherwise say "[vagina]".

To say ChestDesc of (M - a gladiator):
	if lady fetish is 2, say "pecs";
	otherwise say "breasts".

To say MonsterDesc of (M - wild gladiator):[she doesn't care about big breasts anymore and is more of a warrior type]
	say "This [man of M] is nude, [if lady fetish is 2][his of M] big, enticing asscheeks and[otherwise][his of M] large breasts completely exposed and [his of M][end if] [if the M is male or lady fetish is 2][LongDickDesc of M][otherwise]pussy[end if] in full view. Intricate tattoos cover [his of M] entire body, accentuating [his of M] impressively muscled form. [big he of M] looks very confident in [his of M] [SwordDesc of M]";

To say MonsterDesc of (M - enlightened gladiator):[she's gotten some guidance from the great ones, and is a bit sluttier]
	say "This [man of M] is completely naked with pearly strands of [semen] connecting [his of M] thighs together as [he of M] walks. The caramel skin of [his of M] chiselled chest and abs, as well as [his of M] [if lady fetish is 2]buttocks[otherwise]breasts[end if] are covered in a fine sheen of sweat. [big he of M] isn't armed, and there's a bit of an odd look in [his of M] eye, but [he of M] still seems confident.".

To say SwordDesc of (M - a gladiator):
	let D be the difficulty of M - the starting difficulty of M;
	say "[if D < 1]wooden training sword[otherwise if D < 2]iron shortsword[otherwise]steel longsword[end if]";

To say LeftoverDesc (N - 106):
	if diaper quest is 1:
		say "An unconscious gladiator is lying here, with a very full diaper and mittens over [his of a random gladiator] hands.";
	otherwise:
		say "An unconscious gladiator on the ground has a [if pregnancy fetish is 1]pregnant looking[otherwise]fully stretched[end if] belly and [semen] slowly flowing out of [his of a random gladiator] asshole. [big his of a random gladiator] shortsword is completely stuck in the stone ground.[line break]".

To say MonsterDesc of (M - a gladiator):
	if M is diaper-enslaved:
		say "This tall dark-skinned [man of M] has lost [his of M] sword and gained a white disposable diaper. [big he of M]'s either unwilling or unable to talk properly, and is wandering around confused and aimlessly.";
	otherwise if diaper quest is 1:
		say "This tall dark-skinned [man of M] looks very proud of [his of M] [SwordDesc of M] and adult, curvy body shape. [big his of M] [ChestDesc of M] are completely bare.";
	otherwise if M is fucked-silly:
		say "This tall dark-skinned [man of M] has a [if pregnancy fetish is 1 and lady fetish is 1 or full-lady fetish is 1]pregnant looking[otherwise]fully stretched[end if] belly and [semen] slowly flowing out of [his of M] gaping [HoleDesc of M]. [big he of M] seems like [he of M][']d carry a sword, but [he of M] clearly doesn't have one.";
	otherwise if lady fetish is 2:
		say "[one of]This [man of M] has big, kissable lips and a taut, muscular butt. However, the [SwordDesc of M] in [his of M] hands makes him look rather intimidating and dangerous. [big he of M] is wearing a leather belt[unless M is male], from which hangs a loincloth that comes halfway down [his of M] thighs[end if] and a scarlet cape that reaches all the way down to [his of M] knees. [big he of M] wears a perpetual sneer as [he of M] prowls through the dungeon like a hungry puma.[or]This [man of M] is practically naked, wearing only [unless M is male]a loincloth that comes about halfway down [his of M] thighs and [end if]a long, scarlet cape. [big he of M] has big, kissable lips and a taut, muscular butt, although [his of M] sex appeal is curbed by [his of M] perpetual sneer and the [SwordDesc of M] in [his of M] hand.[in random order][if doomed is 5][big his of M] irises seem to glow with a strange pink light.[end if][if M is male]Oh, and [he of M] has a [LongDickDesc of M] proudly erect and bobbing with every step [he of M] takes[otherwise]You can see the glint of steel under [his of M] loincloth with every step [he of M] takes.[end if]";
	otherwise:[at this point, we know the gladiator is definitely female, so we don't need to do gender substitutions here]
		say "[one of]This [man of M] is scantily clad, but the [SwordDesc of M] [he of M]'s carrying in [his of M] hands makes [him of M] look quite intimidating and dangerous. [big he of M] is wearing a leather belt, from which hangs a loincloth that only comes halfway down [his of M] thighs. Thick plates are held to [his of M] ankles, forearms, and shoulders by black straps, all of which are made of solid gold. A scarlet cape is draped over [his of M] shoulders, which are covered by loose black hair. [big his of M] [if (lactation fetish is 1 and M is milky-gladiator) or diaper quest is 1]milk-dripping breasts[otherwise]huge breasts[end if] are completely exposed, as well as the bronze skin of [his of M] taut stomach and muscular legs. [big he of M] wears a perpetual sneer as [he of M] prowls through the dungeon like a hungry puma.[or]This [man of M] is wearing a leather belt, a loincloth that comes about halfway down [his of M] thighs, ankle and forearm protectors, and a long, scarlet cape. [big he of M] is otherwise completely naked, nearly every inch of [his of M] flawless dark brown skin exposed, including [his of M] [if (lactation fetish is 1 and M is milky-gladiator) or diaper quest is 1]milk-dripping breasts[otherwise]huge breasts[end if], taut stomach, and muscular thighs. [big his of M] perpetual sneer and [SwordDesc of M] make [him of M] look intimidating and very dangerous.[in random order][if doomed is 5][big his of M] irises seem to glow with a strange pink light.[end if][if M is male]Oh, and [he of M] has a [LongDickDesc of M] pushing up through [his of M] belt.[end if]".

To say MonsterComment of (M - a wild gladiator):
	say "[variable custom style][big he of M] looks pretty tough...[roman type][line break]".

To say MonsterComment of (M - a gladiator):
	if lady fetish is 2:
		do nothing;
	otherwise if diaper quest is 0:
		if the bimbo of the player < 6:
			if M is male:
				if the player is gendered male, say "[first custom style][if the size of penis < 6]Wait, is [his of M] [DickDesc of M] actually bigger than my [manly-penis]?[otherwise if the size of penis < 9][big his of M] [DickDesc of M] can't really be that huge, can it[otherwise]No big deal. [big he of M] still isn't as big as I am.[end if]?";
				otherwise say "[first custom style]Why does [he of M] have a [if lady fetish is 2]boner[otherwise][DickDesc of M][end if]...?";
			otherwise:
				if the player is gendered male, say "[first custom style][one of]Damn, [he of M]'s a fucking fox! I should probably leave [him of M] alone though.[or]Man, what I wouldn't give to bury my bone in that! I'm not sure I want to provoke [him of M] though.[stopping][roman type][line break]";
				otherwise say "[first custom style][one of]Anybody who can be confident while half naked in this hell hole is probably really dangerous. I should leave [him of M] alone.[or]I definitely don't want to fight [him of M] unless I have to.[or][big he of M] doesn't look like someone I should take on.[stopping][roman type][line break]";
		otherwise if the bimbo of the player < 10 and the largeness of breasts < 8:
			if M is male:
				if lady fetish is 2, say "[variable custom style][one of]I guess all that confidence had to come from somewhere.[stopping][roman type][line break]";
				say "[variable custom style][one of]Huge boobs AND a huge [DickDesc of M]...[or]Does EVERY part of [him of M] have to be huge?[stopping][roman type][line break]";
			otherwise:
				if lady fetish is 2, say "[variable custom style][one of][big he of M] looks so confident.[or]Where does [he of M] get all that confidence?[stopping][roman type][line break]";
				say "[variable custom style][one of][big his of M] boobs are really big, but [he of M] looks so confident. Maybe having big boobs will make me feel better about being here?[or]Where does [he of M] get all that confidence? Maybe if I had bigger boobs I'd be like [him of M].[stopping][roman type][line break]";
		otherwise if the bimbo of the player < 10:
			if M is male, say "[variable custom style][one of]If [he of M] comes after me...I might as well use my boobs, right?[or][big he of M]'s so into big breasts...maybe that can help me deal with [him of M]?[at random][roman type][line break]";
			otherwise say "[variable custom style][one of]Maybe having big boobs isn't as bad as I thought...[or][big he of M] looks so confident, even though [his of M] chest is so large. Is that the secret?[or]We both have big boobs, but [he of M]'s confident. Maybe I should be more like [him of M]...[stopping]";
		otherwise:
			if lady fetish < 2, say "[second custom style][one of][big he of M]'s got big boobies, just like me![or]Looks like I'm not the only one with rockin['] tits![or][big his of M] knockers are almost as great as mine.[stopping]";
			otherwise say "[second custom style][one of][big he of M]'s carrying a sword. That's another word for penis! Hee hee![or]I bet [he of M]'d love a good titwank.[or]Mmm, I can't wait to wrap my tits around [his of M] cock![stopping][roman type][line break]";
	otherwise:
		if lady fetish < 2, say "[variable custom style]It's weird that [he of M]'s practically naked, right? But why do I find myself drawn to [his of M] [ChestDesc of M]...?[roman type][line break]".

A gladiator has a number called milkTimer.

To compute unique periodic effect of (M - a gladiator):
	if the class of the player is maid or a random number between 1 and 5 > 3, increase the milkTimer of M by 1;
	if a random number between 30 and 100 <= the milkTimer of M:
		now the milkTimer of M is 0;
		if ((lactation fetish is 1 and M is milky-gladiator) or diaper quest is 1) and lady fetish < 2:
			if M is in the location of the player:
				if M is asleep, say "A few drops of milk drip from [NameDesc of M][']s nipples onto the floor.";
				otherwise say "You make eye contact with [NameDesc of M] as a few drops of milk drip from [his of M] nipples onto the floor. [big he of M] puffs [himself of M] up with pride.";
			MilkPuddleUp 1 in (the location of M);
		otherwise if M is not asleep and M is not dangerous and M is not seduced and the refractory-period of M <= the refractory-time of M * -1 and M is male:[is she horny?]
			if M is in the location of the player, say "You see [NameDesc of M] find a corner and begin to masturbate, sighing with pleasure as [he of M] blows [his of M] load on the ground.";
			SemenPuddleUp 1 in (the location of M);
			now the refractory-period of M is -4.

To set up (M - a gladiator):
	reset M;
	now the monstersetup of M is 1;
	if diaper quest is 0, add gladiator-sword to the banishItems of M, if absent;
	add metal-disc to the taxableItems of M, if absent;
	add red-pasties to the tradableItems of M, if absent;
	add nail-bomb to the tradableItems of M, if absent;
	now the raw difficulty of M is the starting difficulty of M;
	now M is female;
	if doomed is 5, SilentlyDifficultyUp M by 1;
	now the health of M is the maxhealth of M.

Definition: a gladiator is human: decide yes.

To decide which number is the girth of (M - a gladiator):
	if M is male:
		if M is milky-gladiator, decide on 3;
		decide on 4;
	decide on 0.

To decide which number is the base semen load of (M - a gladiator):
	let X be 4;
	if gladiatorcurse is 0, decide on X;
	decide on X + 1.

Definition: a gladiator (called M) is able to remove cursed plugs: [Can the monster remove all butt plugs?]
	decide yes.

Definition: A gladiator (called M) is willing to shag:
	if M is awake and the scared of M is 0 and the boredom of M < 120 and M is threatening and M is male, decide yes;
	decide no.

gladiatorcurse is a number that varies. gladiatorcurse is 0.[1 - Xavier, 0 - Witch.]

Part 1 - Misc Flavour

To say SummoningFlav of (M - a gladiator):
	say "[if M is in the location of the player]A space opens up in the centre of the circle, and a sword pushes through, clattering across the nearby stone. You hear a mighty groan of effort as a [printed name of M] pulls [himself of M] through the portal, which quickly closes behind [him of M]. The buildup of energy slowly dissipates as [he of M] climbs to [his of M] feet.[otherwise]You hear the sound of metal hitting stone coming from another part of the dungeon.[end if]".

To say speech style of (M - a gladiator):
	say first custom style.

To say PregGrowth of (M - a gladiator):
	say "[NameDesc of M][']s [child]"

Definition: a gladiator (called M) is swordless:
	if M is fucked-silly or M is diaper-enslaved or M is sex-enslaved or M is enlightened gladiator, decide yes;
	decide no.

To compute labour to (M - a gladiator):
	if M is regional and M is alive:
		compute pregnancy clothing displacement;
		say "[PregFlav][if the father is in the location of the player]The [father][otherwise]The [father] appears almost as if on cue! [big he of M][end if] drops onto one knee, [unless M is swordless]gingerly placing [his of M] sword on the ground[otherwise]quietly smiling[end if] as [he of M] delivers your adorable human baby. You watch quietly as [he of M] lifts [if lady fetish is 2]her off the ground and gently cradles her against [his of M] chest.[line break][first custom style]'It's a girl.'[roman type][line break]You can hear the tinge of pride in [his of M] voice.[first custom style]'She will make a fine warrior one day.'[otherwise if the father is proud-gladiator or the father is amazonian gladiator]him off the ground, gently guiding [his of M] nipple into his mouth as [he of M] appraises him with an obvious look of disgust.[line break][first custom style]'I have no interest in raising a male, but he is better with off me than a whore like you.'[otherwise]her off the ground, gently cradling her with one hand as [he of M] guides a nipple into her tiny mouth.[line break][first custom style]'It's a girl.'[roman type][line break]You can hear the tinge of pride in [his of M] voice. [first custom style]'She will make a fine warrior one day.'[end if][roman type][line break] Without a second look in your direction, the [father] retrieves [his of M] weapon and leaves you to recover from your ordeal.";
		if the father is in the location of the player: [possibly this effect could be different]
			say "For some reason, you are filled with a sense of deep fulfilment. You feel great!";
			StrengthUp 1;
			DexUp 1;
			IntUp 1;
	otherwise if M is alive:
		Delay Labour.

To compute kneeling reaction of (M - a gladiator):
	if M is male:
		say "[one of][BigNameDesc of M] wraps a hand around [his of M] [LongDickDesc of M], readying [himself of M] for the violation that's sure to come.[or][BigNameDesc of M] takes a wide stance, snarling with [DickDesc of M] in hand.[line break][speech style of M]'Expect no mercy from me, whore. You are mine.'[roman type][line break][or][BigNameDesc of M] leers down at you, [DickDesc of M] already in hand.[line break][speech style of M]'Excited by your own folly, whore? Disgusting.'[roman type][or][BigNameDesc of M] wraps [his of M] hand around [his of M] [LongDickDesc of M]. [speech style of M]So, whore, what happens next?'[roman type][line break][or][BigNameDesc of M] spits in [his of M] hand and begins to stroke [his of M] hardening [DickDesc of M], silently regarding you with fierce contempt.[or][BigNameDesc of M] grins humourlessly.[line break][speech style of M]'I will not go easy on you, whore. You will pay for what you have done.'[roman type][line break][in random order]";
	otherwise:
		say "[BigNameDesc of M] smiles.[line break][speech style of M]'[one of]So finally, you begin to see that I am only trying to help you.'[or]You understand now, with my help you can become a true woman.'[or]I was like you once. In time, you will become as I am now.'[at random][roman type][line break]";
	if the player is not shameless, say "You shiver with shame.";
	strongHumiliate.

To say DiaperReaction of (M - a gladiator):
	if there is a currently visible diaper or the player is shameless:
		if M is unfriendly:
			say "[BigNameDesc of M] frowns.[line break][speech style of M]'I knew it. You are not even close to worthy of my respect.'[roman type][line break]";
		otherwise:
			bore M;
			say "[BigNameDesc of M] grimaces.[line break][speech style of M]'That is not an act befitting a respectable woman. I must not be seen near you.'[roman type][line break]";
		if the player is modest, say "[variable custom style][if the player is able to speak]'I am respectable usually! You've got to believe me!'[otherwise]Why is this happening to me?![end if][roman type][line break]";
		otherwise say "You [if the player is not disgraced]look down at the ground[otherwise]nod[end if] in shame.";
		FavourDown M with consequences;
	otherwise:
		say "It seems that you've gotten away with wetting without [NameDesc of M] noticing. This time.".

To compute (M - a monster) stomping (N - a gladiator):
	if diaper quest is 1:
		if M is in the location of the player, say "[BigNameDesc of N] charges at [NameDesc of M] with [his of N] [SwordDesc of N]. With incredible agility [NameDesc of M] grabs the sword and snaps it in two before body slamming [NameDesc of N]. As soon as [he of N] is out of sight, you hear [him of N] begin to scream. [big he of N] screams[line break][speech style of N]'No, [please], I need the toilet! Ahhhhh!'[roman type][line break]and then begins to wail like a baby. Moments later [NameDesc of M] stands back up, revealing that [NameDesc of N] is now lying in a very fully used diaper, and no longer has a sword. [big he of N] scrabbles at [his of N] diaper with [his of N] useless hands for a few moments before beginning to soil [himself of N] further. After [he of N] is done, [he of N] passes out from exhaustion.";
		otherwise say "You hear the sound of a sword hitting stone, followed by a [man of M] shouting[line break][speech style of N]'No, [please], I need the toilet!'[roman type][line break]from [if N is nearby]nearby![otherwise]somewhere in the dungeon![end if]";
		now N is diaper-enslaved;
	otherwise:
		if M is in the location of the player, say "[BigNameDesc of N] charges at [NameDesc of M] with [his of N] [SwordDesc of N]. With incredible agility [NameDesc of M] dodges the attack, grabs [NameDesc of N], snaps the sword in two and and presses [his of M] [LongDickDesc of M] against [his of N] asshole. [big he of N] screams[line break][speech style of N]'Aaagh, [please], not there!'[roman type][line break]but before [he of N] has even finished [he of M] has started fucking and cumming inside [him of N]. You watch as [his of N] belly grows in front of your eyes. After [he of N] is full, [he of M] tosses [him of N] to the ground, where [he of N] promptly faints.";
		otherwise say "You hear the sound of a sword hitting stone, followed by a [man of N] shouting[line break][speech style of N]'Aaagh, [please], not there!'[roman type][line break]from [if N is nearby]nearby![otherwise]somewhere in the dungeon![end if]";
		now N is fucked-silly;
		now the sleep of N is 600.

[To say LeftoverDesc (N - 106):
	if diaper quest is 1:
		say "An unconscious gladiator is lying here, with a very full diaper and mittens over [his of a random gladiator] hands.";
	otherwise:
		say "An unconscious gladiator on the ground has a [if pregnancy fetish is 1]pregnant looking[otherwise]fully stretched[end if] belly and [semen] slowly flowing out of [his of a random gladiator] asshole. [big his of a random gladiator] shortsword is completely stuck in the stone ground.[line break]".]

To say CurtseyReactionFlav of (M - a gladiator):
	if there are worn currently visible knickers:
		say "[BigNameDesc of M] frowns.[line break][speech style of M]'Are you aware of how disrespectful what you just did was?! I don't want to see your underwear!'[roman type][line break]";
		FavourDown M;
	otherwise:
		say "[BigNameDesc of M] frowns but doesn't say anything.".

To compute delay of (M - a gladiator):
	if M is wild gladiator or M is enlightened gladiator:
		say "[BigNameDesc of M] grips you by the throat[if M is male], [his of M] [LongDickDesc of M] already dripping precum[end if] as [he of M] squats over you.[line break][speech style of M]'[if M is enlightened gladiator][one of]You have my womanhood to look forward to[or]I always enjoy teaching you[stopping][otherwise][one of]It seems that there is only one way to ensure that you will learn your place[or]I'm beginning to look forward to our sessions together, [worm of M][stopping][end if].'[roman type][line break]";
		if M is male, cutshow figure of wild gladiator cutscene 5 for M;
	otherwise:
		say "[BigNameDesc of M] [if the player is prone]stands over you, one foot either side of your face[otherwise]holds back from [his of M] next attack[end if].[line break][speech style of M]'[if the health of M < the maxhealth of M]You have been defeated. [end if]Now submit to your superior.'[roman type][line break]".

Part 2 - Perception

Definition: a gladiator (called M) is uniquely unfriendly:
	if M is friendly-fucking or M is purified, decide no;
	if diaper quest is 1:
		if M is default uniquely unfriendly, decide yes;
	otherwise:
		if the player is a flatchested trap:
			if the gladiator-friendly-level of M < the size of penis, decide yes;
		[otherwise:
			if the gladiator-friendly-level of M > the largeness of breasts, decide yes;] [Removed as gladiator now follows standard favour rules]
	decide no.

To decide which number is the bab tolerance of (M - a gladiator):
	decide on 9.

To decide which number is gladiator-ideal-level of (M - a gladiator):
	if the player is a flatchested trap:
		decide on min penis size;
	otherwise if extreme proportions fetish is 0:
		if max breast size < 8, decide on max breast size;
		decide on 8;
	otherwise:
		if max breast size < 14, decide on max breast size;
		decide on 14.

To decide which number is gladiator-friendly-level of (M - a gladiator):
	let B be gladiator-ideal-level of M;
	if the player is a flatchested trap:
		if M is normally guardian, increase B by 1;
		if M is normally ally, increase B by 1;
		if M is normally buddy, increase B by 1;
		decide on B;
	otherwise:
		if M is normally guardian, decrease B by 1;
		if M is normally ally, decrease B by 1;
		if M is normally buddy, decrease B by 1;
		decide on B.

To decide which number is gladiator-next-level of (M - a gladiator):
	if the player is a flatchested trap:
		decide on the size of penis - 1;
	otherwise:
		if the largeness of breasts >= gladiator-friendly-level of M:
			decide on 30;
		otherwise:
			decide on the largeness of breasts.

To decide which number is the breast-happy of (M - a gladiator): [Is the gladiator happy with the size of your breasts?]
	if diaper quest is 1 or the largeness of breasts >= the gladiator-ideal-level of M, decide on 1;
	decide on 0.

Definition: a gladiator (called M) is fed up:
	if the player is prone:
		if the player is a flatchested trap:
			if the size of penis <= min penis size, decide yes;
		otherwise:
			if the breast-happy of M is 1 or there is an uncursed restricting salve covering breasts, decide yes;
	decide no.

To compute appearance assessment of (M - a gladiator):
	if the player is a flatchested trap or (the player is possessing a penis and the size of penis <= min penis size and tg fetish >= 1):
		if M is unfriendly:
			if tg fetish >= 1, say "[speech style of M]'Come, I am compelled to help you turn into the woman you should be. Kneel before me and allow me to accelerate your transformation[if M is buddy]. You have been kind to me but this does not mean I can abide your current pathetic appearance[end if].'[roman type][line break]";
			otherwise say "[speech style of M]'Come, I am compelled to help you turn into the [one of]emasculated weakling[or][sissy slut][stopping] you should be. Kneel before me and allow me to accelerate your transformation[if M is buddy]. You have been kind to me but this does not mean I can abide your current appearance[end if].'[roman type][line break]";
			anger M;
			now the growth-target of M is the size of penis;
		otherwise if the size of penis > min penis size:
			say "[speech style of M]'You again. I am not happy with the state of your remaining masculinity, but as you have been generous to me recently, I will leave you be... for now.'[roman type][line break]";
			FavourDown M;
		otherwise if tg fetish >= 1:
			say "[speech style of M]'Come, it is time for us to perform the Forbidden Ritual.'[roman type][line break]";
			anger M;
			now the growth-target of M is the size of penis;
		otherwise:
			say "[speech style of M]'Hmm, I can do no more for you, I will leave it to the other entities in this world to [if the analvirgin of the player is 1]break you in[otherwise]emasculate you further[end if]. Hopefully I will be around to see it happen.'[roman type][line break]";
			calm M;
	otherwise if M is unfriendly:
		if M is flying:
			say "[speech style of M]'If you had heavier breasts, this humiliating situation would not have happened. Don't worry, I'll be sure to help you out when you come down...'[roman type][line break]";
		otherwise if the player is gendered male:
			if the times-met of M is 0:
				say "[speech style of M]'[one of]You there, boy! You clearly need help if you want to become a woman!'[or]You there, boy! I cannot fix your penis, but I can still make you more like a woman!'[or]You there, boy! I am going to help you become a woman!'[in random order][roman type][line break]";
			otherwise if the largeness of breasts > 8:
				say "[speech style of M]'[one of]You, boy! You will need larger breasts than that if you want to overcome your gender handicap[if M is normally buddy]. Your recent generosity will not stop me from doing what must be done[end if].'[or]You again, boy? You will need a larger bust than that if you really want to become a woman[if M is normally buddy]. Your recent generosity will not stop me from doing what must be done[end if]!'[in random order][roman type][line break]";
			otherwise if the largeness of breasts < 3:
				say "[speech style of M]'[one of]You, boy! You will never be a true woman with such small breasts[if M is normally buddy]. You have been kind to me but this does not mean I can abide your current appearance[end if]!'[or]You again, boy? You will never be a woman with tiny breasts like that[if M is normally buddy]. You have been kind to me but this does not mean I can abide your current appearance[end if]!'[or]You, boy! You will need a much larger bust if you truly want to be a woman[if M is normally buddy]. You have been kind to me but this does not mean I can abide your current appearance[end if].'[in random order][roman type][line break]";
			otherwise:
				say "[speech style of M]'[one of]You again, boy? It is clear you still need my help[if M is normally buddy]. You have been kind to me but this does not mean I can abide your current appearance[end if]!'[or]You again, boy? I will make you a woman whether you want me to or not[if M is normally buddy]. You have been kind to me but this does not mean I can abide your current appearance[end if]!'[or]You again, boy? It is clear your journey to womanhood is only beginning[if M is normally buddy]. You have been kind to me but this does not mean I can abide your current appearance[end if].'[in random order][roman type][line break]";
		otherwise:
			if the favour of M > the aggro limit of M:
				say "[speech style of M]'You there, you do not look like a real woman with such small breasts. Do not worry though, I shall help you[if M is normally buddy] Your recent generosity will not stop me from doing what must be done[end if]!'[roman type][line break]";
			otherwise:
				say "[speech style of M]'You again! You clearly need more help becoming a real woman!'[roman type][line break]";
		now the growth-target of M is the gladiator-next-level of M;
	otherwise:
		if the breast-happy of M is 1:
			if the player is possessing a penis and tg fetish >= 1 and there is a worn chastity cage:
				say "[speech style of M]'[one of]Impressive breasts, but you must not stop at restraining your penis. It will never work. You must continue down the path of womanhood.'[or]Impressive chest, but I can tell your penis still holds sway over you. You must continue down the path, and become a true woman.'[or]You have an impressive bust, but even you must understand the futility of putting your penis in a cage. You must continue down the path of womanhood.'[in random order][roman type][line break]";
			otherwise if the player is possessing a penis and tg fetish >= 1:
				say "[speech style of M]'[one of]Impressive breasts. Your last step in becoming a true woman is to rid yourself of that penis.'[or]Impressive chest. You no longer need my help, but your journey is not over until you have discarded that penis.'[or]Impressive bust. Now, only your penis stands in the way of becoming a true woman.'[in random order][roman type][line break]";
			otherwise:
				say "[speech style of M]'[one of]Remember, those of lesser chest can never understand true womanhood.'[or]Impressive chest. I'm proud to consider you a sister!'[or]Impressive bust. Make sure you wear it proudly, sister!'[or]Impressive breasts, you must be proud!'[in random order][roman type][line break]";
			calm M;
		otherwise if M is guardian:
			say "[speech style of M]'It is good to see you again. [one of]How goes your pursuit of womanhood?'[or]I hope that one day you decide to further improve the size of your chest, I think you would not regret it.'[or]It would be even nicer to see you again if you breathed in some more pink smoke, haha! Just kidding, you are free to follow your own path.'[or]I hope you are staying safe.'[or]These halls grow more dangerous by the day.'[or][if M is swordless]If I had a sword, it would be yours if you needed it.'[otherwise]My sword is yours if you need it, but I cannot leave this region with you.'[end if][in random order][roman type][line break]";
		otherwise if the player is live fucked:
			if M is buddy, say "[speech style of M]'I'll come back later. Don't let me catch you like this again, lest I am forced to decide that you need... therapy.'[roman type][line break]";
			otherwise say "[speech style of M]'Real [if the player is gendered male and the largeness of breasts < 3]men[otherwise]women[end if] do not allow themselves to be degraded in public like this! I cannot help but judge you negatively.'[roman type][line break]";
			distract M;
			FavourDown M by 2;
		otherwise if the appearance of the player > the outrage tolerance of M:
			say "[speech style of M]'[one of]Do you truly believe that it is appropriate to be seen in these halls looking like that?!'[or]Your appearance betrays your true nature, [whore].'[or]I keep hoping to meet somebody truly worthy of my respect in these halls, but instead all I find are you disgraceful wenches.'[or]Ugh, does any other woman in these parts even know the meaning of the word [']dignified[']?!'[in random order][roman type][line break]";
			FavourDown M by 2;
		otherwise if breasts is lewdly exposed:
			if M is buddy and the times-met of M > 0:
				say "[speech style of M]'You again. I still think your breasts could be larger, but as you have been generous to me recently, I will leave you be... for now.'[roman type][line break]";
			otherwise:
				say "[speech style of M]'If you are going to bare your breasts to the world, you should at least make sure that they are a respectable size! Disgraceful.'[roman type][line break]";
			distract M;
			FavourDown M;
		otherwise if the player is top-wardrobe-malfunctioning:
			compute tq nip slip reaction of M;
		otherwise if the times-met of M is 0:
			say "[speech style of M]'Are you new to these parts, traveller? [one of]Well let me warn you now, you should learn to carry yourself with dignity and self-respect wherever you go, lest you wish to feel my wrath.'[or]I hope you are not another boring, weak sex addict like most of the new people I seem to meet down here as of late.'[in random order][roman type][line break]";
		if M is unfriendly and M is interested: [It is possible that the above loss in favour has taken the player down to unfriendly levels.]
			say "[BigNameDesc of M] [if the player is upright and M is not swordless]flexes [his of M] sword arm[otherwise]puts a forceful hand on your shoulder[end if].[line break][speech style of M]'I think [one of]it's time to take matters into my own hands. I'll aid with the growing of your breasts, but then it will be up to you whether you carry them with the dignity and pride of a true woman or simply become another brain-dead big-titted slut.'[or]I was right the first time - you need a chest-focused makeover if you are to stand any chance of understanding what it truly means to be a woman.'[stopping][roman type][line break]";
		otherwise if M is interested:
			say "[if M is buddy][BigNameDesc of M] gives you a wide smile, but you struggle to decipher whether it is meant to be friendly or jeering.[otherwise if M is acquaintance][BigNameDesc of M] puts [his of M] hands on [his of M] hips, and seems content to watch you closely for now.[otherwise][BigNameDesc of M][']s tight pursed lips tell you everything you need to know about [his of M] current feelings towards you.[end if]".

To compute perception of (M - a gladiator):
	say "[BigNameDesc of M] notices you[if the player is sluttily dressed][one of], even though [he of M] is almost naked [himself of M][or][stopping].[otherwise]![end if]";
	if the player is soulless and the class of the player is not succubus and the class of the player is not avatar:
		say "[BigNameDesc of M] looks at you carefully.[line break][speech style of M]'Oh my, just to look at your eyes I see there is nothing of true womanhood left inside your heart. Do not fear, I know just how to handle that...'[roman type][line break]";
		anger M;
	otherwise if M is purified:
		say "[one of][big he of M] bows.[line break][speech style of M]'I can only blame myself for leaving my enemies alive long enough for someone else to defeat them. It is clear that I have more to learn from you than you ever did from me. [NameBimbo], from this day forward, I will leave you to pursue womanhood on your own.'[roman type][line break][or][big he of M] bows.[line break][speech style of M]'Sister.'[roman type][line break][stopping]";
		calm M;
		FavourUp M by 20;
	otherwise if M is male:
		if M is wild gladiator:
			if M is unfriendly:
				say "[speech style of M]'[if breasts is not lewdly exposed][one of]You there, honour me. Obey at once or I will use force.[or]Honour me, whelp. I will play no games.'[stopping][otherwise if the largeness of breasts > 3][one of]You there, warrior. This forest belongs to me, and to me alone. Honour me or I will claim you by force.'[or]Prepare yourself to be claimed, warrior.'[stopping][otherwise][one of]I will not allow you to flaunt such small breasts in my forest. Leave now or I will claim you along with what little honour you possess.'[or]The only warrior here is me! You will soon taste my seed, whelp!'[stopping][end if][roman type][line break]";
				anger M;
				compute racial submission to M;
			otherwise:
				say "[speech style of M]'[if the times-met of M < 2]You there. I can see that you are no warrior, so you are welcome to experience my jungle as long as you honour me. Deny me and I will show no mercy.[otherwise]'[one of]How do you like my jungle, stranger?'[or]Everything here belongs to me. Impressive, isn't it.'[or]Even my sisters in the dungeon respect my might. You are in good company, stranger.'[at random][end if][roman type][line break]";
		otherwise if M is enlightened gladiator:
			if M is unfriendly:
				let O be random worn ridiculously low cut or higher clothing;
				say "[speech style of M]'[if O is clothing][one of]I have decided. I will show what it means to lay with a true woman.[or]You will receive the honour of laying with a true woman.'[stopping][otherwise if the largeness of breasts > 3][one of]You there, warrior. Let me test my womanhood against your womanhood.'[or]Prepare your womanhood to be tested, warrior.'[stopping][otherwise][one of]Even warriors of small chest can attain true womanhood. It is time you experienced it.'[or]Warriors of small chest simply have more to learn. Come, my [DickDesc of M] teach you.'[stopping][end if][roman type][line break]";
			otherwise:
				say "[speech style of M]'[one of]Be prepared for your next lesson about womanhood.'[or]Ah, sister! Do you like my chest?'[or]I am preparing for your next lesson, sister. Be at ease.'[in random order][roman type][line break]";
				FavourDown M;
		otherwise:
			say "[big he of M] stares at you with an angry gaze. [speech style of M]'I will never forgive you. Never!'[roman type][line break]";
			permanently anger M;
			compute racial submission to M;
	otherwise if M is diaper focused:
		say "[speech style of M]'Oh my goddess, what are you wearing?! There's no way I can abide seeing an adult like this.'[roman type][line break]";
		anger M;
	otherwise:
		compute appearance assessment of M;
	display interaction of M.

To decide which number is the outrage tolerance of (M - a gladiator): [What number of outrage they are unimpressed and lose favour.]
	if diaper quest is 1, decide on 4;
	decide on 6.

To compute disapproval of (M - a gladiator):
	if the breast-happy of M is 0:
		FavourDown M;
		say DisapprovalFlav of M;
		if M is unfriendly and M is interested:
			say BecomesAggressive of M;
	otherwise:
		say DisapprovalFlav of M.

To decide which number is the cringe tolerance of (M - a gladiator): [What number of cringe they are unimpressed and lose favour. Set to 20 by default so that it isn't used.]
	if diaper quest is 1, decide on 7;
	decide on 20.

To compute DQ appearance assessment of (M - a gladiator):
	if there is a worn currently visible messed knickers:
		say "[speech style of M]'[one of]Horrible! Even babies like you should be able to find someone to change you rather than wandering around with such a nasty smell following you. I don't think I will ever be able to look at you with respect again.'[or]I guess disgusting babies like you never change.'[stopping][roman type][line break][big he of M] turns to leave you alone.";
		FavourDown M by 4;
		distract M;
		if there is worn perceived unmessed knickers, compute state check of a random worn messed knickers;
	otherwise if the cringe appearance of the player > the cringe tolerance of M:
		if M is buddy, say "[speech style of M]'Hmm, I'll come back later, when you've hopefully had a chance to find some more grown-up clothing.'[roman type][line break]";
		otherwise say "[speech style of M]'You are just asking to be treated like a little girl, you know that? Grown women wouldn't be seen in such childish clothing.'[roman type][line break]";
		distract M;
		FavourDown M by 2;
	otherwise if the appearance of the player > the outrage tolerance of M:
		say "[speech style of M]'Truly adult women don't need to look like sluts in order prove their [maturity], you know. I'm going to leave you to hopefully improve your appearance before we next meet.'[roman type][line break]";
		distract M;
		FavourDown M by 2;
	otherwise if the player is top-wardrobe-malfunctioning:
		compute dq nip slip reaction of M;
	otherwise:
		say "[speech style of M]'[big please]d to meet you[if the times-met of M > 0] again[end if]. ".

To compute DQ perception of (M - a gladiator):
	now M is interested;
	say "[BigNameDesc of M] notices you!";
	if (there is a worn diaper or the diaper-duration of M > 0) and the player is immobile:
		say "[big he of M] seems to decide to leave you alone for now.";
		distract M;
	otherwise if M is uniquely unfriendly:
		say "[speech style of M]'[if the times-submitted of M is 0][one of]Goodness gracious, this has gone too far! Clearly I need to take your care into my own hands.'[or]You need more than a diaper check, little one. You need reconditioning. Come here.'[or]Come here. I am going to train you further.'[then at random][otherwise]You again! [one of]On your knees!'[or]Your appearance has not improved since our last session. Clearly I must punish you further.'[at random][end if][roman type][line break]";
		anger M;
	otherwise if there is a worn currently at least partially visible diaper or M is aware that the player needs a change:
		compute diaper check of M;
	otherwise if the diaper-duration of M > 0:
		if there is a worn diaper:
			compute diaper check of M;
		otherwise:
			say "[big he of M] swiftly walks up to you and holds [if diaper messing < 3]a hand to the front[otherwise]hands to the front and back[end if] of your crotch, pushing firmly to get a good feel.[line break][speech style of M]'Child! I can't believe you have disobeyed my order to remain in diapers. I will make sure you sorely regret this!'[roman type][line break]";
			FavourDown M by 4;
			anger M;
	otherwise if M is unfriendly:
		say "[speech style of M]'I'm disappointed in you. Come here, child.'[roman type][line break]";
	otherwise:
		let F be the favour of M;
		compute DQ appearance assessment of M;
		if M is interested: [If she is interested she hasn't finished speaking.]
			if M is unfriendly:
				say "[speech style of M][if the player is upright]Get on your knees, and get what's coming to you.'[otherwise]In fact, stay right there, I'm going to treat you the way you deserve.'[end if][roman type][line break]";
			otherwise if the favour of M < F and M is not buddy:
				say "[speech style of M][one of]Just unacceptable.'[or]Honestly, I can't believe it even needed to be said.'[or]Must I really state the obvious?'[in random order][roman type][line break]";
			otherwise:
				say "[speech style of M][one of]Anyway, if you ever need tips on how to be womanly, don't hesitate to ask.'[or]Anyway, I should allow you to proceed with your journey.'[or]Anyway, your appearance is much better than some of the wenches I've seen down here, so I will allow you to proceed unhindered.'[in random order][roman type][line break]";
	if M is interested, display interaction of M.

To display interaction of (M - a gladiator):
	if M is wild gladiator and M is unfriendly:
		cutshow figure of gladiator interact 8 for M;
	otherwise if M is enlightened gladiator and M is unfriendly:
		cutshow figure of gladiator interact 9 for M;
	otherwise if M is guardian:
		alwayscutshow figure of gladiator interact 1 for M;
	otherwise if M is ally:
		alwayscutshow figure of gladiator interact 2 for M;
	otherwise if M is buddy:
		alwayscutshow figure of gladiator interact 3 for M;
	otherwise if M is acquaintance:
		alwayscutshow figure of gladiator interact 4 for M;
	otherwise if M is friendly:
		alwayscutshow figure of gladiator interact 5 for M;
	otherwise if M is male:
		alwayscutshow figure of gladiator interact 6 for M;
	otherwise:
		alwayscutshow figure of gladiator interact 7 for M.

To say DQFeedingResistReactionFlav of (M - a gladiator):
	say "[speech style of M]'[one of]Hahaha, thrash and flail to your heart's content sweetie, my nectar will find its mark, like it or not.'[or]Please angel, my nipples are practically purple. You will not know release until I allow it!'[or]Hehe, are we embarrassed, being nursed in public? You know proud warriors would not be seen dead like this. And yet here you are!'[in random order][roman type][line break]".

Part 3 - Combat

To say waitingflav of (M - a gladiator):
	if the player is able to speak:
		if M is male:
			say "[variable custom style]'[if the bimbo of the player < 10]I'm sorry! I didn't want any of this to happen...'[otherwise]It's just a [DickDesc of M], honey, get over it! Now stop stalling and fuck me.'[end if][roman type][line break]";
		otherwise:
			say "[one of][line break][variable custom style]'[if the bimbo of the player < 10]Go on then, let's get this over with.'[otherwise]You're the boss, lady!'[end if][roman type][line break][or][or][or][or][cycling]";
	otherwise:
		say "[variable custom style][muffled sounds][roman type][line break]".

Section 1 - Protect and Attack

To compute (M - a gladiator) protecting against (X - monster):
	if the player is monster fucked:
		if M is wild gladiator:
			say "[speech style of M]'Such is the law of the jungle.'[roman type][line break][BigNameDesc of M] smiles to [himself of M] and turns to leave.";
		otherwise:
			say "[speech style of M]'Women should not be caught doing such things... as you are a friend I will turn a blind eye this once.'[roman type][line break][BigNameDesc of M] turns to leave.";
		FavourDown M;
		bore M;
	otherwise if the player is upright and the difficulty of X > the difficulty of M and M is ally:
		compute M default protecting against X;
	otherwise if X is intelligent and the player is getting unlucky:
		say "[speech style of M]'[one of]Learn from this battle.'[or]How will you handle uneven battle?'[or]Now you face us together!'[or]A real woman continues to fight even when outnumbered!'[at random][roman type][line break][BigNameDesc of M] grins and follows [NameDesc of X][']s lead. [GotUnluckyFlav]";
		anger M;
	otherwise:
		say "[speech style of M]'[if M is wild gladiator]Everything here is mine. I see no reason to choose favourites.'[otherwise]I cannot help you; a real woman fights for herself alone.'[end if][roman type][line break][BigNameDesc of M] turns to leave.";
		bore M.

To say AllyDamageFlav of (M - a gladiator) on (X - a monster):
	say "[speech style of M]'Hyah!'[roman type][line break][BigNameDesc of M] strikes [NameDesc of X][one of] with the blunt end of [his of M] sword. It's like [he of M] is purposefully holding back.[or]![stopping]".

To compute the flying player taunting of (M - a gladiator):
	let R be a random number from 1 to 6;
	if R is 1:
		say "[BigNameDesc of M] berates you.[line break][speech style of M]'[one of]Proper women have slim, respectable figures. You on the other hand, have clearly let yourself go.[or]You are so obese that you can't even move. How could anyone ever respect you?[or]If your breasts were more substantial you wouldn't be lifted into the air so easily. What a useless person you are.[or]You look like an animal ready to be eaten, not a human ready to be respected.[or]Your current curves do not make you look attractive. They make you look like a slob.[in random order]'[roman type][line break][if the humiliation of the player < 17500]You [one of]wince[or]shudder[or]cringe[purely at random] with shame.";
		humiliate 20.

To say LandingTaunt of (M - a gladiator):
	say "[BigNameDesc of M] frowns.[line break][speech style of M]'[one of]Good. I shan't waste any more time waiting!'[or]So disgraceful. You can't even accept your punishment with dignity.'[in random order][roman type][line break]";
	humiliate 50.

To compute the default taunting of (M - a gladiator):
	say "[if M is enlightened gladiator and M is male][BigNameDesc of M] furiously strokes [his of M] [DickDesc of M] as [he of M] watches you. [otherwise][BigNameDesc of M] stands still, patiently watching you. [end if]".

To compute the dildo stuck taunting of (M - a gladiator):
	if M is not swordless and the difficulty of M - the starting difficulty of M >= 1:
		repeat with B running through uncursed bras worn by the player:
			say "[speech style of M]'You don't need this!'[roman type][line break][BigNameDesc of M] takes advantage of your compromised position on the dildo and uses [his of M] shortsword to slice off your [printed name of B]![line break][speech style of M]'Display your chest proudly!'[roman type][line break]";
			destroy B.

This is the gladiator latex punishment rule:
	if current-monster is not male, follow the default latex punishment rule.
The latex punishment rule of a gladiator is usually the gladiator latex punishment rule.

The monster fucked taunting rule of a gladiator is usually the gladiator further degrading rule.
This is the gladiator further degrading rule:
	let M be current-monster;
	if watersports fetish is 1 and the number of monsters filling Face is 0 and M is not male and the latex-transformation of the player <= 4:
		if M is enlightened gladiator or M is wild gladiator:
			say "[BigNameDesc of M] walks round to your face.[line break][speech style of M]'[if M is wild gladiator]Are you familiar with the law of the jungle? This kind of thing only happens to weak people. This is the only way you'll ever learn.'[otherwise]You're shameful. Trash. I'm going to mark you. Everyone will know now.'[end if]";
		otherwise if the player is gendered male:
			say "[BigNameDesc of M] walks round to your face.[line break][speech style of M]'[one of]Only a man would be caught performing such an act. You do not deserve true womanhood. I have no choice but to degrade you further.[or]A dignified woman would never be caught performing such acts! You do not deserve true womanhood! I have no choice but to degrade you further.[or]As a man, you already lack my respect. Now that I know you are performing such acts, I have no choice but to degrade you further.[or]Because it was not your choice to be a man, I tolerated helping you. But now that I know you are performing such acts, I have no choice but to degrade you further.[in random order]";
		otherwise:
			say "[BigNameDesc of M] walks round to your face.[line break][speech style of M]'A dignified woman should not be caught performing such acts! You do not deserve to be called a woman. I have no choice but to degrade you further.'";
		compute M urinating;
	otherwise if the number of monsters filling Face is 0 and M is male:
		now the chosen-orifice of M is face; [This is so she'll do something to you instead of standing there dumbstruck with rage.]
		follow the monster mouth insertion rule;
	otherwise:
		compute the default taunting of M;
	rule succeeds.

To say PissDrinkThreat of (M - a gladiator):
	say "[speech style of M]'[one of]For this to be a proper punishment, you must willingly drink it all[or]Open your mouth and drink, or I will not stop with just this[in random order].'[roman type][line break]".

To say UrinationFlav of (M - a gladiator):
	if lady fetish is 2 or (M is male and full-lady fetish is 0):
		say "[if the urine taste addiction of the player < 4][one of][BigNameDesc of M] smiles widely, holding [his of M] [LongDickDesc of M] several centimetres away from your face. You assume [he of M] wants you to open wide, when suddenly a stream of [urine] spurts out [his of M] tip![or][BigNameDesc of M] smiles widely, holding [his of M] [LongDickDesc of M] inches away from your face. You are ready this time when a stream of [urine] floods out from the tip![stopping][otherwise][BigNameDesc of M] smiles widely, holding [his of M] [LongDickDesc of M] inches away from your face. You are ready as a stream of [urine] floods out from the tip![end if][if the humiliation of the player < HUMILIATION-MODEST + 1500 and the urine taste addiction of the player < 7][line break][variable custom style][line break]This can't be happening[one of].[or] again![stopping][roman type][line break][end if]";
	otherwise:
		if M is enlightened gladiator:
			say "[roman type][line break][BigNameDesc of M] grabs a handful of your hair, forcing you to look up as [he of M] parts [his of M] caramel pussy lips. [big he of M] begins to furiously rub [his of M] clit as golden urine begins streaming straight toward your face.";
		otherwise:
			say "[roman type][line break][BigNameDesc of M] [if M is wild gladiator]dips a few fingers into[otherwise]pulls [his of M] loincloth to the side, exposing[end if] [his of M] tight [if M is proud-gladiator]brown[otherwise if M is determined gladiator]brown[otherwise if M is amazonian gladiator]bronze[otherwise]caramel[end if] pussy[unless M is wild gladiator] and thick black bush[end if]. Pulling apart [his of M] lips, [he of M] starts pissing in your hair and face.";
	cutshow figure of gladiator cutscene 11 for M.

To compute satisfaction of (M - a gladiator):
	if the player is a flatchested trap:
		if the size of penis < the growth-target of M:
			satisfy M for 450 seconds;
			now the target-room of M is Capsule;
	otherwise:
		if the largeness of breasts > the growth-target of M and M is not swordless and the difficulty of M > the starting difficulty of M:
			let C be a random currently uncovered tearable normally-nipple-covering clothing;
			if C is clothing and a random number between the cleavageCover of C and 10 >= 9:
				say "[speech style of M]'I can't see enough of your new puppies. Let me get a better look.'[roman type][line break]Without waiting for a response, [NameDesc of M] slices your [C] open with [his of M] sword, destroying it!";
				destroy C;
			satisfy M for 850 seconds;
			now the target-room of M is Capsule.

The gladiator unique punishment rules is a rulebook. The unique punishment rule of a gladiator is usually the gladiator unique punishment rules.
[The unique punishment rule of a gladiator is usually the gladiator punishment rule.]
This is the gladiator demon conversion rule:
	let M be current-monster;
	if M is uninterested and M is not male, rule succeeds;[Handled first so we know the gladiator doesn't want to do anything to you this turn.]
	if debugmode > 1, say "delayed stand is [delayed stand]";
	if M is not male and the player is soulless and the class of the player is not succubus and the class of the player is not avatar and M is not wild gladiator and delayed stand is 0:[This prevents a glitch with autostanding and the gladiator dragging]
		let player-moved be 0;
		now the target-room of M is Dungeon33;
		if the location of the player is Dungeon33:
			say "[BigNameDesc of M] smears you with blood from a container in the room and begins a strange chant. You feel a sudden pain, so great that your vision goes black![line break]You awake after you're not sure how long, with [NameDesc of M] glancing at you with vague interest. You feel different somehow...";
			compute succubus transformation;
			satisfy M;
		otherwise:
			drag to Dungeon33 by M;
		rule succeeds.
The gladiator demon conversion rule is listed first in the gladiator unique punishment rules.

This is the gladiator sex conversion rule:
	let M be current-monster;
	if M is uninterested and M is not male, rule succeeds;[Handled first so we know the gladiator doesn't want to do anything to you this turn.]
	if debugmode > 1, say "delayed stand is [delayed stand]";
	if M is not male and M is not wild gladiator and delayed stand is 0 and the player is possessing a penis and (the size of penis <= min penis size or the real size of penis <= min penis size) and tg fetish >= 1:
		let player-moved be 0;
		now the target-room of M is Dungeon33;
		if the location of the player is Dungeon33:
			say "[speech style of M]'At last, we can complete your transformation. Your downstairs transformation, at least...'[roman type][line break][BigNameDesc of M] pushes you into the middle of the circle and whispers a few words in a language you don't understand. At first it seems like whatever [he of M] just tried to do didn't work, but then you feel your insides, behind your crotch, twisting and turning and rearranging themselves[if the player is possessing a penis], and then you shriek in surprise and horror as you realise you can't feel your [player-penis][end if]! You reach down to feel yourself and discover that a brand new [variable custom style][vagina][roman type] has taken its place. ";
			SexChange the player;
			satisfy M;
		otherwise:
			drag to Dungeon33 by M;
		rule succeeds.
The gladiator sex conversion rule is listed first in the gladiator unique punishment rules.

This is the gladiator fed up rule:
	let M be current-monster;
	if lady fetish is not 2 and M is not male and M is fed up:
		if the player is possessing a penis:[if her refractory-period is low enough, she'll want to ride the player instead]
			if the player is a sissy or (the size of the penis <= 5 and the refractory-period of M > the refractory-time of M * -1) or M is not willing to charm snakes:
				if penis is not penis-erect:
					say "[BigNameDesc of M] grabs your hair and pulls your face into [his of M] pussy.[line break][speech style of M]'You will worship me so you might learn how to be a more [if tg fetish >= 1]respectable woman[otherwise]useful sissy[end if]. Be warned, if I see your shameful manhood rise, then you will be further punished.'[roman type][line break]";
					arouse 750;
					if penis is not flaccid-under-pressure:
						say "[roman type] Your [sissy-penis] starts to stiffen as you service the [if interracial fetish is 1]ebony goddess's [pussy][otherwise]amazon's pussy[end if][roman type].[line break]";
						now penis is penis-erect;
					otherwise:
						say "[roman type] Your [sissy-penis] twitches, but remains soft as you service the [if interracial fetish is 1]ebony goddess's [pussy][otherwise]amazon's pussy[end if][roman type].[line break]";
				if penis is penis-erect:
					say "[speech style of M]'Clearly your manhood has not yet learned its place in the world. I shall need to break it further for your own good.'[roman type][line break]. [BigNameDesc of M] grabs your [genitals] with one hand and presses into your navel with two fingers whilst murmuring some curse. Your [sissy-penis] feels hotter and more sensitive than ever in [his of M] firm grip, but your body betrays you as your erection fades. [BigNameDesc of M] smiles at your impotence and starts teasing the head of your limp [sissy-penis].[line break][speech style of M]'[if the penetrativevirgin of the player is 1] I've just made sure you're going stay a virgin sissy. Don't look so sad slut, you can still cum...'[otherwise]Spread your ass cheeks slut, you're going to cum like a wanton whore so you might further learn your place.'[end if][roman type][line break]";
					say "[if asshole is actually occupied]You feel [him of M] start to toy with your [ShortDesc of a random thing penetrating asshole], pushing it into your prostate until you can't take it anymore! [otherwise]You feel two wet fingers slip into your [asshole], milking your prostate as [he of M] squeezes your balls.[roman type][line break]";
					anally orgasm shamefully;
					increase the penis-obedience of penis by 4;
					strongHumiliate;
				otherwise:
					say "[BigNameDesc of M][']s thighs squeeze your head as [he of M] climaxes and squirts girlcum all over your face.[line break][speech style of M]'You make for a good pussy licker, slut. Let me show you one of the pleasures of womanhood.'[roman type][line break][big he of M] pushes you to the floor and sits on your hips, your [ShortDesc of penis] remaining[if there is a worn chastity cage] tightly locked away in its cage[otherwise] completely limp[end if] as it's pressed against your body by [his of M] hot and engorged pussy. [BigNameDesc of M] rolls [his of M] hips back and forth, teasing your[if there is a worn chastity cage] caged[end if] [sissy-penis] between [his of M] ebony pussy lips. You blush hard as [NameDesc of M] twists your nipples and whispers dirty thoughts into your ears.[line break][speech style of M][one of]'In my tribe, inferior males like you are kept as entertainment...'[or]'I bet you might be able to manage an erection with a [manly-penis] in your sissy ass...'[or]'It's a good thing you can't get hard anymore, your [sissy-penis] isn't large enough to please a woman anyway...'[in random order][roman type][line break]Your nipples are then mercilessly licked and rubbed until your little bitch [sissy-penis] tingles.[line break]";
					orgasm M;
					LickCount;
					breasts orgasm shamefully;
					strongHumiliate;
				satisfy M;
				rule succeeds;
		otherwise if M pierce success is 0: [If it is 0 it means nipple chain can't be applied. If it is 2, then the player was pierced successfully this turn.]
			say "[BigNameDesc of M] [if M is enlightened gladiator]seizes you by the neck, lifting you partway off the ground as [he of M] jams [his of M] crotch into your face. [big he of M] chokes you with no remorse, dropping you only when your face has been thoroughly smeared with [his of M] juices[otherwise] presses the sharp part of [his of M] sword into your side, making sure that it hurts. [big he of M] pulls away just before the pressure reaches the point where it would have pierced your tender skin[end if].";
			PainUp 2;
			if M is enlightened gladiator:
				if bukkake fetish is 1, CumFaceUp 2;
				otherwise StomachSemenUp 1;
			say "[speech style of M]'[if M is enlightened gladiator]Good. Useful.[otherwise]Maybe next time you should think twice before pissing off a bitch with a sword[end if].'[roman type][line break]";
			satisfy M;
			rule succeeds.
The gladiator fed up rule is listed last in the gladiator unique punishment rules.

This is the gladiator smoke rule:
	let M be current-monster;
	if M is not male and M is not fed up:
		if presented-orifice is not nothing, say "[BigNameDesc of M] sighs.[line break][speech style of M]'Don't worry, I'm not going to have sex with you. You do have a one track mind, don't you?'[roman type][line break]";
		let player-moved be 0;
		if milking is 1:
			say "[BigNameDesc of M] pulls the milkers off your nipples!";
			now milking is 0;
		let nearest-room be nothing;
		let closest-room be 100;
		if M is wild gladiator:
			repeat with S running through smoky jungle rooms:
				if the distance of S < closest-room:
					now closest-room is the distance of S;
					now nearest-room is S;
		otherwise if M is enlightened gladiator and M is in the mansion:
			repeat with S running through smoky haunted rooms:
				if the distance of S < closest-room:
					now closest-room is the distance of S;
					now nearest-room is S;
		otherwise:
			repeat with S running through smoky labyrinth rooms:
				unless S is Dungeon12:
					if the distance of S < closest-room:
						now closest-room is the distance of S;
						now nearest-room is S;
		if M is wild gladiator and the smoke of M is 0:
			say "[BigNameDesc of M] holds you down as you breathe in the last of the smoke.";
			compute satisfaction of M;
		otherwise if nearest-room is nothing or delayed stand is 1:
			say "[BigNameDesc of M] takes the pink vial from [his of M] belt! ";
			[cutshow figure of gladiator cutscene 14 for M;]
			say "[big he of M] throws it on the [if playerRegion is woods]ground, and the clearing starts to fill with thick pink smoke[otherwise]floor, and the room starts to fill with pink smoke[end if]!";
			cutshow Figure of Gladiator Cutscene 21 for M;
			now the location of M is smoky;
			if M is wild gladiator, now the smoke of M is the difficulty of M - 2;
		otherwise if nearest-room is the location of the player:
			say "[BigNameDesc of M] holds your face in the pink smoke.";
			now the target-room of M is nearest-room;
			compute satisfaction of M;
			if M is interested:
				if the player is gendered male, cutshow Figure of Gladiator Cutscene 22 male for M;
				otherwise cutshow Figure of Gladiator Cutscene 22 female for M;
		otherwise:
			now the target-room of M is nearest-room;
			drag to the target-room of M by M;
		rule succeeds.
The gladiator smoke rule is listed last in the gladiator unique punishment rules.

To say DragArrival of (M - a gladiator) to (R - a room):
	cutshow figure of gladiator cutscene 12 for M;
	if M is enlightened gladiator:
		say "[speech style of M]'[if the player is not a flatchested trap]Let's make those tits a little bigger. You will thank me...'[otherwise]Let's shrink down that cock a little. You will thank me one day...'[end if][roman type][line break]";
	otherwise if M is wild gladiator:
		say "[speech style of M]'[if the player is not a flatchested trap]Your breasts need to be bigger. I will not suffer a trophy with such bee-stings...'[otherwise]Your penis must be inferior to mine, obviously.'[end if][roman type][line break]";
	otherwise:
		say "[speech style of M]'[if the player is not a flatchested trap]Now let's see if we can get your breasts to grow a bit.'[otherwise]Now we will see if we can get your [sissy-penis] to shrink a bit.'[end if][roman type][line break]";
	let G be the gladiator-next-level of M;
	if the growth-target of M < G, now the growth-target of M is G.

To say DragArrival of (M - a gladiator) to (R - Dungeon33):
	say "[BigNameDesc of M] looks down upon you.[line break][speech style of M]'Now let us begin.'[roman type][line break]".

To say PresentAcceptanceFlav of (M - a gladiator):
	if presented-orifice is penis, say "[speech style of M]'You are challenging me? Ha. Hahaha... Did you expect me to refuse?'[roman type][line break][BigNameDesc of M] seems convinced by your request!";
	otherwise say "[speech style of M]'[one of]Eager to show me what a whore you really are? Be my guest.'[or]I am going to enjoy this...'[stopping][roman type] [BigNameDesc of M] seems convinced by your request!".

To say StrikingFlav of (M - a gladiator) on (B - a body part):
	if M is swordless, say "[BigNameDesc of M] smacks you [TargetName of B]! ";
	otherwise say "[BigNameDesc of M] smacks you [TargetName of B] with the flat of [his of M] sword! ".

To say StrikingSuccessFlav of (M - a gladiator) on (B - a body part):
	say "[StrikingFlav of M on B][one of]That's going to leave a bruise[or]It's a direct hit[or]It connects powerfully with a loud THUD[or]It leaves a sore red mark where it hit[at random]!".

To say StrikingFailureFlav of (M - a gladiator) on (B - a body part):
	say "[StrikingFlav of M on B][one of]You manage to dodge the blow enough that it doesn't hurt.[or]The strike was too weak to hurt you.[or]By swiftly blocking the hit, you manage to avoid getting hurt.[at random]".

To compute (S - a spike bra) damaging (M - a gladiator):
	say "Somehow, the magic spikes on your [printed name of S] reflect some of the damage from [NameDesc of M][']s attack [unless M is swordless]back down [his of M] sword and [end if]into [his of M] wrist! [big he of M] growls with pain!";
	decrease the health of M by 3.

To decide which body part is the painful-part of (M - a gladiator):
	let B be a random body part;
	if B is breasts:
		if the breast-happy of M is 1, now B is face;[She *won't* attack the proud breasts of a true woman]
		otherwise now B is a random body part;[Otherwise, breasts will be viable, but a lower priority]
	if B is a fuckhole or B is penis or B is scrotum, now B is hips;
	if B is hair, now B is face;
	decide on B.

To decide which body part is the painful-part of (M - an enlightened gladiator):[The enlightened gladiator prefers to target breasts]
	let B be a random body part;
	if B is a fuckhole or B is penis or B is scrotum, now B is breasts;
	if B is hair, now B is face;
	decide on B.

To compute (M - a gladiator) hurting (B - a body part):[as her weapon increases in quality, so does her damage]
	let D be the difficulty of M - the starting difficulty of M;
	if D < 1 or M is swordless:
		BodyRuin 1;
	otherwise if D < 2:
		BodyRuin a random number between 1 and 2;
	otherwise:
		BodyRuin 2.

To compute (M - a gladiator) hurting (B - breasts):
	let D be the difficulty of M - the starting difficulty of M;
	if M is swordless:
		BodyRuin 1;
	otherwise if D < 1:
		BodyRuin a random number between 1 and 2;
	otherwise if D < 2:
		BodyRuin a random number between 2 and 3;
	otherwise:
		BodyRuin 3.

To compute (M - a gladiator) hurting (F - face):
	compute M hurting breasts.

To compute damaging attack of (M - a gladiator):
	let C be nothing;
	if M is swordless:[pretty much only the enlightened gladiator]
		now C is a random worn stealable equippable;
		if C is clothing and a random number between 1 and 7 is 1:
			compute disarming attack of M;
		otherwise:
			compute striking attack of M;
	otherwise:
		now C is a random worn nipple covering bra;
		if C is clothing and the coverer of C is nothing and the difficulty of M > the starting difficulty of M and a random number between 1 and 7 is 1:
			compute shredding attack of M;
		otherwise:
			compute striking attack of M.

To compute disarming attack of (M - a gladiator):
	let E be a random worn slap ready equippable;
	unless E is clothing, let E be a random worn zap ready equippable;
	say "[speech style of M]'[one of]Fight me barehanded, coward!'[or]Weapons are useless against a true woman! I'll show you!'[or]You can't defeat me with such a pitiful weapon!'[in random order][roman type][line break][BigNameDesc of M] tries to grab you!";
	if the accuracy roll of M >= the dexterity of the player:
		say "[big he of M] catches your wrist with one hand and uses the other to try and pry the [printed name of E] out of your grip!";
		if the strength roll of M >= the strength of the player:
			if E is pink-spraybottle:
				compute E breaking;
			otherwise:
				say "You aren't strong enough to fight off [his of M] grip, and a moment later, your [printed name of E] clatters across the floor.";
				now E is in the location of the player;
		otherwise:
			say "You quickly fight off [his of M] grip and shove [him of M] away.";
	otherwise:
		say "You get away before [he of M] catches you.".

To compute shredding attack of (M - a gladiator):
	let B be a random worn nipple covering bra;
	say "[speech style of M]'[one of]Enough of this! Your womanhood must be free!'[or]I can watch no longer! Your breasts must be freed![or]Enough! Your chest must be freed at once!'[in random order][roman type][line break][BigNameDesc of M] tries to grab you!";
	if the accuracy roll of M >= the dexterity of the player:
		say "You aren't fast enough to avoid [him of M] seizing your bra by the front and slicing through it with [his of M] sword! Your [ShortDesc of breasts] jiggle free!";
		destroy B;
	otherwise:
		say "You're just fast enough to avoid getting caught in [his of M] grip!".

To decide which number is (M - a gladiator) pierce success: [0 means failure, 2 means success.]
	if the player is a flatchested trap, decide on 0;
	let N be a random nipple chain;
	if N is off-stage:
		say "[BigNameDesc of M] harrumphs.[line break][speech style of M]'Your breasts [if the breast-happy of M is 1]are an acceptable size now, I guess[otherwise]won't seem to grow any larger than that. How disappointing. I guess that will have to do then[end if]. Just one more thing to add...'[roman type][line break]";
		repeat with O running through worn actually nipple covering clothing:
			if M is swordless, say "[BigNameDesc of M] tears off your [O]! It is completely destroyed.";
			otherwise say "[BigNameDesc of M] uses [his of M] [SwordDesc of M] to slice up your [O]! It is completely destroyed.";
			destroy O;
		if N is actually summonable:
			say "[BigNameDesc of M] closes [his of M] eyes and whistles a quick tune. [if there is a worn cow piercing]You can't believe your eyes as a gold chain appears to connect your nipple rings![otherwise]You can't believe your eyes as two piercings sear into existence through your nipples. You cry in pain as the feeling hits you, and it takes you a moment to notice that [NameDesc of M] has attached a chain between your two now extremely sensitive pierced nipples.[end if][line break]After admiring [his of M] handiwork, [NameDesc of M] seems happy and loses interest.";
			PainUp 1;
			repeat with P running through worn cow piercings:
				destroy P;
			summon N cursed with persistent quest;
			bore M;
			FavourUp M;
			decide on 2;
		otherwise:
			say "[speech style of M]'What the hell?! Something is stopping me from applying this nipple chain!!! (please report bug to Aika)'[roman type][line break]";
			decide on 0;
	otherwise:
		decide on 0.

To compute post climax effect of (M - a gladiator) in (F - a fuckhole):
	if M is not wild gladiator and M is not enlightened gladiator:
		compute M sleeping 200 after sex.

To decide if (M - a gladiator) is willing to creampie (F - vagina):
	if there is a worn sword and the largeness of breasts > 5, decide yes;[if she sees you as a proper warrior, she'll definitely seed you]
	if the reaction of the player is 2, decide no;
	otherwise:
		if the openness of vagina <= a random number between 2 and 7, decide yes;
		decide no.

To decide if (M - a gladiator) is willing to creampie (F - asshole):
	if the reaction of the player is 2 and a random number between 1 and the charisma of the player > 1, decide no;
	decide yes.

To get creampie image of (M - a gladiator) in (F - vagina):
	cutshow figure of gladiator cutscene 3 for M.

To get creampie image of (M - a gladiator) in (F - asshole):
	cutshow figure of gladiator cutscene 4 for M.

To get clean pull out image of (M - a gladiator) in (F - a fuckhole):
	cutshow figure of gladiator cutscene 6 for M.

To compute (M - a gladiator) messily pulling out of (F - a fuckhole):
	get messy pull out image of M in F;
	say MessyPullOutFlav of M in F;
	CumFaceUp the semen load of M;
	say "[big he of M] loses interest.";

To compute (M - a gladiator) cleanly pulling out of (F - a fuckhole):
	get clean pull out image of M in F;
	say PullOutFlav of M in F;
	SemenPuddleUp the semen load of M;
	say "[big his of M] eyes roll back, and after a long sigh of relief, [he of M] slumps over and falls asleep.";
	compute M sleeping 100 after sex.

To say CondomAcceptFlav of (M - a gladiator):
	say "[BigNameDesc of M] [one of]smiles disgustedly[or]laughs humourlessly[or]scoffs[at random] and takes a condom. Discarding the wrapper, [he of M] rolls it down the length of [his of M] [DickDesc of M]. You stare[one of] [if the semen taste addiction of the player > 13]hypnotised, eagerly licking your lips[otherwise if the semen taste addiction of the player > 6]hypnotised, unconsciously licking your lips[otherwise]disgustedly, curling your upper lip[end if].[or], unable to [if the sex addiction of the player < 13 and the sex addiction of the player > 6]bring yourself to [end if]look away[or], your mouth opening unconsciously[or] [if the sex addiction of the player < 7]unexcitedly[otherwise]enviously[end if] as the rubber makes intimate contact with every inch of the massive tool[or] as the gleaming latex makes every bump and vein glisten [if the sex addiction of the player < 7]unappealingly[otherwise]temptingly[end if][at random].".

To decide which number is the condom resistance of (M - a gladiator):
	if the player is not possessing a vagina or pregnancy fetish is 0, decide on 3;[she'd rather not impregnate a whore, but if there's no risk she's more interested in degrading you as much as possible.]
	if M is mating, decide on -2;
	decide on 0.

To say CondomRejectFlav of (M - a gladiator):
	say "[speech style of M][one of]Ha. As if you deserve even that.[or]You are in no position to be asking favours of me, whore.[or]I will fuck you as I [please]. You deserve nothing more.[at random][roman type][line break][if M is not seduced]Looks like [he of M][']s going in bare...[end if]".

To say CondomPieFlav of (M - a gladiator) in (F - a fuckhole):
	say "[one of][BigNameDesc of M] roars with pleasure, tightening [his of M] grip as the condom begins to fill up with warm [semen].[line break][speech style of M]'[if lady fetish < 2]That actually felt... pretty... amazing[otherwise]That actually wasn't...so...bad[end if]...'[roman type][line break]You hear a sigh as [he of M] pulls out, a *snap* as [he of M] pulls the condom off, and a soft thump as [he of M] immediately falls over, asleep.[or][BigNameDesc of M] grunts, [his of M] [DickDesc of M] throbbing as it unloads into the surprisingly stretchy latex condom. [big he of M] sighs in satisfaction, pulling out and drowsily peeling it off before slumping over, asleep.[or][line break][speech style of M]'Haahh... hahhh... HAAAAH!'[roman type][line break]You're used to this series of events by now, and find yourself clenching around [NameDesc of M][']s [DickDesc of M] as the condom catches several jets of [semen]. You wait expectantly, and after a few seconds [he of M] pulls out, removing the condom before immediately falling asleep.[then at random]";

To decide if (M - a gladiator) is losing wrapper in (F - a fuckhole):
	if the player is getting unlucky, decide yes;
	decide no.

To compute condom failure of (M - a gladiator) in (F - a fuckhole):
	get condom failure image of M in F;
	say CondomFailFlav of M in F;
	say GotUnluckyFlav;
	now M is unwrapped;
	if M is wild gladiator or M is enlightened gladiator:[gladiators on upper levels give you the full amount]
		compute M finishing in F;
	otherwise: [in the dungeon, failed condoms are less severe]
		if F is asshole, AssFill 1;
		otherwise PussyFill 1;
	say CreampieReactionFlav to M in F.

To say CondomFailFlav of (M - a gladiator) in (F - a fuckhole):
	say "[BigNameDesc of M] roars with pleasure, tightening [his of M] grip as warm [semen] begins flooding into you. [if the semen addiction of the player < 5]You immediately realize something is wrong, and thankfully [he of M]'s already begun[otherwise if the semen addiction of the player < 11]It takes you a split second to realize something is wrong, but luckily [he of M]'s already noticed and begun[otherwise]You're so in love with the feeling of taking [his of M] hot load that you don't realize something is wrong until [he of M] suddenly starts[end if] to pull out. You look down to see the remains of the condom bunched up around the base of [his of M] [DickDesc of M], which [one of]is still slightly connected to your [variable F] by a strand of [semen][or]is currently dripping fresh [semen][or]throbs visibly as the rest of [his of M] load dribbles down [his of M] bare shaft[in random order][line break][speech style of M]'[one of]Oh... well...'[or]I shouldn't have... stopped...'[or]I should have... kept going...'[in random order][roman type][line break][big he of M] snarls at you as [he of M] slumps over and immediately falls asleep.".

To say CreampieFlav of (M - a gladiator) in (F - a fuckhole):
	say "[one of][BigNameDesc of M] roars with pleasure, tightening [his of M] grip as warm [semen] begins flowing inside of you. [big he of M] continues fucking you until [his of M] lust as been completely and thoroughly emptied into your [variable F].[line break][speech style of M]'I'm sleepy...'[roman type][line break]You feel [his of M] hands leave your hips as [he of M] pulls out and falls over, asleep.[or][BigNameDesc of M] grunts, [his of M] [DickDesc of M] throbbing as [he of M] unloads into your [variable F]. [big he of M] sighs in satisfaction, roughly shoving you off [his of M] [DickDesc of M] before slumping over, asleep.[or][line break][speech style of M]'Haahh... hahhh... HAAAAH!'[roman type][line break]You're used to this series of events by now, and find yourself clenching around [NameDesc of M][']s [DickDesc of M] as [he of M] shoots several jets of [semen] deep inside you. You wait expectantly, and then after a few seconds feel and hear [him of M] slump to the ground, asleep.[then at random]".

To say CreampieFlav of (M - wild gladiator) in (F - a fuckhole):
	say "[one of][BigNameDesc of M] roars with pleasure, tightening [his of M] grip as warm [semen] begins flowing inside of you. You feel [his of M] hands leave your hips, followed by a gentle slap on your [AssDesc] as [he of M] pulls out.[line break][speech style of M]'Recover. I will return when you are ready for more.'[roman type][line break][or][BigNameDesc of M] grunts, [his of M] [DickDesc of M] throbbing as [he of M] unloads into your [variable F]. [big he of M] sighs in satisfaction, slapping your [AssDesc] as [he of M] pulls out and climbs to [his of M] feet.[or][line break][speech style of M]'Hah... haaaaahhh...'[roman type][line break]You're used to this series of events by now, and find yourself clenching around [NameDesc of M][']s [DickDesc of M] as [he of M] shoots off several powerful jets of [semen] deep inside you. [big he of M] sighs contentedly, nibbling your ear before pulling out and getting to [his of M] feet.[then at random]".

To say MessyPullOutFlav of (M - a gladiator) in (F - a fuckhole):
	say "[if the number of monsters penetrating an orifice > 1][one of][BigNameDesc of M] pulls out abruptly, seizing you by the hair and wrenching your face toward [him of M].[or][BigNameDesc of M] grabs you by the hair, twisting your face toward [him of M] as [he of M] pulls out.[at random][otherwise][one of][BigNameDesc of M] pulls out and flips you over, snarling as [he of M] climbs on top you.[or][BigNameDesc of M] pulls out, flips you over, and kneels over your face.[at random][end if][line break][speech style of M]'[one of]Wear it, whore!'[or]I'll mark your face, whore!'[or]They will know when they see your face, whore!'[or]They will understand when they see your face, whore!'[in random order]'[roman type][line break][big he of M] rapidly pumps [his of M] [one of]throbbing[or]swollen[or]big[at random] [DickDesc of M], [one of]practically shivering with pleasure[or]holding back [his of M] moans[or]obviously trying not to moan[at random] as [he of M] [one of]ejaculates all over your face[or]unloads all over your face[or]paints your face with a hot, sticky load[or]blasts your face with several ropes of fresh, sticky [semen][in random order].".

To say PullOutFlav of (M - a gladiator) in (F - a fuckhole):
	say "[one of][BigNameDesc of M] pulls out abruptly, gasping with pleasure as [he of M] paints the floor with fresh, sticky [semen].[or][BigNameDesc of M] suddenly pushes you off, emitting several badly stifled moans as [he of M] shoots [his of M] load all over the floor.[at random][line break][speech style of M]'[one of]I... spared you... THIS time.'[or]I decided... not to... waste my cum.'[or]I decided against it... just this... once.'[or]Just this... once, I... spared you.'[at random][roman type][line break]".

To say angry punishment insult of (M - a gladiator):
	if M is wild gladiator:
		say "[speech style of M]'How disrespectful...'[roman type][line break]";
	otherwise if M is enlightened gladiator:
		say "[BigNameDesc of M] snarls.[line break]";
	otherwise:
		say "[speech style of M]'You still wish to test my wrath?!'[roman type][line break]".

To say angry punishment clothing destruction of (M - a gladiator) on (C - a clothing):
	if player-fucking is not DOMINANT-FAILURE:
		say "[first custom style]'[if C is actually breast covering and the largeness of breasts > 3]Maybe now you will act with more honour, whore!'[otherwise if C is ass covering]Display your [fuckholes] to everyone, like the true whore you are.'[otherwise]Clothes are merely a crutch for honorless women like you!'[end if][roman type][line break]".

To say angry punishment accessory confiscation of (M - a gladiator):
	say "[first custom style]'This belongs to me now.'[roman type][line break]".

To compute (M - a gladiator) entering breasts:
	say "[speech style of M]'[one of]Hmm, I guess it's fate that things turned out this way, hmm?'[or]See? There are so many uses for big breasts!'[or][if the player is gendered male and the times-dominated of M > 0]It's fun to be on the giving end, wouldn't you agree?[otherwise]Personally, I prefer to be on the giving end[end if].[then at random][roman type][line break][if the titfuck addiction of the player < 5]You hold your body still and try to think of other things as [NameDesc of M] slides [his of M] [DickDesc of M] between your [BreastDesc][otherwise]You massage [his of M] [DickDesc of M] with your [BreastDesc], moving them with your hands as fast and powerfully as you can[end if]. It must be [his of M] obsession with breasts, because it isn't long until [he of M] climaxes, moaning as [he of M] sprays [his of M] [semen] all over your tits.";
	AnnouncedSquirt semen on breasts by the semen load of M;
	BreastsSensitivityUp 1;
	say "[speech style of M]'Don't... expect... *huff*... this much generosity... *huff*... next time.'[roman type][line break]";
	TimesSubmittedUp M by 1;
	Orgasm bore M.

To compute (M - wild gladiator) entering breasts:
	say "[speech style of M]'[one of]That is right. When you are in my jungle, your breasts belong to me, and to me alone'[or]You want me to mark your breasts? Ha. I'd expect no less.'[or]Good idea.'[stopping][roman type][line break][if the titfuck addiction of the player < 5]You hold your body still and try to think of other things as [NameDesc of M] slides [his of M] [DickDesc of M] between your [BreastDesc][otherwise]You massage [his of M] [DickDesc of M] with your [BreastDesc], moving them with your hands as fast and powerfully as you can[end if] until [he of M] tells you to stop.[line break][speech style of M]'Here. It... comes!'[roman type][line break][BigNameDesc of M] growls with pleasure as [he of M] blows [his of M] load all over your tits, surprising you with both its volume and coverage.";
	AnnouncedSquirt semen on breasts by (the semen load of M) + 2;
	BreastsSensitivityUp 1;
	FavourUp M by 2;
	TimesSubmittedUp M by 1;
	Orgasm bore M.

To say TwosomePrep of (M - a gladiator) in (F - vagina):
	say "[BigNameDesc of M] emits a hungry growl as [his of M] positions [his of M] [LongDickDesc of M] in front of your [vagina] with one hand.".

To say PrepTaunt of (M - a gladiator) in (F - vagina):
	say "[speech style of M]'[one of]Is this situation familiar to you, whore? If not, it will be.'[or]Womanhood is wasted on you, whore, but it will not be wasted on me.'[or]The shame only begins from here.'[or][if tg fetish is 0]I will desecrate this hole in the same way you desecrate the gift of womanhood.'[otherwise]Since you did not want my womanhood, perhaps I will take yours.'[end if][or]A woman without virtue is unfit to be anything but a vessel for my seed.'[or]There is no punishing whores like you, but I will try.'[or]It's over. You won't have dignity to speak of when I am through with you.'[in random order][roman type][line break]".

To say VaginalVirginityTaunt of (M - a gladiator):
	say "[line break][speech style of M]'[one of]A virgin? Hmmph.'[or]I am your first? Hmmph.'[or]I am no man. You will enjoy your first.'[at random][roman type][line break]".

To say VeryTightVaginaPenetrationFlav of (M - a gladiator):
	say "[if the vaginal sex addiction of the player < 3]You tremble with humiliation as [he of M] slowly slides in, and you feel yourself stretching to accept [his of M] thick, veiny rod[otherwise if the vaginal sex addiction of the player < 6]You tremble with reluctant excitement as [he of M] slowly slides in, and you feel yourself stretching to accept [his of M] thick, veiny rod, the nigh-painful stretching sensation sending a thrill of illicit pleasure through you[otherwise]You shiver with excitement as you feel [him of M] sliding in, and you feel yourself stretching to accept [his of M] thick, veiny rod, the painful stretching sensation sending a wonderful thrill of pleasure up your spine[end if]. [one of]Every feminine hiss and groan of pleasure coming from behind you lets you know how intense it feels for [him of M], and you [if the vaginal sex addiction of the player < 3]grit your teeth as you endure[otherwise]bite your tender lips as you concentrate on[end if] inch after inch of thick, throbbing [DickDesc of M] sinking into your vice-tight hole[or][big his of M] grunts and moans make it quite clear [he of M]'s enjoying [himself of M], audible evidence of [his of M] pleasure as [he of M] slowly works inch after inch of throbbing [DickDesc of M] into your vice-like slit[at random]. [one of][big he of M] hisses in satisfaction as [he of M] bottoms out, and [his of M] soft, yet strong hands locking you into place.[or][big his of M] soft, yet powerful hands firmly grip your hips as [he of M] pins your [vagina] against the base of [his of M] shaft, finally bottoming out.[at random]".

To say LessTightVaginaPenetrationFlav of (M - a gladiator):
	say "[if the vaginal sex addiction of the player < 3]You stifle a moan of pleasure as [he of M] guides [his of M] shaft into your defenceless sex. [big he of M] places [his of M] hands on your hips, emitting a satisfied breath as [he of M] drives inch after awful inch of thick [DickDesc of M] through the shamefully swollen and slick lips of your labia. [big his of M] grip tightens as [he of M] bottoms out, assuring you that you're in for a long, rough fuck.[otherwise if the vaginal sex addiction of the player < 6]You moan in pleasure, fighting the urge to push back against [him of M] as [he of M] guides [his of M] shaft into your receptive and waiting sex. [big he of M] places [his of M] hands on your hips, steadily forcing inch after throbbing inch of [his of M] thick [DickDesc of M] through the slick lips of your labia. [big his of M] grip tightens as [he of M] bottoms out, assuring you that you're in for a good, rough fuck.[otherwise]You emit a lust-thickened moan as [he of M] guides [his of M] shaft into your hungry sex. [big he of M] grabs your hips, driving inch after throbbing inch of [his of M] thick [DickDesc of M] your slick labia lips. [big his of M] grip tightens as [he of M] bottoms out, assuring you that you're in for the good, rough fuck you so desperately deserve.[end if]".

To say LessLooseVaginaPenetrationFlav of (M - a gladiator):
	say "[if the vaginal sex addiction of the player < 3]You whimper softly in pleasure, shamefully lowering your head as [his of M] shaft slides in. Each moment of [his of M] slow, but forceful penetration makes you feel more ashamed, and you realise the reason [he of M] moving so relentlessly slowly is just to draw out that point. Every inch of [his of M] thick [DickDesc of M] drives home [his of M] victory, until at last [he of M] bottoms out, and [his of M] soft, yet implacably strong hands tighten their grip. Looks like you're in for the long haul.[otherwise if the vaginal sex addiction of the player < 6]You try not to push back against [him of M], unable to keep from mewling in pleasure as [his of M] shaft slides in. Your slick, lubricated channel makes a mockery of your resistance by eagerly opening up to its invader, and forces out a low, defeated croon of pleasure from your lips. It doesn't take long for [him of M] to bottom out, the feeling of [his of M] long rod reaching deeply up inside you, pinning you in place like a fluttering butterfly somehow delighted by its own impalement. You feel [his of M] strong, yet soft hands gripping your hips tightly. You won't be getting away now![otherwise]You push back against [him of M], shamelessly moaning in pleasure as [his of M] shaft finally slides into your welcoming sex. All too soon, [his of M] length bottoms out, but then you feel two soft, yet powerful hands clamp your hips in place You won't be getting away now, Hee hee![end if]".

To say VeryLooseVaginaPenetrationFlav of (M - a gladiator):
	say "[if the vaginal sex addiction of the player < 3]You try to clench your muscles down there, trying to close yourself, to seal off the slick, vulnerable opening between your legs. But is no use. The receptacle being probed by the blunt head of [his of M] shaft has been [italic type]designed[roman type] to yield to it, no matter what your wishes on the subject might be. You let out a completely involuntary moan as [his of M] [DickDesc of M] slides into your desperately clenching [vagina] like a knife through butter, immediately bottoming out. [big he of M] grins as you look over your shoulder, horrified at the sound that just came out of your own mouth. Strong, soft hands pin your hands in place, the strength of [his of M] grip assuring you that [he of M] isn't about to turn back.[otherwise if the vaginal sex addiction of the player < 6]You let out a somewhat involuntary moan of pleasure as [his of M] shaft slides in like a knife through butter, immediately bottoming out. [big he of M] grins as you look over your shoulder, embarrassed at how good that felt, yet hungry for more. [big his of M] strong, soft hands grab your hips tightly, the strength of [his of M] grip assuring you that your hunger will be sated.[otherwise]You shamelessly moan in pleasure as [his of M] shaft slides in like a knife through butter, immediately bottoming out. [big he of M] grins as you look over your shoulder, licking your lips in hopes that [he of M]'ll give you the roughest fucking [he of M] can. Strong, soft hands grab your hips tightly, the strength of [his of M] grip assuring you're about to get the sex you're so eager for.[end if]".

To say AnalVirginityTaunt of (M - a gladiator):
	if the times-submitted of M > 2 and the player is gendered male:
		say "[line break][speech style of M]'[one of]You took me like this before, so it's only fair I have you this way too.'[or]Does this feel familiar, whore?'[or]You were my first, too. I'm going to enjoy this.'[at random][roman type][line break]";
	otherwise if the player is gendered male:
		say "[line break][speech style of M]'[one of]This is my first time too. I'll enjoy this.'[or]I have never had a male this way before. This will be fun.'[or]Now, you will always remember me.'[at random][roman type][line break]".

To say SpitroastPrep of (M - a gladiator) with (O - a monster) in (F - asshole):
	say "[BigNameDesc of M] yanks your hips toward [him of M], [one of]gagging you[or]making sure you gag on[at random] on the [O] as [he of M] grabs hold of your waist.";

To say TwosomePrep of (M - a gladiator) in (F - asshole):
	say "[one of][BigNameDesc of M] shoves you down, smacking your [AssDesc] and tweaking your nipples as [he of M] grabs hold of your waist.[or][BigNameDesc of M] [unless M is swordless]tosses [his of M] sword aside and [end if]pulls your hips up against [his of M] body, rubbing [his of M] cock between your cheeks as [he of M] grabs hold of your waist.[or][BigNameDesc of M] locks [his of M] hands around your waist, rubbing [his of M] cock between your [AssDesc] as [his of M] nipples dig into your back.[or][BigNameDesc of M] kneels over you, grazing your neck with [his of M] [ChestDesc of M] as [he of M] spreads your [AssDesc] apart and grabs hold of your waist.[at random]";

To say PrepTaunt of (M - a gladiator) in (F - asshole):
	say "[speech style of M]'[one of]This is supposed to be a punishment, so I'll make sure that it hurts.'[or]You should not have angered me. You will feel why.'[or]Your most delicate hole is mine for the taking.'[or]This will hurt.'[or][if the player is gendered female]You don't deserve to be called a woman. I will not fuck you like one.'[otherwise]Since you did not want womanhood, perhaps you will like manhood'[end if][or]I will make sure you don't enjoy this, whore.'[or]I think I will enjoy punishing you.'[or]It's over. You won't have dignity to speak of when I am through with you.'[in random order][roman type][line break]".

To get failed facial dodge image for (M - a gladiator):
	cutshow figure of gladiator cutscene 10 for M.

To say FailedFacialDodge of (M - a gladiator):
	say "[first custom style]'[one of]Not today[or]Not this time[or]Nice try[or]Get back here[in random order], [one of]cretin[or]scum[or]loser[in random order]!'[roman type][line break][one of][BigNameDesc of M] grabs your head and holds you still, emptying [his of M] load all over your face![or][BigNameDesc of M] manages to grab you again, holding you still as [he of M] ejaculates all over your face.[or][BigNameDesc of M] cackles as [he of M] holds your head and blasts it with a rather inhuman amount of [semen].[or]Your lips make a loud [italic type]pop[roman type] as [NameDesc of M] suddenly pulls out and begins to cum all over your mouth and nose. By the time [he of M] has finished painting your face, it is rather thoroughly coated in warm [semen].[in random order]".

To get facial accepting image for (M - a gladiator):
	get failed facial dodge image for M.

To say UnavoidedFacial of (M - a gladiator):
	say "[first custom style]'Wear this as a [one of]mark of your disgrace[or]reminder of your loss[or]token of your defeat[in random order], [one of]weakling[or]you has-been[in random order]!'[roman type][line break][one of]Pulling out, [NameDesc of M] holds you still as [he of M] rope after rope of [semen] onto your face![or][BigNameDesc of M] pulls out of your mouth and lets [his of M] [semen] coat your [if the oral sex addiction of the player > 7]smiling [otherwise if the oral sex addiction of the player < 5]frowning [end if]visage.[or][BigNameDesc of M] cackles as [he of M] holds your head and blasts it with a rather inhuman amount of [semen].[or]If you thought you were escaping a final humiliation you were very mistaken, as you feel a warmth hit your face as the first of several ropes of [semen] lands on it. By the time [NameDesc of M] has finished painting your visage, it is rather thoroughly coated in warm [semen].[in random order]".

To say DefaultDeepthroatDeclaration of (M - a gladiator):
	say "[first custom style]'[one of]Open your throat for my load[or]Choke on your punishment[or]Revenge is a dish best served warm and salty. Now gag on my shaft[or]Accept your defeat[in random order], [one of]cretin[or]scum[or]loser[in random order]!'[roman type][line break]";
	cutshow figure of gladiator cutscene 8 for M.

To say DefaultDeepthroatCreampie of (M - a gladiator):
	say "[one of][BigNameDesc of M] tightens [his of M] grip, cackling vindictively as [he of M] cums straight down your throat.[or][BigNameDesc of M][']s [DickDesc of M] throbs powerfully, firing off load after load of warm [semen] down your throat. [or][BigNameDesc of M] forces you all the way down, growling with triumph as [he of M] ejaculates straight down your throat.[or][BigNameDesc of M] buries [his of M] [DickDesc of M] as far into your mouth as it will go, jet after jet of [semen] pinging into the back of your throat.[or][BigNameDesc of M] forces [his of M] length down your throat, groaning as [he of M] fills your belly with a decent load.[or][BigNameDesc of M] forces you to take [his of M] [DickDesc of M] all the way to the hilt. You can do nothing but wait helplessly as [he of M] pumps [his of M] load directly into your belly.[in random order]".

To say AutomaticSwallow of (M - a gladiator):
	cutshow figure of gladiator cutscene 9 for M;
	say "[one of][if the semen taste addiction of the player < 6]You are so surprised that you find yourself swallowing before you can even properly process what is happening.[otherwise if the semen taste addiction of the player < 10]You swallow it all, telling yourself it's because you don't want to piss [him of M] off any further.[otherwise]You swallow it all, appeasing both [NameDesc of M] and your taste buds.[end if][or][if the semen taste addiction of the player < 6]Despite the fact that every fibre of your being tells to spit, you find yourself swallowing every last drop.[otherwise if the semen taste addiction of the player < 10]You swallow every last drop, desperately insisting to yourself that it was because you were thirsty.[otherwise]You swallow every last drop, knowing full well that if you really wanted something else to drink, you would have looked harder.[end if][in random order]".

This is the gladiator forces the player to pee rule:
	if the player is diaper focused:
		compute punishment of gladiator-forced-pee;
		rule succeeds.
The diaper punishment rule of a gladiator is usually the gladiator forces the player to pee rule.

To say GroundPeeReaction of (M - a gladiator):
	say "[speech style of M]'[if M is unfriendly]Just as I expected[otherwise]And to think that I had respect for you[end if]. [if diaper quest is 1][one of]You need to be kept in diapers.'[or]You're a big baby who can't get to the toilet in time.'[or]You need help.'[in random order][otherwise][one of]You still have a lot to learn about how to act in a distinguished manner.'[or]You still exhibit many uncouth behaviours that you need beating out of you!'[or]Nobody would ever be able to mistake you for a noble!'[in random order][end if][roman type][line break]";
	if diaper quest is 1:
		now M is diaper-committed;
		now M is interested;
		if M is friendly:
			anger M;
			say BecomesAggressive of M;
	otherwise:
		FavourDown M with consequences.

To set up sex length of (M - a gladiator) in (B - penis):
	let N be 5;
	decrease N by the size of penis / 3;
	set up sex length N of M in B.

[Remember: this DOES NOT show up if the player already has an erection]
To say ErectionDemand of (M - a gladiator):
	if M is friendly-fucking or presented-orifice is penis:
		say "[line break][speech style of M]'[one of]Now then...show me your weapon.'[or]Now. Let me see your weapon.'[or]Wait, you don't seem ready. Where is your weapon?'[or]Now, are you prepared? I do not see your weapon.'[at random][roman type][line break][BigFuckerDesc of M] looks down at your crotch expectantly...";
	otherwise:
		say "[line break][speech style of M]'[one of]You have lost. Present your weapon.'[or]You are defeated. Now, prepare your sword.'[or]Hmph, too easy. Now then, I wish to test your sword.'[or]I tire of these games. Show me your weapon.'[at random][roman type][line break][BigFuckerDesc of M] looks down at your crotch expectantly...".

To say ErectionPenetrationFlav of (M - a gladiator):
	if the size of penis > 8:
		say "[BigFuckerDesc of M][']s eyes [if penis is penis-erect]widen as [his of M] gaze finds your [ShortDesc of penis][otherwise]remain glued to your [ShortDesc of penis] as it slowly grows to its full size[end if], and you can see [his of M] nipples hardening as [he of M] unclips [his of M] loincloth and leaps on top of you. [big he of M] eagerly strokes your shaft with one hand and [if M is male]pumps [his of M] [LongDickDesc of M] with the other[otherwise if lady fetish is 2]fingers [his of M] [asshole] with the other[otherwise]spreads [his of M] enticingly wet labia lips with the other[end if]. [big his of M] eyes lock with yours as [he of M] eases your [player-penis] into [his of M] [HoleDesc of M].";
	otherwise:
		say "[if penis is penis-erect]Seeing your erection, [FuckerDesc of M] unclips [his of M] loincloth, straddling you with a haughty expression on [his of M] face[otherwise][Big he of M] watches haughtily as your [ShortDesc of penis] slowly grows to hardness, unclipping [his of M] loincloth as [he of M] straddles you[end if]. [big he of M] grasps your [ShortDesc of penis] from the base, [if M is male]lifting [his of M] [DickDesc of M] out of the way as [he of M] guides your shaft into [his of M] [asshole][otherwise if lady fetish is 2]holding [his of M] metal cage out of the way as [he of M] eases your shaft into [his of M] asshole[otherwise]delicately spreading [his of M] labia with [his of M] fingers as [he of M] eases your shaft into [his of M] pussy[end if].".

To compute unerect taunting of (M - a gladiator):
	if M is male:
		say "[big his of M] eyes remain glued to your crotch, [his of M] lips slowly curling into a smirk. No matter how much time passes, you remain completely soft, and [his of M] [LongDickDesc of M] gets ever harder and more ready.[line break][speech style of M]'[one of]If you're intimidated, you should be.'[or]This is only the beginning of the shame you will taste today.'[or]In that case, I will use MY blade.'[or]Even if you are unarmed, I will show no mercy.'[at random][roman type][line break][big his of M] shaft bobs tauntingly as [he of M] drags you onto your hands and knees.";
		now chosen-orifice of M is asshole;
		now another-turn-flavour is the substituted form of "[BigFuckerDesc of M] holds you in place.";
		now another-turn is 1;
	otherwise:
		say "[big he of M] waits for several seconds, but your [player-penis] remains completely soft. Your cheeks burn with shame as [his of M] lips curl up into a smirk.[line break][speech style of M]'[one of]How unexpected.'[or]I am surprised. Can you tell?'[or]How shocking.'[at random][roman type][line break]";
		strongHumiliate;
		Bore M.

To say ErectionForceFlav of (M - a gladiator):
	say "[one of][BigFuckerDesc of M]'s [if M is male][DickDesc of M] jiggles[otherwise if lady fetish is 2]cage jiggles[otherwise]breasts jiggle[end if] as [he of M] aggressively bounces on your [player-penis].[or][BigFuckerDesc of M] skilfully massages your [player-penis] with [his of M] powerful inner muscles as [he of M] rides you.[or][BigFuckerDesc of M][']s [if M is male][DickDesc of M] jiggles[otherwise if lady fetish is 2]cage jiggles[otherwise]breasts jiggle[end if] as [he of M] forcefully slams [his of M] hips down into you.[or][BigFuckerDesc of M] grunts with effort as [he of M] drives your [ShortDesc of penis] in and out of [his of M] [HoleDesc of M].[or]Your [ShortDesc of penis] slides in and out of [FuckerDesc of M][']s [HoleDesc of M] as [he of M] forcefully slams [his of M] hips down into you.[in random order]".

To say ErectionUseFlav of (M - a gladiator):
	say ErectionForceFlav of M.

To compute erection orgasm of (M - a gladiator):
	say "[BigNameDesc of M] gives you a knowing look as your [ShortDesc of penis] begins to throb, bringing [his of M] hips down decisively as you explode, forcing you to deposit every drop of your [semen] deep inside [his of M] [HoleDesc of M].";
	now penis is not penis-erect.

To say ErectionLostFlav of (M - a gladiator):
	if M is unfriendly:
		say "[BigFuckerDesc of M] laughs coldly as your softening [ShortDesc of penis] slips out of [his of M] [HoleDesc of M].[line break][speech style of M]'[one of]How pitiful.'[or]Ha. I expected nothing more.'[or]Too easy.'[at random][roman type][line break][big he of M] climbs off you without another word immediately loses interest.";
	otherwise:
		say "[BigFuckerDesc of M] smiles as your as your softening [ShortDesc of penis] slips out of [his of M] [HoleDesc of M].[line break][speech style of M]'[one of]It is my victory.'[or]It seems you have lost this battle.'[or]I accept your surrender.'[at random][roman type][line break][big he of M] climbs off you and immediately loses interest.";
	FavourDown M by 1;
	Bore M;
	now the sex-length of M is 0.

To say ErectionNearingClimaxFlav of (M - a gladiator):
	say "[one of][BigFuckerDesc of M] grits [his of M] teeth, moving riding you with more and more urgency[or][BigFuckerDesc of M] silently bites [his of M] lip, riding you with more and more vigour[or][BigFuckerDesc of M] begins to breathe more quickly, [his of M] eyes crossing as [his of M] hips begin to move even faster[at random]. [big he of M] must be close!".

To say ErectionClimaxFlav of (M - a gladiator):
	say "[BigFuckerDesc of M] forcefully drops [his of M] hips, [one of]moaning heavily[or]groaning with pleasure[or]emitting a throaty roar[at random] as [his of M] [HoleDesc of M] clamps down around you. [if M is male][big his of M] [LongDickDesc of M] bounces, shooting long ropes of [semen] across your belly[otherwise if lady fetish is 2]Fresh [semen] slowly dribbles out of [his of M] cage, forming a small puddle on your belly[otherwise][big his of M] thighs quiver[end if] as climax crashes over [his of M] muscular body. For a moment, [his of M] haughty expression crumbles into one of unguarded pleasure, but [FuckerDesc of M] recovers by the next moment and stands up without looking at you again.";
	orgasm M;
	Calm M;
	FavourUp M by 1.

Section 2 - DQ

gladiator-forced-pee is a diaper punishment. The priority of gladiator-forced-pee is 5.
Definition: a gladiator-forced-pee (called P) is appropriate:
	if current-monster is not gladiator, decide no;
	if there is a worn diaper or current-monster is diaper-committed or there is worn dirty knickers, decide no;
	decide yes.

To compute punishment of (P - gladiator-forced-pee):
	let M be current-monster;
	say "[speech style of M]'[if diaper quest is 1]Are you sure you don't need diapers? You might need to pee at any moment...'[otherwise]A grown woman should not be wearing a child's underwear. You should be able to control your own bodily functions.'[end if][roman type][line break]Rolling you over slightly, [he of M] pushes a knee into your side, where your bladder is, crushing it painfully.";
	PainUp 1;
	if the bladder of the player < 6:
		say "[if the bimbo of the player < 8]Luckily you[otherwise]You[end if] don't need to go, and so [he of M] doesn't manage to force you to wet yourself.[line break][speech style of M]'Hmph, I guess you got lucky this time.'[roman type][line break]";
		satisfy M;
	otherwise:
		say "The weight of [NameDesc of M][']s knee forces you to start wetting yourself!";
		now delayed urination is 1;
		try urinating; [No need for us to have the gladiator say anything here, as this will automatically trigger the PeeReaction function.]
		if M is diaper-committed:
			compute diaper change of M;
		otherwise:
			satisfy M.

gladiator-dq-tg is a diaper punishment. The priority of gladiator-dq-tg is 5.
Definition: a gladiator-dq-tg (called P) is appropriate:
	if current-monster is not gladiator, decide no;
	if current-monster is wild gladiator, decide no;
	if the player is possessing a penis and the size of penis <= min penis size and tg fetish >= 1, decide yes;
	decide no.

To compute punishment of (P - gladiator-dq-tg):
	follow the gladiator sex conversion rule.

Definition: a gladiator is willing to spank: decide yes.

Definition: a gladiator is willing to forcefeed: decide yes.

Definition: a gladiator is willing to forcefeed pills: decide yes.

Definition: a gladiator is willing to change diapers: decide yes.

To say DiaperChangeStart of (M - a gladiator):
	say "With a single hand [NameDesc of M] tosses you prone to the cold dungeon floor. You are not left alone, however, and [he of M] plants [his of M] warm thighs down onto your chest[one of], giving you a full view of [his of M] curvy chocolate-coloured rear end![or].[stopping] [BigNameDesc of M] holds you by your ankles, forcing you to lie on your back.[line break][speech style of M]'[if there is worn messed knickers]Whew, I could smell that 2 rooms down. It's changing time for you!'[otherwise]My changing ability is on par with my fighting prowess!'[end if][roman type][line break]".

Definition: a gladiator is willing to donate diapers: decide yes.

Definition: a gladiator is diaper disciplining: decide yes.

To say DiaperChangeRemovalFlav of (M - a gladiator):
	say "[speech style of M]'[one of]Hmmm, thicker or thinner diapers, which one should I choose?'[or]Come now, don't act like you're not enjoying my attention!'[in random order][roman type][line break][BigNameDesc of M] [if current-diaper is diaper]gets to work, ripping either side of your [MediumDesc of current-diaper] off and collecting it with one hand. [big he of M] holds the used diaper out to you and tuts[otherwise]rips off your [ShortDesc of current-diaper][end if][if current-diaper is messed knickers]. Taking out several baby wipes, [he of M] gently but efficiently wipes your bottom down until it is completely clean[end if].".

To say DiaperPowderFlav of (M - a gladiator):
	say "[speech style of M]'[one of]Is THIS how you think adults relieve themselves?!'[or]This had better be the last time you need me to do this.'[or]Take a good look at what you've done.'[stopping][roman type][line break]".

To say DiaperChangeFlav of (M - a gladiator):
	say "[big he of M] proceeds to produce [if old-diaper is new-diaper]an identical (but clean) [ShortDesc of new-diaper][otherwise]a [ShortDesc of new-diaper][end if] from [DiaperSpace of M] and push it under you, bouncing [his of M] bottom mockingly as [he of M] folds the thick thing between your legs, chortling in a breathy tone as the wings of the diaper snare around your waist.".

To say DiaperChangeComment of (M - a gladiator):
	if M is diaper disciplining and the diaper-duration of M <= 0, say "[speech style of M]'[one of]You have been exposed as an inferior [man of the player]. Your forfeit is that you must remain in diapers until I give you permission to return to normal underwear. Understand?'[or]As your superior, I must now demand that you only wear diapers until I feel you have proved to me that you deserve respect again. There will be consequences for disobedience.'[or]Now that you have been diapered by me, the rule of honour is that you must promise to only wear diapers until I grant you permission to stop, or you defeat me in combat. If I catch you not wearing a diaper before then, I will make you sorely regret it. Now get out of my sight.'[in random order][roman type][line break]";
	otherwise say "[speech style of M]'[one of]A real [man of the player] would have spanked my bottom raw for trying this... and you just let it happen. What does that say about you, little one?'[or]There, you're no warrior, but I cannot deny how cute you are!'[or]All done. Doesn't that feel so much better?'[then at random][roman type][line break][BigNameDesc of M] asks with a knowing smirk.".

To say DQChangeResistReactionFlav of (M - a gladiator):
	say "[one of][BigNameDesc of M] gives a hearty laugh as your bucks and kicks do extremely little to knock [him of M] off.[line break][speech style of M]'You know, only hungry nursing children thrash like this. Food for thought.'[roman type][line break][or][speech style of M]'Well then, someone is enjoying themselves... did I not use enough baby powder, is that it?'[roman type][line break][BigNameDesc of M] hums.[roman type][line break][or][speech style of M]'Yes yes, by all means child, resist... you're only making your diaper crinkle louder, a constant reminder of our relationship!'[roman type][line break][BigNameDesc of M] speaks loudly.[in random order]".

To say DQSpankResistReactionFlav of (M - a gladiator):
	say "[BigNameDesc of M] snorts.";
	if the player is diapered, say "[speech style of M]'[one of]Hear those crinkles little one? That's your diaper. You're making that noise. Embrace it!'[or]Can't take a loss with grace can we? What should I have expected, you're wearing a diaper after all.'[or]Hahaha, this is rich! Yes, squirm more like a toddler!'[or]Do you need to go to the bathroom? Is that what this is about? Don't pretend like you're potty trained with THIS hugging your waist!'[in random order][roman type][line break]";
	otherwise say "[speech style of M]'[one of]Goodness you are a toddler. I think I can find a diaper around here if you're going to take your punishment with such disgrace.'[or]Squirming only gets you more winks little one.'[or][if there is worn knickers]Are we regretting our choice in underwear yet? The thrashing says yes!'[otherwise]I don't back-pedal from a punishment, child. Do not try to escape!'[end if][in random order][roman type][line break]".

To decide which number is the forcefeed-length of (M - a gladiator):
	if M is unfriendly, decide on 3;
	decide on 1.

To say ForcefeedDeclarationFlav of (M - a gladiator):
	if M is unfriendly, say "[speech style of M]'[one of]Let me show you what grown-ups use their breasts for.'[or]Time for your milk!'[stopping][roman type][line break]".

To say ForcefeedStartFlav of (M - a gladiator):
	say "[BigNameDesc of M] [if the player is prone]lays your back onto [his of M] lap and holds your head strongly with one hand[otherwise]pushes a large breast into your face[end if]. [big he of M] coaxes [his of M] [if M is milky-gladiator]lactating [end if]nipple into your mouth, and you have no choice but to accept it.".

To compute forcefeed round (N - a number) of (M - a gladiator):
	say "[BigNameDesc of M] strokes your hair and [if M is milky-gladiator]allows you to suck the [milk] from [his of M] breast[otherwise]squeezes [his of M] breast, filling your mouth with milk[end if]. You [one of]relent and [or][stopping]swallow it all down.";
	StomachMilkUp 1.

To say ForcefeedAftermath of (M - a gladiator):
	say "[BigNameDesc of M] pulls away, [his of M] nipple popping from your mouth mid-flow[if the bimbo of the player <= 14][one of]. You realise that at some point during the feeding you had begun sucking voluntarily[or][stopping][end if]!".

To say ForcefeedAfterFlav of (M - a gladiator):
	say "[speech style of M]'[one of]What an eager little baby you are! I'm afraid that's all I've got time for right now.'[or]I've got more where that came from, but it'll have to be later.'[or]Wow, you've got quite some suction on you there! I'll give you some more later if you're that eager.'[in random order][roman type][line break]".

Section 3 - Damage

To uncurse gladiators:
	increase gladiatorcurse by 1;
	now gladiatorcurse is gladiatorcurse * -1;[-2 Xavier, -1 Witch]
	repeat with M running through gladiators:
		if M is not wild gladiator and M is not enlightened gladiator:
			uncurse M.

To uncurse (M - a gladiator):
	now M is female;
	now M is purified.

To compute damage reaction of (M - a gladiator):
	if M is uninterested or M is friendly:
		say CombatProvokedReaction of M;
		now the sleep of M is 0;
	otherwise:
		let S be a random worn slap ready equippable;
		let C be the curse-charge of M;
		[say DamageReaction (the health of M) of M.]
		if attack-type is 1 and M is not male:
			unless S is clothing:[normal slap; transformation in 4 hits]
				increase the curse-charge of M by 1;
				say "[BigNameDesc of M]'s [if M is presenting as male]abs clench[otherwise]tits jiggle[end if] as they absorb your barehanded attack. ";
			otherwise if S is penis themed:[transformation in 3 hits]
				say "[BigNameDesc of M]'s [if M is presenting as male]abs clench[otherwise]tits jiggle[end if] as they absorb your attack. ";
				increase the curse-charge of M by 2;
			otherwise if S is magic themed:[transformation in 2 hits]
				say "[BigNameDesc of M]'s [if M is presenting as male]cage[otherwise]tits[end if] seem to absorb the residual magic from your attack.";
				increase the curse-charge of M by 3;
			if the curse-charge of M > 2:
				say DamageReaction (the health of M) of M;
			otherwise if S is clothing and S is not penis themed and S is not magic themed:
				say "[big he of M] [one of]stumbles, panting[or]briefly loses [his of M] balance, gritting [his of M] teeth[or]stumbles, apparently oblivious to the pain[at random] as [if M is swordless][he of M][otherwise][his of M] free hand[end if] clutches [his of M] crotch.";
		if C < the curse-charge of M:[if she gained charge, she'll comment on it.]
			if the curse-charge of M < 2:
				say "[line break][speech style of M]'[one of]Do you mean to excite me? Stop this foolishness!'[or]If you mean to excite me, you are nothing but a fool!'[or]I warn you! You will regret such attacks!'[then at random][roman type][line break]";
			otherwise if the curse-charge of M < 4:
				if S is clothing and S is magic themed, say "[line break][speech style of M]'[one of]Hng, magic... no! I'm can't lose control!'[or]This magic... I-I can't endure much more of this!'[or]Nng, this magic... I must finish this before I lose control!!'[then at random][roman type][line break]";
				otherwise say "[line break][speech style of M]'[one of]That method of attack... you will be the one to pay if I get turned on.'[or]Damn, I already feel it! Fool! You must use another method of attack!'[or]N-no, my arousal is... you must change your method of attack! Now!'[then at random][roman type][line break]";
			otherwise if the curse-charge of M < 6:
				say "[line break][speech style of M]'[one of]Stop! I'm on the verge of... losing control...'[or]Nng... the [if lady fetish is 2]cage[otherwise]curse[end if]... I'm at my limit...'[or]This is my last warning! I'm about to... lose control!'[then at random][roman type][line break]";
			otherwise:
				say "[line break][speech style of M]'[one of]No... it's no USE!'[or]Fool... I was holding BACK...'[or]No... it's... too LATE!'[then at random][roman type][line break]";
		otherwise:
			decrease the curse-charge of M by 1;

The gladiator priority attack rules is a rulebook. The priority attack rules of a gladiator is usually the gladiator priority attack rules.

This is the gladiator unsealing rule:
	let M be current-monster;
	if diaper quest is 0 and M is not male and gladiatorcurse > -1 and the curse-charge of M >= 6:
		if lady fetish is 2:
			say "[big he of M] doubles over, growling fiercely.[line break][speech style of M]'You... HNNG... [if gladiatorcurse is 1]think I choose to stay here, but in reality I was... RRR!... defeated and returned here in shame[otherwise]don't understand. I was only... RRR!... trying to help you! Only I can defeat... that treacherous witch[end if]...'[roman type][line break][big he of M] tears off [his of M] loincloth, revealing the steel chastity cage underneath. [if gladiatorcurse is 1]The area around you dims slowly as the cage glows with ominous red light[otherwise]The cage visibly shifts as its occupant tries to grow erect[end if], creaking audibly and finally exploding into a shower of shrapnel as a [LongDickDesc of M] bursts free.[line break][speech style of M]'[one of]As long as I had this cage, I could defeat [him of demon lord], but now... I have no chance. You will pay for this!'[or]My cage... You IDIOT!'[stopping][roman type][line break]";
		otherwise if gladiatorcurse is 1:
			let D be demon lord;
			say "[big he of M] doubles over, growling fiercely.[line break][speech style of M]'You... HNNG... think I choose to stay here, but in reality I was... RRR!... defeated and forced to return.[roman type][line break][big he of M] tears off [his of M] loincloth and takes a staggering step back, the area around you dimming slowly as [his of M] body wreathes itself in ominous red light. You watch in [horror the sex addiction of the player] as it converges on [his of M] crotch, forming a [LongDickDesc of M] right [if futanari fetish is 1]where [his of M] clit should be[otherwise]above [his of M] pussy[end if]![line break][speech style of M]'[one of]I was cursed to [if futanari fetish is 1]bear the mark of the lesser sex[otherwise]wear this vile thing[end if] ever since. You will regret revealing my shame.'[or][big his of D] curse... it's awakening! GRAAAAH!'[stopping][roman type][line break]";
			if futanari fetish is 1, cutshow figure of gladiator cutscene 2 for M;
		otherwise:
			let W be witch;
			say "[big he of M] growls fiercely.[line break][speech style of M]'You... HNNG... you've done it now...'[roman type][line break]You watch in [horror the sex addiction of the player] as [if futanari fetish is 1][his of M] clit starts to throb and swell, and before you know it, a [LongDickDesc of M] stands proudly erect from the tops of [his of M] vulva.[otherwise]a black, tar-like substance begins to gather above [his of M] pussy, slowly forming itself into a [LongDickDesc of M][end if][line break][speech style of M]'[one of]Yes, that's right, [if futanari fetish is 1]I'm part male[otherwise]I'm forced to wear this[end if], ever since that magical traitor in the woods planted this curse on me. Don't expect me to ever forgive you for revealing my shame.'[or]The curse... it awakens... GRAAAH!'[stopping][roman type][line break]";
			if futanari fetish is 1, cutshow figure of gladiator cutscene 1 for M;
		now M is male;
		rule succeeds.
The gladiator unsealing rule is listed in the gladiator priority attack rules.

To say CombatProvokedReaction of (M - a gladiator):
	say "[big he of M] [if M is asleep]wakes up and [end if]snarls menacingly! Uh-oh...";
	now the growth-target of M is gladiator-next-level of M.

To say DamageReactHealthy of (M - a gladiator):
	say "[big he of M] ignores the pain, with the smallest of winces!".

To say DamageReactDamaged of (M - a gladiator):
	say "[big he of M] barely reacts to the pain!".

To say DamageReactTired of (M - a gladiator):
	say "[big he of M] seems to be struggling to ignore the pain!".

To say DamageReactWeak of (M - a gladiator):
	say "[big he of M] grunts as [he of M] fights to maintain [his of M] balance.".

To say DamageReactSubmissive of (M - a gladiator):
	say "[big he of M] grunts as [he of M] fights to keep [his of M] balance, blushing as [his of M] eyes linger on your crotch.".

To say BanishForceFlav of (M - a gladiator):
	let E be a random worn slap ready equippable;
	say "You [if the player is able to use their hands]roughly grab [NameDesc of M] by the breasts[otherwise]stand over the defeated [MediumDesc of M], staring down menacingly[end if].[line break][if the player is able to speak][variable custom style]'I have proven my strength. Now leave this place, and never return, while you still have the chance.'[roman type][line break][end if][BigNameDesc of M] snarls, but looks more angry at [himself of M] than at you.[line break][speech style of M]'[roman type][line break]".

To compute loot dropping of (D - metal-disc) by (M - a gladiator):
	say "[BigNameDesc of M] plucks a [D] from [his of M] belt and tosses it towards you. It rolls towards you and comes to a halt at your feet.[line break][speech style of M]'There. A trophy for your victory. I wonder what I will take for my trophy the next time we fight...'[roman type][line break]".

Section 4 - Dominant Sex

To decide which number is the dominationtype of (M - a gladiator) using (F - penis):
	reset multiple choice questions;
	set next numerical response to "Go for a blowjob";
	set next numerical response to "Go for penetration";
	set next numerical response to "Settle for whatever";
	say "How do you want to dominate [him of M]?";
	compute multiple choice question;
	let CNR be the chosen numerical response;
	let C be 0;
	if the printed name of CNR is "Go for a blowjob", now C is FUCK-BLOWJOB;
	if the printed name of CNR is "Go for penetration", now C is FUCK-PENETRATION;
	if the printed name of CNR is "Settle for whatever":
		if a random number between 1 and 2 is 1, now C is FUCK-BLOWJOB;
		otherwise now C is FUCK-PENETRATION;
	decide on C.

To decide which number is the dominationtype of (M - a gladiator) using (F - a fuckhole):
	unless M is male, decide on FUCK-FACESIT;
	reset multiple choice questions;
	let C be 0;
	if there is a held condom-providing thing, now C is 1;
	set next numerical response to "Try facesitting";
	if C is 0:
		set next numerical response to "Try riding";
	otherwise:
		set next numerical response to "Try riding bareback";
		set next numerical response to "Try riding with a condom";
	set next numerical response to "Settle for whatever";
	say "How do you want to dominate [him of M]?";
	compute multiple choice question;
	let CNR be the chosen numerical response;
	let C be 0;
	if the printed name of CNR is "Try facesitting", now C is FUCK-FACESIT;
	if the printed name of CNR is "Try riding", now C is FUCK-RIDE;
	if the printed name of CNR is "Settle for whatever":
		if a random number between 1 and 2 is 1, now C is FUCK-FACESIT;
		otherwise now C is FUCK-RIDE;
	if the printed name of CNR is "Try riding with a condom":
		say CondomManualFlav of M;
		now M is wrapped;
		now C is FUCK-RIDE;
	decide on C.

To compute domination interference of (M - a gladiator) for (N - a monster):
	say "[BigNameDesc of M] moves out of the way, seemingly waiting to see the outcome.";

To compute domination interference of (M - wild gladiator) for (N - a monster):
	say "[BigNameDesc of M] puts [himself of M] between you and [NameDesc of N]![line break][speech style of M]'Don't touch my trophies, whelp.'[roman type][line break]Looks like you'll need to deal with [him of M] first!";
	now player-fucking is DOMINANT-FAILURE;
	if M is not unfriendly, anger M.

To say DominationReaction of (M - a gladiator) to (N - a monster):
	if player-fucking is DOMINANT-SHAMEFUL:
		say "[line break][speech style of M]'Weak.'[roman type][line break][BigNameDesc of M] seems unimpressed at your display of 'dominance'.";
		FavourDown M by 1;
		make M expectant;
	otherwise:
		if M is unfriendly:
			if player-fucking is DOMINANT-NEUTRAL, FavourUp M by 1;
			otherwise FavourUp M by 2;
			say "[line break][speech style of M]'It seems you are not worthless as a warrior. [if M is unfriendly]However, I will not spare you. Prepare yourself.'[roman type][line break][BigNameDesc of M] resumes [his of M] aggressive stance![otherwise]I will spare you, for now.'[roman type][line break][BigNameDesc of M] turns to leave[end if]";
			make M expectant;
		otherwise:
			FavourUp M by 1;
			say "[line break][speech style of M]'Hm. Impressive.'[roman type][line break][BigNameDesc of M] nods approvingly.";
		unless M is unfriendly, Bore M;

To say DominationFailedReaction of (M - a gladiator) to (N - a monster):
	if N is interested:
		say "[line break][speech style of M]'Remain where you are. [big he of N] is not finished.'[roman type][line break][BigNameDesc of M] watches you closely to make sure you don't get up.";
	otherwise:
		say "[line break][speech style of M]'It is clear to me that you are not worthy of being seen as a warrior.'[roman type][line break][BigNameDesc of M] assumes a fighting stance.";
	anger M;
	make M expectant.

To say DominanceFailure of (M - a gladiator):
	if M is male and player-fucker is not penis:
		say "You grab [NameDesc of M] by the wrist and try to [if M is swordless]overpower [him of M]. [big his of M][otherwise]wrench the sword out of [his of M] hand. [big his of M][end if] erection bobs ominously as [he of M] sweeps your legs out from underneath you.";
	otherwise:
		say "You grab [NameDesc of M] by the wrist and try to [if M is swordless]overpower [him of M]. [big he of M][otherwise]wrench the sword out of [his of M] hand. [big he of M][end if] reacts instantly, sweeping your legs out from underneath you.".

To compute failed dominance punishment of (M - a gladiator):
	if M is not male:[as in, hasn't awakened the curse yet]
		if the player is getting lucky:
			if player-fucker is penis, say "[speech style of M]'[one of]I was looking forward to what you would do when you won. But you did not win.'[or]And I thought you had potential. How stupid.'[or]If you defeated me, I would be servicing you right now. But you did not defeat me.'[at random][roman type][line break][BigNameDesc of M] loses interest.";
			otherwise say "[speech style of M]'[one of]Grow from this defeat.'[or]I hope this has been a wake-up call.'[or]Do better.'[at random][roman type][line break][BigNameDesc of M] loses interest.";
			say GotLuckyFlav;
			slightHumiliate;
			Bore M;
		otherwise if (the player is getting very unlucky or player-fucker is penis) and face is not actually occupied:[you can either eat her out or piss her off]
			say "[speech style of M]'[one of]After my body, are you? I have no problem with that.'[or]If you mean to taste me, I don't mind.'[at random][roman type][line break][BigNameDesc of M] [if M is presenting as male]turns around and expectantly spreads [his of M] cheeks, glaring at you over [his of M] shoulder[otherwise]lifts up [his of M] loincloth and pulls your face toward [his of M] crotch, glaring down at you[end if] as if daring you to refuse. Will you eat [him of M] out?";
			if the player is not bimbo consenting:
				say "[if the number of things penetrating face > 0][line break][speech style of M]'Hmph. I expected as much.'[roman type][line break][end if][BigNameDesc of M] gives you an icy look, but loses interest without doing anything more.";
				FavourDown M by 2;
				Bore M;
			otherwise:
				let O be the oral sex addiction of the player;
				say "You obediently lean forward, opening your mouth [if the delicateness of the player + the sex addiction of the player < 10]after a moment of hesitation[otherwise if the sex addiction of the player < 12]with little hesitation[otherwise]with no pretence of hesitation[end if] and [if O < 3]unenthusiastically[otherwise if O < 6]all too eagerly[otherwise]happily[end if] push your tongue into [his of M] [if M is presenting as male][asshole]. The[otherwise if interracial fetish is 1]proud ebony folds. The[otherwise]folds. The[end if] lack of control you have over the situation [if the times-seeded of M > 0]is reinforced by the creamy taste of your previous [one of]encounter[or]encounters[stopping] hitting your tongue, [otherwise]is reinforced by the fact that [he of M] hasn't enough bothered to restrain you, [end if]and you willingly submit to being [his of M] bitch until your tongue is fatigued enough to lose its dexterity.";
				if interracial fetish is 1, Arouse 500;
				if the times-seeded of M > 0, StomachSemenUp 1;
				humiliate 50 + ((the times-dominated of M - 1) * 3);
				LickCount;
				Satisfy M;
			unless player-fucker is penis, say GotUnluckyFlav;
		otherwise:[she decides she didn't earn this victory]
			say "[speech style of M]'[one of]It won't be satisfying unless I defeat you properly.'[or]I want a complete victory. For that reason alone, I will spare you.'[in random order][roman type][line break]";
			Bore M;
	otherwise:
		if (player-fuckchoice is FUCK-RIDE and the player is getting very unlucky) or the player is getting unlucky:[she decides to fuck you]
			say "[speech style of M]'[one of]I can't wait to humiliate you!'[or]Prepare for your will to be broken!'[or]Enough games! It's time I shattered your dignity for good!'[in random order][roman type][line break][GotUnluckyFlav]";
			now another-turn-flavour is the substituted form of "[BigFuckerDesc of M] holds you in place.";
			now another-turn is 1;[She's still interested because she intends to fuck you]
		otherwise if player-fuckchoice is FUCK-RIDE:[she decides punishing you would be useless, and is totally not flattered or anything.]
			say "[line break][speech style of M]'[one of]Is there even a way to punish [him of the player]...'[or]Ugh, how do I punish [him of the player]...'[or]Even punishing [him of the player] is useless. Ugh...'[in random order][roman type][line break][BigNameDesc of M] makes a frustrated noise before turning away, seeming to lose interest.";
			FavourUp M by 1;
			Bore M;
		otherwise:[she decides she didn't earn this victory]
			say "[speech style of M]'[one of]It won't be satisfying unless I defeat you properly.'[or]I want a complete victory. For that reason alone, I will spare you.'[in random order][roman type][line break]";
			Bore M.

To penetration dominate (M - a gladiator):
	let X be the remainder after dividing the times-seeded of M by 2;
	if X is 1, anal penetration dominate M;
	otherwise vaginal penetration dominate M;

To compute unique dominance reward of (M - a gladiator):
	if player-fuckchoice is FUCK-RIDE, compute power bottom reward of M;
	otherwise:[meaning that you used a strapon/penis]
		if the player is possessing a penis, PenisUp 1;
		otherwise DelicateDown 1;
	DelicateDown 1.

To ride dominate (M - a gladiator):
	let F be player-fucker;
	let G be the openness of F - the girth of M;
	say "You grab [NameDesc of M] by the wrist and try to [if M is swordless]overpower [him of M]. [big he of M][otherwise]wrench the sword out of [his of M] hand. [big he of M][end if] tries to resist, but [his of M] [DickDesc of M] throws off [his of M] balance, and [he of M] ends up falling on [his of M] ass. [PowerBottomComment of M] You sit in [his of M] lap, looking [him of M] in the eye as you grind on [his of M] shaft. [big his of M] eyes [if M is wild gladiator]narrow[otherwise]widen[end if].[line break][speech style of M]'[if M is wild gladiator][one of]You forget your role.'[or]You doubt my abilities?'[at random][otherwise][one of]T-that is my lesser part! S-stop this at once!'[or]You want that? But that's my-!'[or]What?! You're after my-?!'[at random][end if][roman type][line break][BigNameDesc of M] watches with bated breath as you line [his of M] drooling tip up with your hole. Your eyes meet as you drop your hips, and you share a wince as [his of M] [LongDickDesc of M] [if G > 2]slips[otherwise if G > -1]slides[otherwise]slooowly slides[end if] into your [variable F].";
	now M is penetrating F;
	now refractoryperiod is 3;
	ruin F;
	let C be a random worn chastity cage;
	say "[line break][big he of M] tries to harden [his of M] expression, but from the way [he of M]'s twitching inside you, it's clear [he of M]'s actually desperate to see where you take things next. [if the relevant sex addiction of the player > 6]Luckily, you've been desperate to have this [DickDesc of M] inside of you from the moment you laid eyes on it, and you aren't about to back out now[otherwise if the times-submitted of M > 0]The thought of punishing [him of M] for all [he of M]'s done to you is enticing, but the exaggerated look of scorn on [his of M] face is too cute to ignore[otherwise]The thought of torturing [him of M] a little bit is enticing, but you're really horny, and [his of M] [DickDesc of M] is BIG![end if]. You [if the relevant sex addiction of the player > 10]enthusiastically[otherwise if the relevant sex addiction of the player > 5]confidently[otherwise]hesitantly[end if] begin to move your hips, [if C is clothing]cage jiggling uselessly[otherwise if the size of penis > 4][player-penis] tapping [his of M] belly[otherwise if the player is possessing a penis][sissy-penis] jiggling happily[otherwise]breasts [BreastBouncingDesc][end if] as your bouncing hips drive [him of M] into your [if the player is sexed male]prostate[otherwise]G-spot[end if] over and over again. [big he of M] accepts [his of M] punishment without flinching or looking away, panting quietly as you treat [him of M] like your own personal dildo. Your wild pace eventually takes its toll, and you find yourself shutting your eyes and speeding up as you race toward your peak.[line break]";
	now refractoryperiod is 0;
	let R be the times-dominated of M;
	if the player is gendered female, increase R by 1;
	let T be 3;
	if debugmode > 0, say "[input style]Gladiator warning check: Is [R] (gladiator respect) > [T] (Respect threshold)?[roman type][line break]";
	if M is wrapped:
		if debugmode > 0, say "[bold type]SKIPPED[roman type][line break]";
		say "An orgasm crashes over your body, temporarily robbing you of muscle control as you collapse onto [him of M] and [if the player is possessing a penis]paint [his of M] belly with your load[otherwise if the player is possessing a vagina]douse [him of M] with feminine juices[otherwise]bury your face in [his of M] [ChestDesc of M][end if]. A surge of warmth inside you lets you know that [he of M] came too, and you glance up at [him of M] as the condom slowly fills with [semen].";
		moderateDignify;
		orgasm;
		orgasm M;
		say AfterDominationComment 9 of M;
	otherwise if R > T:[if she respects you, she'll warn you]
		if debugmode > 0, say "[bold type]PASSED[roman type][line break]";
		say "[line break][speech style of M]'WAIT!'[roman type][line break][NameDesc of M] yelps.[line break][speech style of M]'If you keep going, I won't be able to hold back. [big please], I have no right to seed you.'[roman type][line break]Keep going anyway?";
		if the player is bimbo consenting:
			say "You don't even slow down, and pound yourself to orgasm within moments. Moans bubble out of your mouth as you [if the player is possessing a penis]paint [his of M] belly with your load[otherwise if the player is possessing a vagina]douse [him of M] with feminine juices[otherwise]bury your face in [his of M] [ChestDesc of M][end if], relishing [his of M] hiss of pleasure as [he of M] fills your [variable F] with several spurts of fresh [semen].";
			strongDignify;
			orgasm;
			compute M finishing in F;
			orgasm M;
			say AfterDominationComment 9 of M;
		otherwise:
			say "You reluctantly climb off of [him of M], avoiding a creampie, but also ruining your own orgasm.";
			moderateDignify;
			now player-fucking is DOMINANT-NEUTRAL;
			Arouse 2000;
			say AfterDominationComment 4 of M;
	otherwise:
		if debugmode > 0, say "[bold type]FAILED[roman type][line break]";
		say "Orgasm crashes over your body, temporarily robbing you of muscle control as you collapse into [him of M] and [if the player is possessing a penis]paint [his of M] belly with your load[otherwise if the player is possessing a vagina]douse [him of M] with feminine juices[otherwise]bury your face in [his of M] [ChestDesc of M][end if]. Just when you start to get up, you feel [his of M] arms lock around your waist, forcing you to stay in place as [his of M] [DickDesc of M] rapidly begins to spasm. The satisfaction of victory is immediately replaced by the feeling of [his of M] [semen] flooding your [variable F].";
		slightDignify;
		now player-fucking is DOMINANT-NEUTRAL;
		orgasm;
		compute M finishing in F;
		orgasm M;
		say AfterDominationComment 2 of M;
	if F is vagina, FuckCount;
	otherwise AnalCount;
	now M is not penetrating F.

To watersports dominate (M - a gladiator):
	say "You force [NameDesc of M] to [him of M] knees, [if there is bottom level protection clothing]pulling aside your [printed name of random bottom level protection clothing] as you drag [him of M][otherwise] pulling [his of M] head[end if] toward your crotch.[line break][speech style of M]'So, I am to be your toilet? [one of]Hmph. Fine.'[or]Very well.'[or]It is your right.'[at random][roman type][line break][big he of M] closes [his of M] eyes and holds [his of M] mouth open proudly as your [urine] streams onto [his of M] face and breasts.";
	now the bladder of the player is 0;
	moderateDignify;
	say AfterDominationComment 2 of M.

To facesit dominate (M - a gladiator):
	if player-fucker is vagina:
		say "You force [NameDesc of M] onto [his of M] back and [if there is bottom level protection clothing]pulling aside your [printed name of random bottom level protection clothing], [end if]sit on [his of M] face. Accepting [his of M] punishment, [he of M] pulls your thighs apart, teasing your clitoris with [his of M] tongue as [he of M] gently pushes [his of M] fingers in and out of your [vagina]. [big his of M] touch is delicate, yet firm. Inquisitive, yet skilled, and before you realise it's happening, your thighs are hugging the sides of [his of M] head as orgasm crashes through your body. [big he of M] pulls away, face dripping with [if the semen volume of vagina > 0 and the pregnancy of the player is 0]a mixture of [semen] and your own juices[otherwise]your juices[end if], puffing up [his of M] chest with pride.";
		if the pregnancy of the player is 0:
			if the semen volume of vagina > 2, now the semen volume of vagina is 0;
			otherwise decrease the semen volume of vagina by 2;
		slightDignify;
	otherwise:
		say "You force [NameDesc of M] onto [his of M] back and [if there is bottom level protection clothing]pulling aside your [printed name of random bottom level protection clothing], [end if]sit on [his of M] face. Accepting [his of M] punishment, [he of M] pulls your asscheeks apart, gently yet firmly pushing [his of M] tongue into your [asshole] as [his of M] fingers [if the player is not possessing a penis]delicately tease your outer rim[otherwise]gently tease your sack[end if]. It's a pleasant feeling, but [if the anal sex addiction of the player > 4]it's not enough to make you cum[otherwise]you're not all that interested in cumming with your ass[end if], and decide to leave [him of M] be once you get bored.";
		slightDignify;
		FavourUp M;
	say AfterDominationComment 2 of M;
	LickGet.

To blowjob dominate (M - a gladiator):
	let C be a random bottom level protection clothing;
	let R be the semi-dominance roll for M;
	if lady fetish is 2, now R is 0;
	if the sexual-penis-length > 8:
		if R >= 0:
			if debugmode > 0, say "[bold type]PASSED[roman type][line break]";
			say "You force [NameDesc of M] to [his of M] knees and [if C is not strapon-panties and C is clothing]taking your [SexDesc of penis] out of your [printed name of random worn bottom level protection clothing],[otherwise]taking your [SexDesc of penis],[end if] slap [him of M] a couple times.[line break][speech style of M]'I-I'd be honoured to satisfy you, warrior...'[roman type][line break][big he of M] breathes, forming a perfect 'O' with [his of M] lips as your [SexShaft] slides into [his of M] mouth. You roughly fuck [his of M] face, purposefully going too fast so [he of M] gags trying to deepthroat your [sexual-player-penis]. Seeing [his of M] domineering demeanour snap like a twig is just too hot, and [if bukkake fetish is 1]you roar with pleasure as you pull out and spray a massive load all over [his of M] face and chest[otherwise]you roar with pleasure as you jizz straight down [his of M] throat, [semen] rolling out of [his of M] nose as [he of M] struggles to swallow your huge load.[end if] [big he of M] gasps erratically as you shove [him of M] away and wipe off your [sexual-player-penis], [his of M] understanding of [his of M] proper place written all over [his of M] face.";
			cutshow figure of gladiator cutscene 18 for M;
			severeDignify;
			FavourUp M by 1;
			say AfterDominationComment 5 of M;
		otherwise:
			if debugmode > 0, say "[bold type]FAILED[roman type][line break]";
			say "You force [NameDesc of M] to [his of M] knees and pull [his of M] head toward your crotch.[line break][speech style of M]'Very well, you have bested me, I accept my punishment.'[roman type][line break][big he of M] [if C is not strapon-panties and C is clothing]pulls your [sexual-player-penis] out of your [printed name of random worn bottom level protection clothing][otherwise if penis is penis-erect]takes hold of your [SexDesc of penis] with one hand[otherwise]takes hold of your hardening [sexual-player-penis] with one hand[end if] and forces your [SexShaft] in between [his of M] breasts as [he of M] wraps [his of M] lips around your tip. You realise a moment too late that [he of M]s taken control, helplessly trying to push [him of M] off as [he of M] expertly pumps and polishes your shaft at the same time. [big his of M] expert movements force you up to the edge, [his of M] eyes twinkling ass [he of M] suddenly pulls [his of M] head back and allows your massive load to spray liberally across [his of M] face and chest.";
			cutshow figure of gladiator cutscene 20 for M;
			moderateDignify;
			say AfterDominationComment 2 of M;
		BlowGet;
	otherwise if the sexual-penis-length > 6:
		if R >= 0:
			if debugmode > 0, say "[bold type]PASSED[roman type][line break]";
			say "You force [NameDesc of M] to [his of M] knees and [if C is not strapon-panties and C is clothing]taking your [SexDesc of penis] out of your [printed name of random worn bottom level protection clothing], [end if]drop your [if penis is penis-erect]fully erect[otherwise]hardening[end if] [SexDesc of penis] on [his of M] face.[line break][speech style of M]'Very well, you have bested me. I accept my punishment.'[roman type][line break][big he of M] grabs your [sexual-player-penis] and obediently guides it into [his of M] mouth. You groan in satisfaction as [he of M] begins to suck, vigorously jerking you off with one hand and fondling your balls with the other. It's obvious [he of M]'s had some experience with situations like this, but [he of M] struggles to take your full length into [his of M] mouth. [big he of M] keeps pulling up for air, repeatedly tantalising you with the promise of an eventual deepthroat. Eventually you get sick of it and aggressively hold [him of M] down the next time [he of M] tries to come up. [big he of M] gags loudly as you force your [sexual-player-penis] down [his of M] throat, cheeks slowly turning purple from lack of oxygen. ";
			cutshow figure of gladiator cutscene 17 for M;
			say "It feels great though, and luckily for [him of M] it doesn't take too long for the clenching of [his of M] throat around your [SexShaft] to push you over the edge. [big he of M] splutters as you begin to cum, eyes fluttering and [semen] rolling out of [his of M] nose as you clog [his of M] windpipe with your [load]. You hold [him of M] down until [he of M]'s just about to pass out and abruptly shove [him of M] away. [big he of M] gasps for air, glaring up at you with a strange measure of dignity as you finish off on [his of M] face.";
			moderateDignify;
			say AfterDominationComment 3 of M;
		otherwise:
			if debugmode > 0, say "[bold type]FAILED[roman type][line break]";
			say "You force [NameDesc of M] to [his of M] knees and [if C is not strapon-panties and C is clothing]take your [SexDesc of penis] out of your [printed name of C], pushing[otherwise]push[end if] your [sexual-player-penis] into [his of M] face.[line break][speech style of M]'Very well, you have bested me, I accept my punishment.'[roman type][line break][big he of M] sandwiches it between [his of M] [ChestDesc of M], skilfully pumping your [SexShaft] as [his of M] lips wrap themselves around the tip. The way [he of M] moves is almost hypnotic, and as much as you want to take charge and prove your dominance, you find yourself losing track of time as [his of M] measured strokes and tender movements of [his of M] tongue slowly bring you to the brink of orgasm. [big his of M] eyes seem to twinkle as [he of M] holds you there for several excruciating moments before pulling off and forcing you to surrender your load all over [his of M] [if lady fetish is 2]tits[otherwise]chest[end if].";
			cutshow figure of gladiator cutscene 20 for M;
			slightDignify;
			now player-fucking is DOMINANT-NEUTRAL;
			say AfterDominationComment 2 of M;
		BlowGet;
	otherwise if the sexual-penis-length > 4:
		say "You force [NameDesc of M] to [his of M] knees and[if C is not strapon-panties and C is clothing], taking your [SexDesc of penis] out of your [printed name of C],[end if] tap your [if penis is penis-erect]fully erect[otherwise]hardening[end if] [SexDesc of penis] on [his of M] cheek.[line break][speech style of M]'Very well, you have bested me, I accept my punishment.'[roman type][line break]";
		BlowGet;
		if R >= 0:
			if debugmode > 0, say "[bold type]PASSED[roman type][line break]";
			say "[big he of M] takes hold of your [sexual-player-penis] and guides it through [his of M] lips. You place a hand on the back of [his of M] head as you force your entire [SexShaft] into [his of M] mouth. The sound of [his of M] gagging is enough to push you over the edge, causing you to spurt your [semen] straight down [his of M] throat. You pull out as your orgasm tapers off, depositing a few short ropes on [his of M] tongue, which [he of M] swallows without complaint.";
			cutshow figure of gladiator cutscene 18 for M;
			moderateDignify;
			say AfterDominationComment 3 of M;
		otherwise:
			if debugmode > 0, say "[bold type]FAILED[roman type][line break]";
			say "[big he of M] sandwiches it between [his of M] [ChestDesc of M], eyes twinkling as [he of M] completely smothers your [SexShaft]. You want to take charge and prove your dominance, but [he of M] gives you no chance, using measured strokes and skilful movement to bring you to the edge and then hold you there indefinitely. [big he of M] puts you through several excruciating minutes of torture before finally forcing you to surrender your load into [his of M] cleavage.";
			cutshow figure of gladiator cutscene 17 for M;
			trivialDignify;
			now player-fucking is DOMINANT-SHAMEFUL;
			say AfterDominationComment 2 of M;
	otherwise:
		if R >= 0:
			if debugmode > 0, say "[bold type]PASSED[roman type][line break]";
			say "You force [NameDesc of M] to [his of M] knees and [if C is not strapon-panties and C is clothing]taking your [SexDesc of penis] out of your [printed name of C], [end if]press your [if penis is penis-erect]fully erect[otherwise]hardening[end if] [SexDesc of penis] up against [his of M] chin.[line break][speech style of M]'... Is that it? Ugh, I deserve this.'[roman type][line break][big he of M] purses [his of M] lips around your [SexShaft], taking the whole thing into [his of M] mouth. The feeling is far too much to bear, and you moan [if the player is gendered male]femininely[otherwise]uncontrollably[end if] as you spurt a tiny load directly onto [his of M] tongue. [big he of M] pulls off and swallows it as [he of M] props [himself of M] up [if M is swordless]against a wall.[otherwise]on [his of M] sword.[end if]";
			BlowGet;
			slightDignify;
			now player-fucking is DOMINANT-NEUTRAL;
		otherwise:
			if debugmode > 0, say "[bold type]FAILED[roman type][line break]";
			say "You force [NameDesc of M] to [his of M] knees and [if C is not strapon-panties and C is clothing]taking your [SexDesc of penis] out of your [printed name of C], [end if]drop your [if penis is penis-erect]fully erect[otherwise]hardening[end if] [SexDesc of penis] up against [his of M] chin. [big he of M] smirks as [he of M] lunges forward, completely crushing your tiny [SexShaft] with [his of M] [ChestDesc of M]. The feeling is far too much too bear, and you moan uncontrollably as you immediately spurt your load into [his of M] cleavage.";
			now player-fucking is DOMINANT-SHAMEFUL;
		say AfterDominationComment 1 of M;
	orgasm.

To vaginal penetration dominate (M - a gladiator):
	if the sexual-penis-length > 8:
		if the penis is penis-erect:
			say "You force [NameDesc of M] onto [him of M] back, letting your rock hard [sexual-player-penis] rest on [his of M] belly as you rip off [his of M] loincloth.[line break][speech style of M]'I would be honoured to bear the seed of such a fine warrior.'[roman type][line break][big he of M] reaches between [his of M] legs, grasping your [SexDesc of penis] with one hand and spreading [himself of M] with the other, shuddering as [he of M] slowly eases you into [his of M] [HoleDesc of M]. An abrupt thrust forward causes [him of M] to gasp sharply as you enter [him of M] in full.[line break][first custom style]'You ready, bitch?'[roman type][line break]You hiss, which [he of M] immediately answers with the most cock hungry look you've ever seen. Pleasured moans bubble out of [his of M] mouth as you *CLAP* *CLAP* *CLAP* [his of M] ass, pressing your [SexShaft] deep into [him of M] with every thrust. At the same time, [his of M] powerful inner muscles simultaneously massage and pull you deeper with their contractions, insistently milking your [sexual-player-penis] for its load. [big he of M] isn't kept waiting for long, and [he of M] screams in orgasm as you flood [him of M] [HoleDesc of M] with a massive load.";
			severeDignify;
		otherwise:
			let S be a random worn dildo-usage strapon-panties;
			say "You force [NameDesc of M] onto [his of M] back.[line break][speech style of M]'Very well. My body is your right.'[roman type][line break][big he of M] grasps your [sexual-player-penis] as [he of M] unclips [his of M] loincloth, but as you get closer to your full size, but [his of M] demeanour instantly changes.[line break][speech style of M]'[if S is clothing]That... that's big.'[otherwise]You... you're big.'[end if][roman type][line break][big he of M] breathes, staring at your [SexDesc of penis] wide eyes and slightly parted lips.[line break][first custom style]'Fuck yeah [if S is clothing]it is[otherwise]I am[end if], bitch.'[roman type][line break]You retort, smacking [his of M] [if lady fetish is not 2]big tits [end if]as you ease your [sexual-player-penis] into [his of M] [HoleDesc of M]. It's a snug fit, but [he of M]'s a willing slut, and doesn't conceal how much [he of M] loves taking every inch of your big [sexual-player-penis] into [his of M] tight [HoleDesc of M]. [big he of M] emits a stream of pleasured moans as you fuck [him of M], using [his of M] strong inner muscles to simultaneously massage you and pull you deeper, slowly building your pleasure up to an aching peak. The sensations eventually overwhelm you, and [big he of M] screams with pleasure as you flood [his of M] [HoleDesc of M] with a huge load.";
			strongDignify;
		orgasm M;
		FavourUp M by 1;
		cutshow figure of gladiator cutscene 15 for M;
		say AfterDominationComment 5 of M;
	otherwise if the sexual-penis-length > 6:
		if penis is penis-erect:
			say "You force [NameDesc of M] onto [his of M] back.[line break][speech style of M]'Very well. Seed me, warrior.'[roman type][line break][big he of M] unclips [his of M] loincloth, parting [his of M] folds as you line up your [SexDesc of penis] with [his of M] [HoleDesc of M]. You don't need any more of an invitation than that, sighing with pleasure as your [sexual-player-penis] slides in. [big his of M] inner walls are strong, simultaneously pulling you deeper and massaging you from the inside. The sensation is incredible, and you try to savour it, but ultimately you're [one of]no match[or]still no match[stopping] for [his of M] skill. You groan as [he of M] forces you to flood [his of M] [HoleDesc of M] with your load.";
			strongDignify;
		otherwise:
			say "You force [NameDesc of M] onto [his of M] back.[line break][speech style of M]'Very well. My body is your right.'[roman type][line break][big he of M] grasps your [SexDesc of penis] as you unclip [his of M] loincloth, bringing you to full hardness and gently guiding your [SexShaft] unto [his of M] [HoleDesc of M]. You do your best to take control of the situation from there, but [his of M] inner muscles are strong, simultaneously pulling you deeper and massaging you from the inside. Ultimately you're no match for [him of M], and before long you are forced to pull out and paint [his of M] crotch with your load.";
			moderateDignify;
		now player-fucking is DOMINANT-NEUTRAL;
		cutshow figure of gladiator cutscene 15 for M;
		say AfterDominationComment 2 of M;
	otherwise if the sexual-penis-length > 4:
		if penis is penis-erect:
			say "You force [NameDesc of M] onto [his of M] back.[line break][speech style of M]'Very well. Seed me then, warrior.'[roman type][line break][big he of M] unclips [his of M] loincloth, [if M is male or lady fetish is 2]spreading [his of M] ass[otherwise]parting [his of M] folds[end if] as you line yourself up with [SexDesc of penis] with [his of M] [HoleDesc of M]. You don't need any more of an invitation than that, sighing with pleasure as your [sexual-player-penis] slides in. [big his of M] inner walls are strong, simultaneously pulling you deeper and massaging you from the inside. You're no match for [his of M] skill, and groan helplessly as [he of M] forces you to empty your load into [his of M] [HoleDesc of M].";
			moderateDignify;
		otherwise:
			say "You force [NameDesc of M] onto [his of M] back.[line break][speech style of M]'I suppose you have earned my body. Very well.'[roman type][line break][big he of M] grasps your [SexDesc of penis] as you unclip [his of M] loincloth, bringing you to full hardness and gently guiding your [SexShaft] unto [his of M] [HoleDesc of M]. [big his of M] inner muscles are strong, simultaneously pulling you deeper and massaging you from the inside. You can't stand up to it at all, and within moments you are forced to pull out and blow your load on [his of M] belly.";
			slightDignify;
		cutshow figure of gladiator cutscene 15 for M;
		say AfterDominationComment 2 of M;
		now player-fucking is DOMINANT-NEUTRAL;
	otherwise:
		say "You force [NameDesc of M] onto [his of M] hands and knees, making sure to grind your [unless penis is penis-erect]'growing' [end if]erection between [his of M] asscheeks as you unclip [his of M] loincloth.[line break][speech style of M]'You have bested me, so you may use my body, but I refuse to bear the seed of an inferior [if the player is gendered male]man[otherwise]phallus[end if].'[roman type][line break][big his of M] words sting, and so does [his of M] disdainful glance at your [sexual-player-penis], but the thought of cumming inside such a sexy [man of M] already has you pretty hard. You decide to let it go, unclipping [his of M] loincloth and immediately bury your [SexDesc of penis] into [his of M] [HoleDesc of M]. The scowl never leaves [his of M] face the whole time you're fucking [him of M], and [he of M] occasionally glances over [his of M] shoulder as if to urge you to finish sooner. You're too psyched to do [him of M] to feel bothered by it, so it's not long at all before you have to pull out and shoot your [load] on the floor. [big he of M] gives you an ominous look.";
		now player-fucking is DOMINANT-SHAMEFUL;
		say AfterDominationComment 1 of M;
	if M is male, AnalGet;
	otherwise FuckGet;
	orgasm;
	increase the times-seeded of M by 1.

To anal penetration dominate (M - a gladiator):
	if the sexual-penis-length > 8:
		if M is male or lady fetish is 2:
			say "You force [NameDesc of M] onto [his of M] hands and knees.[line break][speech style of M]'I would be honoured to service you.'[roman type][line break][big he of M] pushes [his of M] [ChestDesc of M] up with [his of M] arms, forming a perfect 'O' shape with [his of M] lips. Unimpressed, you turn [him of M] around and tear off [his of M] loincloth, giving [him of M] a firm spank as you line up your tip with [his of M] hole. [big he of M] looks over [big he of M] shoulder, wide eyed.[line break][speech style of M]'Wait! I haven't recovered from-!'[roman type][line break]You cram your [SexDesc of penis] inside [him of M] without waiting for the rest, making sure to groan your satisfaction right into [his of M] ear. [big he of M]'s tight, but [if the times-dominated of M < 4]you're probably the biggest guy [he of M]'s taken anyway[otherwise]thanks to you, not as tight as [he of M] used to be[end if]. You enjoy yourself as much as you can, answering every squeal with a hard smack of [his of M] ass, and punishing every gasp with a merciless squeezing of [his of M] [if lady fetish is 2]pecs[otherwise]big tits[end if]. Eventually you lose control and slam it in as deep as it will go, [if the player is possessing a scrotum]slapping [his of M] balls with your own[otherwise]grinding [his of M] face into the ground[end if] as you pump your load straight up [his of M] ass. [big he of M] can't do much more than tremble and pant as you pull out and drop a few quick ropes on [his of M] back.[line break]";
			cutshow figure of gladiator cutscene 16 for M;
			if the player is a bit horny and the times-dominated of M > 4:
				say "[big he of M] can't do much more than tremble and pant as you pull out and flip [him of M] over.[line break][first custom style]'Want more, bitch?'[roman type][line break][big he of M] looks away from you and shakes [his of M] head, but the twitching erection between [his of M] legs tells a different story.[line break][first custom style]'Oh well, suit yourself'[roman type][line break]You grab [him of M] by the hair, jamming [his of M] face onto your slimy [sexual-player-penis]. [big he of M] gags lewdly, tears welling up in [his of M] eyes as you mercilessly force your [SexShaft] down [his of M] throat, but never letting [his of M] gaze wander away from your face. You savour it a little more this time, making sure [he of M] thoroughly cleans your [sexual-player-penis] before [if bukkake fetish is 1]pulling out and unloading all over [his of M] face. [big he of M] glares up at you defiantly, rock hard and with one eye glued shut[otherwise]emptying your balls down [his of M] throat. [big he of M] glares up at you defiantly as [he of M] pulls off, rock hard and hair matted to [his of M] face[end if].";
				obsceneDignify;
				SilentlyDifficultyUp M by 1;
				BlowGet;
				say AfterDominationComment 3 of M;
			otherwise:
				severeDignify;
				say AfterDominationComment 5 of M;
			orgasm;
			AnalGet;
		otherwise:
			say "You force [NameDesc of M] onto [his of M] hands and knees.[line break][speech style of M]'I would be honoured to bear the seed of such a fine warrior.'[roman type][line break][big he of M] unclips [his of M] loincloth, pulling apart [his of M] labia to expose a soaking wet pussy. Unimpressed, you spit in [his of M] ass, giving [him of M] a firm spank as you line up your tip with [his of M] hole. [big he of M] looks over [his of M] shoulder, wide eyed.[line break][speech style of M]'Wait! Don't put it in my-!'[roman type][line break]You cram your [SexDesc of penis] inside [him of M] without waiting for the rest, making sure to groan your satisfaction right into [his of M] ear. [if the times-dominated of M < 4][big he of M]'s tight, but you're probably the biggest guy [he of M]'s taken anyway[otherwise][big he of M]'s tight, but thanks to you, not as tight as [he of M] used to be[end if]. You enjoy yourself as much as you can, answering every squeal with a hard smack of [his of M] ass, and punishing every gasp with a merciless squeezing of [his of M] tits. Eventually you lose control and slam it in as deep as it will go, grinding [his of M] face into the ground as you pump your load straight up [his of M] ass.[line break]";
			cutshow figure of gladiator cutscene 16 for M;
			if the player is a bit horny and the times-dominated of M > 4:
				say "[big he of M] can't do much more than tremble and pant as you pull out and flip [him of M] over.[line break][first custom style]'Want more, bitch?'[roman type][line break][big he of M] looks away from you and shakes [his of M] head, but you can see how wet [he of M] is.[line break][first custom style]'Oh well, suit yourself'[roman type][line break]You grab [him of M] by the hair, jamming your slimy [sexual-player-penis] into [his of M] mouth. [big he of M] gags lewdly, tears welling up in [his of M] eyes as you mercilessly force your [SexShaft] down [his of M] throat, but never letting [his of M] gaze wander away from your face. You hold [his of M] hands above [his of M] head as you use [him of M], making sure [he of M] has no way to satisfy [himself of M] at all. You savour it a little more this time, making sure [he of M] thoroughly cleans your [sexual-player-penis] before [if bukkake fetish is 1]pulling out and unloading all over [his of M] face. [big he of M] glares up at you defiantly, chest heaving and one eye glued shut[otherwise]emptying your balls down [his of M] throat. [big he of M] glares up at you defiantly as [he of M] pulls off, chest heaving and hair matted to [his of M] face[end if]";
				BlowGet;
				obsceneDignify;
				SilentlyDifficultyUp M by 1;
				say AfterDominationComment 3 of M;
			otherwise:
				severeDignify;
				say AfterDominationComment 5 of M;
			orgasm;
			AnalGet;
	otherwise if the sexual-penis-length > 6:
		if M is male or lady fetish is 2:
			say "You force [NameDesc of M] onto [his of M] hands and knees.[line break][speech style of M]'Very well, you have bested me. It is my duty to service you.'[roman type][line break][big he of M] pushes [his of M] [ChestDesc of M] up with [his of M] arms, allowing [his of M] mouth to fall open with as much dignity as [he of M] can. You turn [him of M] around and tear off [his of M] loincloth, giving the gladiator a firm spank as you spit in [his of M] ass. [big he of M] looks over [his of M] shoulder, wide eyed.[line break][speech style of M]'Wait! I'm still sore from-!'[roman type][line break]You cram your [SexDesc of penis] into [him of M], and without waiting for a response, immediately begin to thrust. [if the times-dominated of M < 4][big he of M]'s tight, but that's not a big deal if you take it slow.[otherwise][big he of M]'s tight, but thanks to you, not as tight as [he of M] used to be[end if]. It doesn't take long for [him of M] to start pushing back against you, panting quietly as [if M is male][he of M] strokes [his of M] neglected cock[otherwise][his of M] chastity cage bobs uselessly underneath him[end if]. You thoroughly savour the experience, and when you're satisfied, you slam it all the way in [if the player is possessing a scrotum]making sure your balls touch as you[otherwise]and[end if] fill [his of M] naughty little [asshole] with your load.";
		otherwise:
			say "You force [NameDesc of M] onto [his of M] hands and knees.[line break][speech style of M]'Very well, you have bested me. You are free to use my body as you see fit.'[roman type][line break][big he of M] unclips [his of M] loincloth, pulling apart [his of M] labia to expose a soaking wet pussy. It's enticing, but you decide you go for the hole above it, spitting in [his of M] ass and giving [him of M] a firm spank as you line up your tip with [his of M] hole. [big he of M] looks over [his of M] shoulder, wide eyed.[line break][speech style of M]'Wait! Don't put it in my-!'[roman type][line break]You cram your [SexDesc of penis] into [him of M], and without waiting for a response, immediately begin to thrust. [if the times-dominated of M < 4][big he of M]'s tight, but that's not a big deal if you take it slow.[otherwise][big he of M]'s tight, but thanks to you, not as tight as [he of M] used to be[end if]. It doesn't take long for [him of M] to start pushing back against you, panting quietly as [he of M] paws at [his of M] neglected pussy. You thoroughly savour the experience, and when you're satisfied, you slam it all the way in and fill [his of M] dirty little [asshole] with your load.";
		AnalGet;
		cutshow figure of gladiator cutscene 16 for M;
		strongDignify;
		say AfterDominationComment 3 of M;
		orgasm;
	otherwise if the sexual-penis-length > 4:
		if M is male or lady fetish is 2:
			say "You force [NameDesc of M] onto [his of M] hands and knees.[line break][speech style of M]'Very well, you have bested me. I will pleasure you for as long as you choose.'[roman type][line break][big he of M] pushes [his of M] [ChestDesc of M] up with [his of M] arms, allowing [his of M] mouth to fall open with as much dignity as [he of M] can. You decide to go for a different prize, walking around behind [him of M] and tearing off [his of M] loincloth. [big he of M] looks over [his of M] shoulder, wide eyed.[line break][speech style of M]'Wait! I'm still sore from-!'[roman type][line break]You cram your [SexDesc of penis] inside [him of M], add some spit for lube, immediately begin to thrust. [big he of M] pouts for a little while, but before long [he of M] starts pushing back against you, moaning as [if M is male][he of M] pumps [his of M] neglected cock[otherwise][his of M] chastity cage bobs uselessly underneath [him of M][end if]. You lose control and cum a little faster than you mean to, grunting as you shoot your load into [his of M] asshole.";
		otherwise:
			say "You force [NameDesc of M] onto [his of M] hands and knees.[line break][speech style of M]'Very well, you have bested me. You are free to use my body as you see fit.'[roman type][line break][big he of M] unclips [his of M] loincloth, pulling apart [his of M] labia to expose a soaking wet pussy. It's enticing, but you decide you go for the hole above it, spitting in [his of M] ass and giving [him of M] a firm spank as you line up your tip with [his of M] hole. [big he of M] looks over [his of M] shoulder, wide eyed.[line break][speech style of M]'Wait! Don't put it in my-!'[roman type][line break]You cram your [SexDesc of penis] inside [him of M], and without waiting for a response, immediately begin to thrust. [big he of M] pouts for a little while, but before long [he of M] starts pushing back against you, moaning as [he of M] paws at [his of M] neglected pussy. You lose control and cum a little faster than you mean to, sighing as you shoot your load into [his of M] asshole.";
		AnalGet;
		cutshow figure of gladiator cutscene 16 for M;
		moderateDignify;
		say AfterDominationComment 3 of M;
		orgasm;
	otherwise:
		say "You force [NameDesc of M] onto [his of M] hands and knees, hurriedly unclipping [his of M] loincloth as [if the player is a bit horny]your achingly hard [sexual-player-penis] drools all over the floor[otherwise]your [SexDesc of penis] surges to attention[end if].[line break][speech style of M]'Stop right there. I will not allow an inferior [if the player is presenting as female]woman[otherwise]man[end if] like you to sully my body with [his of the player] seed.'[roman type][line break][big he of M] snaps, causing you to freeze mid-penetration.[line break][speech style of M]'Your victory gives you the right to use my body, but I promise you will regret it if you put a single drop of that vile swill inside of me.'[roman type][line break]You tremble. It sounds like [he of M] really means business, and you're pretty sure [he of M] let you win anyway, so you might as well do as [he of M] says. You pull your [sexual-player-penis] out of [his of M] [if M is male or lady fetish is 2]ass[otherwise]pussy[end if], gingerly nestling it between [his of M] spacious brown asscheeks and vigorously hump them until you shoot a [load] all over [his of M] back. [big he of M] props [himself of M] up [if M is swordless]against a wall, looking[otherwise]on [his of M] sword, looking[end if] over [his of M] shoulder with undisguised disgust on [his of M] face.";
		trivialDignify;
		now player-fucking is DOMINANT-NEUTRAL;
		say AfterDominationComment 1 of M;
	SilentlyDifficultyUp M by 1;
	increase the times-seeded of M by 1.

To say AfterDominationComment (N - a number) of (M - a gladiator):
	if N is 4:[you rode her, but decided to skip a creampie]
		say "[speech style of M]'[one of]I would have done the same. Next time, warrior.[or]A winner must not have regrets. Next time, warrior.'[or]You did defeat me, after all. Next time, warrior.'[in random order][roman type]";
	otherwise if the player is gendered female and N < 4:[she's more cordial with women]
		say "[speech style of M]'[one of]I will defeat you next time. Or, I will honour you again as the better warrior'[or].'[or]I am glad I lost to you and not some disgusting man. However, I will not lose again.[at random][roman type]";
	otherwise if N is 3:[you pissed her off]
		say "[speech style of M]'[one of]I will make sure you feel all that I have felt.'[or]Fool. You should have killed me.'[or]I wonder, will you remember this moment when I have beaten you?'[at random][roman type][big he of M] laughs coldly.";
	otherwise if N is 2:[she got one over on you or she's neutral about it]
		say "[speech style of M]'[one of]Hmph. The battle is never over.'[or]Did you enjoy that, warrior?'[or]Next time, don't let your guard down.'[at random][roman type]";
	otherwise if N is 1:[SPH]
		say "[line break][speech style of M]'You will not be this lucky next time we meet. For your sake, I hope you've made something of that pitiful thing you call a manhood by then.'[roman type][line break]";
	otherwise:[she had fun!]
		say "[speech style of M]'[one of]T-this will go differently next time...[or]I hope y-you enjoyed that. B-beating me will not be so easy next time...'[or][if player-fucker is penis]Dicking[otherwise]Fucking[end if] me-... Beating me will not be so easy next time.'[in random order][roman type]";

Part 4 - Conversation

To say RewardFlav of (M - a gladiator) for (T - nail-bomb):
	say "[BigNameDesc of M] removes the pink bomb from [his of M] belt.[line break][speech style of M]'If you find yourself in an unfair fight, this might prove invaluable.'[roman type][line break]".

To say OfferFriendshipFlav of (M - a gladiator):
	say "[speech style of M][if M is guardian]'I'm so proud of how much you've grown[otherwise if M is ally]'I wish you well in your next glorious battle[otherwise if M is buddy]'Continue to carry yourself with pride and dignity and the world shall be your oyster[otherwise if M is acquaintance]'You have gained my respect, for now[otherwise]'Hmm, perhaps you don't deserve to be judged quite so harshly[end if].'[roman type][line break]".

To decide which number is the bartering value of (C - a cupless bra) to (M - a gladiator):
	decide on 3.

To say MonsterOfferAcceptFlav of (M - a gladiator) to (C - a cupless bra):
	say "[BigNameDesc of M] nods thoughtfully.[line break][speech style of M]'Feminine and leaves my breasts exposed no matter what their size. I'll take it.'[roman type][line break]".

To IdentifiablePosterReaction of (M - a gladiator):
	if M is male, say "[BigNameDesc of M] looks at you, blinks, then looks back to the poster.[line break][speech style of M]'You are a complete and total disgrace to this world.'[roman type][line break]";
	otherwise say "[BigNameDesc of M] looks at you, blinks, then looks back to the poster.[line break][speech style of M]'This is you in the image? [if M is friendly]I'm sorry, I cannot be seen to associate with such an unwomanly harlot[otherwise]You are even more of a disgrace than I realised[end if].'[roman type][line break]";
	say "You turn bright red with shame.";
	if M is friendly:
		say "[BigNameDesc of M] leaves the way [he of M] came.";
		destroy M;
	humiliate the lewdness of a random poster in the location of the player * 2.

To UnidentifiablePosterReaction of (M - a gladiator) with (P - a poster):
	say "[speech style of M]'Be glad you are not the disgraced [man of P] in this image.'[roman type][line break]";
	say "You turn bright red but don't say a word.";
	humiliate the lewdness of a random poster in the location of the player.

Section 1 - Greeting

[I couldn't think of much else for the gladiator's unfriendly response, which is unfortunate since it will be the only one seen for most players. Submissiveresponse is fairly robust, but once again, it is less depthy when the gladiator is unfriendly.]
To say FirstResponse of (M - a gladiator):
	if the largeness of breasts > 6 and the breast-happy of M is 1:
		say "[speech style of M]'[one of]What impressive breasts...-ahem, hello sister! Welcome!'[or]Hello. It is rare I meet such a well endowed woman out of the blue.'[at random][roman type][line break]";
	otherwise if the class of the player is virgin warrior:
		say "[speech style of M]'[one of]'Welcome......I see you follow the path of purity. Watch yourself, sister.'[or]Welcome, warrior of purity. Not many can walk such a difficult path.'[at random][roman type][line break]";
	otherwise if the class of the player is barbarian:
		say "[speech style of M]'[one of]Welcome, sister! I see you follow the barbarian's path!'[or]Welcome, barbarian!'[at random][roman type][line break]";
	otherwise:
		say "[speech style of M]'Welcome, new sister!'[roman type][line break]".

To say RepeatResponse of (M - a gladiator):
	if M is unfriendly:
		if M is male and the class of the player is virgin warrior:
			say "[speech style of M]'[one of]Savour your last moments as a warrior.'[or]When I am finished with you, you won't even be a warrior.'[or]When I am through with you, you will be a warrior no longer.'[or]Prepare yourself. This is the last time you will ever be called a warrior.'[at random][roman type][line break]";
		otherwise if M is male and the player is a sissy:
			say "[speech style of M]'[one of]I will show you your place, sissy.[or]Even I carry a penis better than you.'[or]I hope you are ready to beg for mercy.'[or]On your knees. I will not play this game with you, sissy.'[or]Do not waste my time, sissy. Get on your knees.'[or]You know your place, sissy. Get on your knees.'[or]Do not play games, sissy, you know what I have planned for you.'[or]I may not be a true woman anymore, but I can definitely handle you.'[at random][roman type][line break]";
		otherwise if M is male:
			say "[speech style of M]'[one of]Shut up, and take what's coming to you!'[or]Won't you be silent while I punish you?!'[or]Gaah! Silence!'[at random][roman type][line break]";
		otherwise if the class of the player is virgin warrior or the class of the player is barbarian:
			say "[speech style of M]'[one of]Your path is a worthy one, but it is not the path to becoming a true woman!'[or]There is only one path to becoming a true woman!'[or]I must put you on the right path to becoming a true woman!'[at random][roman type][line break]";
		otherwise if the class of the player is princess:
			say "[speech style of M]'[one of]I acknowledge none but the rule of true womanhood!'[or]We will speak as equals, or not at all!'[or]The crown cannot teach you the way of true womanhood, but I can!'[at random][roman type][line break]";
		otherwise if the class of the player is fertility goddess:
			say "[speech style of M]'[one of]You of all people should know how important it is to attain true womanhood!'[or]How can you call yourself a goddess without the gift of true womanhood'[or]I answer to another power! TRUE womanhood![at random][roman type][line break]";
		otherwise:
			say "[speech style of M]'[one of]I only associate with real women!'[or]Talk to me when you have become a real woman![or]We will talk when you have become a real woman!'[at random][roman type][line break]";
	otherwise:
		if the breast-happy of M is 1:
			say "[speech style of M]'[one of]There should be more women in the world like you and I.'[or]The size of your breasts is proof of your status as a woman.'[or]Ah, [NameBimbo], my new sister!'[or]Greetings, sister.'[at random][roman type][line break]";
		otherwise if the class of the player is virgin warrior:
			say "[speech style of M]'[one of]Hello, warrior. Impressive that you have remained on the path of purity.'[or]Hello, warrior of purity!'[or]Hello! Your path is one of strength, martial virgin.'[at random][roman type][line break]";
		otherwise:
			say "[speech style of M]'[one of]Your breasts are starting to look a bit on the small side again, you should fix that.'[or]Your breasts [if the largeness of breasts > 6]are big enough to be worthy of respect, but they could[otherwise]can[end if] always be bigger.'[or]Don't let your breasts get too small, sister. They are the only thing that can make you a real woman.'[at random][roman type][line break]".

To say UnAnnoyedResponse of (M - a gladiator):
	say "[speech style of M]'[one of]Take it, whore!'[or]How does it feel when I punish you, whore!'[or][if the player is gendered male]How does it feel to get fucked by a [man of M]?'[otherwise]I said you would pay!'[end if][at random][roman type][line break]";

To say MildAnnoyedResponse of (M - a gladiator):
	say "[speech style of M]'[one of]You disgust me!'[or]Silence, whore!'[or]Gaah! Silence, NOW!'[at random][roman type]";

To say AnnoyedResponse of (M - a gladiator):
	say "[speech style of M]'[one of]BE SILENT!'[or]SHUT UP, WHORE!'[or]SHUT! UP!'[at random][roman type]";

To say InvitationAccepted of (M - a gladiator) with (N - a monster):
	if M is male:
		say "[speech style of M]'[one of]Getting my attention was a mistake, whore.'[or]Fool. Did you think I wouldn't take you up on that?'[or]Fine, whore. I will play your game.'[at random][roman type][line break][BigNameDesc of M] gives you a cold stare.[line break]";
	otherwise:
		say "[speech style of M]'How dare you speak that way. You shame yourself, sister!'[roman type][line break][BigNameDesc of M] gives you a cold stare.[line break]".[this should lead nicely into the watersports scene]

To say InvitationRejected of (M - a gladiator) with (N - a monster):
	if M is gendered male:
		say "[speech style of M]'[one of]Spoken like the whore you are.'[or]The only thing worse than being a whore is enjoying it.'[or]If I join in, it will be for my own pleasure, whore.'[at random][roman type][line break][BigNameDesc of M] gives you a cold stare.[line break]";
	otherwise:
		say "[speech style of M]'[one of]You disgust me.'[or]I'm embarrassed I actually thought you could ever be a true woman.'[or]A dignified woman does not say such things.'[or]It is clear you are no different from a common slut if you say such things.'[at random][roman type][line break][BigNameDesc of M] gives you a cold stare.[line break]".

To say AssistanceRejected of (M - a gladiator) with (N - a monster):
	if M is unfriendly:
		say "[speech style of M]'[one of]As if I would help YOU!'[or]I'm never helping you again.'[or]You deserve everything you get... and more'[or]Never.'[or]I will not help you. But I might help someone else.'[at random][roman type][line break]";
	otherwise:
		say "[speech style of M]'[one of]A true woman would be ashamed to ask for help, and I am ashamed you thought I would help you.'[or]A good warrior would never have gotten into this position in the first place. You are on your own.'[or]Accept your punishment like a true woman should.[if the times-dominated of M > 0] I know I did.'[otherwise]'[end if][or]I will not fight your battles.'[at random][roman type][line break]".

To say DominantResponse of (M - a gladiator):
	if M is unfriendly:
		say TauntResponse of M;
	otherwise:
		if the player is gendered female:
			say "[speech style of M]'[one of][big please]. It is an honour to have lost to such a fine warrior.'[or]There are no hard feelings. You were the better warrior.'[or]Make no mistake, before was a simple sparring match. Perhaps you are ready to fight me for real?'[at random][roman type][line break]";
		otherwise if the size of penis < 4:
			say "[speech style of M]'[one of]Losing to men is embarrassing, especially inferior ones like you. However, you proved yourself as the greater warrior.'[or]Of all men that have beaten me, you are by far the weakest. However, you beat me all the same.'[or]When I say I accept my punishment, I mean it. I deserve to be punished for allowing myself to lose to an inferior [man of the player] like you.'[at random][roman type][line break]";
		otherwise if the player is gendered male:
			say "[speech style of M]'[one of]If you want to taste the pleasure of victory, you will have to beat me again. I promise it will not be as easy as last time.'[or]A true woman does not submit. If you want my body, you will fight me for it.'[or]Talk is cheap, boy. If you want to fuck me, fight me. If not, hold your tongue. I am not afraid to cut it off.'[at random][roman type][line break]".

To compute taunt acceptance effect of (M - a gladiator):
	if the health of M > 5, decrease the health of M by 5.

To say TauntAccepted of (M - a gladiator):
	if the player is gendered male:
		say "[speech style of M]'[one of]D-do not talk to me that way.'[or]W-what happened before was just a fluke.'[or]Our previous...arrangement was a fluke. Don't bring it up again.'[at random][roman type][line break][BigNameDesc of M] seems a little less determined to beat you!";
	otherwise:
		say "[speech style of M]'[one of]I-I am above such petty taunts.'[or]Y-you taunt me? H-how stupid!'[or]Y-You are a better warrior, after all. B-but that has no bearing on our present fight!'[at random][roman type][line break][BigNameDesc of M] seems a little less determined to beat you!".

To say PleadRejected of (M - a gladiator):
	say "[speech style of M]'[one of]You will get no sympathy from me!'[or]I have no more mercy for you!'[at random][roman type][line break]".

To say SubmissiveResponse of (M - a gladiator):
	if M is unfriendly:
		if M is male, say "[speech style of M]'[one of]You enjoyed it? How disgusting.'[or]You liked being punished? Disgusting.'[at random][roman type][line break]";
		otherwise say "[speech style of M]'[one of]A true woman would never say something like that!'[or]A true woman would never act so undignified!'[or]It is clear only one of us is a dignified woman!'[at random][roman type][line break]";
	otherwise:
		say "[speech style of M]'W-well, I'm glad you enjoyed yourself.'[roman type][line break]".

To say AttentionExceeded of (M - a gladiator) with (N - a monster):
	say "[speech style of M]'I will do far more than simply watch.'[roman type][line break]".

To say AttentionAccepted of (M - a gladiator) with (N - a monster):
	say "[speech style of M]'Fine. I will watch you embarrass yourself.'[roman type][line break]".

Section 2 - Questioning

To compute teaching of (M - a gladiator):
	if the player is a flatchested trap:
		say "[speech style of M]'I have nothing to teach [if tg fetish >= 1]you until you turn into a proper woman[otherwise]a worthless imp like you[end if].'[roman type][line break]";
	otherwise if diaper quest is 1:
		if the player is gendered male:
			say "[speech style of M]'I only share my secrets with other women.'[roman type][line break]";
		otherwise:
			say "[speech style of M]'If you carry your chest in a certain manner, walking around topless can make you look like a sexually mature adult rather than a child who can't dress [himself of the player]. Here, let me show you.'[roman type][line break]";
			teach titshow;
	otherwise:
		say "[speech style of M]'[if the largeness of breasts < 5]When you have impressive breasts like mine, you[otherwise]Let me show you how to make sure your breasts don't hinder your combat. You[end if] want to strike from the elbow, like this...'[roman type][line break]";
		teach titshow;
	alwayscutshow figure of gladiator interact 10 for M.

To say WhereAnswer of (M - a gladiator):
	say "[speech style of M]'The dungeons of Bimbacia. Not a safe place for any but the most powerful of women.'[roman type][line break]".

To say WhoAnswer of (M - a gladiator):
	say "[speech style of M]'[if M is proud-gladiator]Xena[otherwise if M is determined gladiator]Andrea[otherwise if M is amazonian gladiator]Fiora[otherwise]Vi[end if] the gladiator!'[roman type][line break]".

To say StoryAnswer of (M - a gladiator):
	if lady fetish is 2:
		say "[speech style of M]'[one of]I was trained as a gladiator in the arena here. Now I am freed and live a noble life, trying to encourage my sisters to better themselves in any way I can!'[or]I was once an adventurer like you, but in a moment of arrogance, I allowed myself to be bested by a royal guard. After he was done with me, I realised my time is best spent helping young warriors to become the best they can be!'[or]Originally, I pursued womanhood for myself, and myself alone. However, I have now realised that all young warriors should cast off their masculinity, and so I must guide them!'[or]I entered this dungeon much like you, alone and helpless before the desires of those around me. However, with the help of my sisters, I have grown beyond masculinity, and now search for true womanhood'[at random][roman type][line break]";
	otherwise:
		say "[speech style of M]'[one of]I was trained as a gladiator in the arena here. Now I am freed and live a noble life, trying to encourage my sisters to better themselves in any way I can!'[or]I was once an adventurer like you, but in a moment of arrogance, I allowed myself to be bested by a royal guard. After he was done with me, I realised my time was best spent helping young warriors to become the best they can be!'[or]Originally, I was a simple wench, but after praying at the sacred altar, my body was transformed and I became a true woman.'[or]I entered this dungeon much like you, helpless and alone, but with the help of my sisters, I defeated every man to ever walk this dungeon, and thus became a true woman.'[at random][roman type][line break]".

To say EscapeAnswer of (M - a gladiator):
	say "[speech style of M]'[one of]Going upwards is the key to victory. However if you go forward before you are ready, you will find yourself unable to deal with the beasts you may find above.'[or]There is no safety in progress. Only when you have the will to rise beyond your girlish fears, will you truly find your way forward.'[or]You must rise above the stony walls of this dungeon to explore the free world beyond. But make no mistake, even a powerful warrior like me could not venture there without being prepared to fight.'[at random][roman type][line break]".

To say AdviceAnswer of (M - a gladiator):
	say "[speech style of M]'[if diaper quest is 1]Some people will be more offended if they see you dressed like a slut than if they see you wearing one or two piece of childish clothing. Others are the opposite. It's difficult to [please] everyone.'[otherwise][one of]If your body is too voluptuous, you will get tired of standing much more quickly. Since it's obviously very important to have outstanding breasts, it would probably be a good idea to try and regulate your belly and hip size.'[or]If you are still getting used to the weight of your breasts, a bra will help significantly. Although, a true woman always keeps her chest proudly on display.'[or]You may think that wearing heavy armour will protect you. As a young warrior, I thought the same, but the burden of its weight brought me to my knees in combat more times than I care to admit. That is how I learned the best way to fight. In the nude!'[or]A true woman should not rely on armour to protect herself. You will find that honing your skills as a warrior will preserve your health much more than a flimsy scrap of metal, and if you do find yourself on the wrong end of a loss, having your chest exposed may help you in more ways than you realise.'[at random][end if][roman type][line break]".

Section 3 - Drink Requesting

[since the gladiator does the same thing regardless, one function can simply link to another]

To compute friendly drink of (M - a gladiator):
	now M is interested;
	if diaper quest is 1:
		say "[big he of M] smiles mischievously.[line break][speech style of M]'You can, but you'll have to drink it straight from the tap.'[roman type][line break][big he of M] holds one of [his of M] dark nipples towards your face. Do you let [him of M] breastfeed you? ";
		if the player is bimbo consenting:
			compute forcefeed of M;
		otherwise:
			say "[big he of M] looks a bit disappointed. You hope that you haven't upset [him of M].";
			FavourDown M;
			if M is unfriendly, say "[speech style of M]'Oh I see, maybe you need convincing...'[roman type][line break][BigNameDesc of M] takes an aggressive stance.";
	otherwise if the player is not top heavy:
		say "[big he of M] grins and pulls out a small flask. You snatch it from [him of M] and down it in one. You feel much less thirsty, and are about to thank [him of M], but suddenly you feel your chest rumble. You watch [if the bimbo of the player < 7]in horror [end if]as your breasts visibly grow in front of you. The gladiator laughs heartily then seems to lose interest.";
		cutshow figure of gladiator cutscene 13 for M;
		StomachUp 2;
		bore M;
		allocate 6 seconds;
		bustup 2;
		if lactation fetish is 1, milkup 2;
	otherwise:
		say "[big he of M] grins and pulls out a small flask. You snatch it from [him of M] and down it in one. You feel much less thirsty, and thank [him of M]. The gladiator seems mildly bemused but then simply smiles.";
		stomachup 2;
		bore M;
		allocate 6 seconds;
	say "[line break]".

To compute unfriendly drink of (M - a gladiator):
	if diaper quest is 1:
		if M is grabbing the player:
			say "[speech style of M]'Maybe later, little one!'[roman type][line break]";
		otherwise if M is upright:
			say "[speech style of M]'Get on your knees and I'll think about it!'[roman type][line break]";
		otherwise if M is able to forcefeed:
			say "[BigNameDesc of M] smiles. It looks like that's exactly what [he of M] had in mind.";
			compute forcefeed of M;
		otherwise:
			say "[BigNameDesc of M] frowns.[line break][speech style of M]'You look a bit busy right now!'[roman type][line break]";
	otherwise if M is male:
		say "[speech style of M]'If I did have a drink, do you really think I would give it to YOU?!'[roman type][line break]";
	otherwise:
		compute friendly drink of M.

[To compute desperate drinking to (M - a gladiator):
	if M is male or the player is top heavy:
		say "You [if the player is upright]drop to your knees and [end if]beg [NameDesc of M] to give you something to drink.";
		compute unfriendly drink of M;
	otherwise:
		if the player is a flatchested trap:
			say "[if M is uninterested]You spot a [M]! You beg[him of M][otherwise]You can't control yourself - you beg [NameDesc of M][end if] to give you something to drink. [big he of M] grins and pulls out a small flask. You snatch it from [him of M] and down it in one. You feel much less thirsty, and are about to thank [him of M], but suddenly you feel your crotch rumble. ";
			PenisDown 1;
			say "The gladiator laughs heartily then seems to lose interest.";
		otherwise:
			say "[if M is uninterested]You spot a [M]! You beg [him of M][otherwise]You can't control yourself - you beg [NameDesc of M][end if] to give you something to drink. [big he of M] grins and pulls out a small flask. You snatch it from [him of M] and down it in one. You feel much less thirsty, and are about to thank [him of M], but suddenly you feel your chest rumble. You watch [if the bimbo of the player < 7]in horror [end if]as your breasts visibly grow in front of you. The gladiator laughs heartily then seems to lose interest.";
			bustup 2;
			if lactation fetish is 1, milkup 2;
		StomachUp 2;
		bore M for 400 seconds;
		now the stance of the player is 1.]

Definition: a gladiator is willing to give snacks: decide yes.

Section 5 - Dismissal

To say DismissalResponseRoyal of (M - a gladiator):
	if M is interested, say "[BigNameDesc of M] smirks.[line break][speech style of M]'I'm sorry Princess, but [if diaper quest is 0]I must admit I have my doubts about you. I will continue to follow and assess you for now.'[roman type][line break][otherwise if there is a currently at least partially visible diaper]I must admit I am too curious as to whether you truly are unable to make it to the toilet in time.'[roman type][line break][big he of M] touches the front of your diaper with one finger.[otherwise]I believe there is a chance that you'll be needing some of my... [']services['].'[roman type][line break][end if]";
	otherwise say "[BigNameDesc of M] [one of]rolls [him of M] eyes and [or][or][or][then at random]bows slightly.[line break][speech style of M]'[one of]Your Highness[or]Princess[or]My Lady[then at random].'[roman type][line break]".

To say DismissalResponseVixen of (M - a gladiator):
	say "[speech style of M]'[if M is interested]That is none of my concern[otherwise]What?! Stay here, I shall investigate[end if].'[roman type][line break]".

To say DismissalResponseToilet of (M - a gladiator):
	if diaper quest is 0, say "[speech style of M]'[if M is interested]I don't like your tone. No, I don't think I shall be leaving you alone any time soon.'[otherwise]I see. I will leave you in peace for now.'[end if][roman type][line break]";
	otherwise say "[speech style of M]'[if the diaper-duration of M > 0]And why exactly would I leave you unsupervised next to a body of water when I have made it my business to ensure you use diapers for the foreseeable future?'[otherwise if M is not interested][one of]Quite arrogant[or]A bit cocky[or]Arrogant[cycling], aren't we? Well, we'll see how long that lasts. I'll be keeping my eye on you. But not in that... I mean, I shall leave you for now.'[otherwise if the player is feeling submissive]No, sweetie, not this time. Good [boy of the player] for asking so respectfully, though.'[otherwise]Are you trying to tell me you can't even hold it in for two more minutes? If you really can't hold it in for that long I want to see it with my own eyes.'[end if][roman type][line break]".

To say DismissalResponseBursting of (M - a gladiator):
	if diaper messing >= 3 and (the player is feeling full or the total squirtable fill of belly > 0):
		say "[speech style of M]'[if M is interested]No! I DEMAND that you hold it in while I remain alongside you, cretin! Or there will be hell to pay.'[otherwise]I must have been mistaken, I could have sworn I heard you say... never mind. I'll be on my way now.'[end if][roman type][line break]";
	otherwise if the player is bursting:
		if the diaper addiction of the player > 14, say "[speech style of M]'[if M is interested and there is a worn diaper]You do know that I will not treat you kindly if you do.'[otherwise if M is interested]If you do lose control, all you will do is prove to me that you are no better than a baby.'[otherwise]I will leave you to find your way to the toilets on your own.'[end if][roman type][line break]";
		otherwise say "[speech style of M]'[if diaper quest is 1 and M is interested and there is a worn diaper]I shall not leave you alone. And if you do lose control in front of me, all you will do is prove to me that you are no better than a baby.'[otherwise if diaper quest is 1 and M is interested]Absolutely not. It is you who must prove to me that you can hold it in until I let you go.'[otherwise if M is interested]There will be no privacy. But you will lose my respect if you cannot restrain yourself in my presence.'[otherwise if there is a worn diaper]Fine, I will leave you and your padding in peace. Come to me if you truly are such a baby that you find yourself in need a change.'[otherwise]Fine. You know where the proper facilities are, I presume?'[end if][roman type][line break]";
	otherwise:
		if the player is a nympho, say "[speech style of M]'[if M is interested and there is a worn diaper]I will if I must. But if I end up having to give you a change, you'll be sorry.'[otherwise if M is interested]If you do that outside of a diaper, any respect I still hold for you will vanish immediately.'[otherwise]No thank you. Not today.'[end if][roman type][line break]";
		otherwise say "[speech style of M]'[if M is interested and diaper lover > 0]You can't expect me to have any respect for you if you can't hold it in for a little while longer.'[otherwise if M is interested]Anyone with any dignity would certainly not insult me by letting go until I have decided it is time for us to part.'[otherwise]Disgusting. Thank you for the warning.'[end if][roman type][line break]".

To say DismissalResponseStalker of (M - a gladiator):
	say DismissalResponseDefault of M.

To say DismissalResponseDefault of (M - a gladiator):
	say "[speech style of M]'How insulting! [if M is buddy]And to think I was beginning to respect you as an equal[otherwise if M is interested]Do you think we are equals, fool? I am following you because I don't trust you[otherwise]I shall not remain by your side if I'm just to be insulted all day[end if].'[roman type][line break]".

Part 5 - Variants

Section 1 - enlightened Gladiator

enlightened gladiator is a gladiator. The text-shortcut of enlightened gladiator is "ngl".

To say MediumDesc of (M - enlightened gladiator):
	say "enlightened [GladiatorCurse of M]gladiator".

Definition: enlightened gladiator is dungeon dwelling:
	if doomed is 5 and diaper quest is 0, decide yes;
	decide no.

Definition: enlightened gladiator is mansion dwelling:
	if doomed > 1 and diaper quest is 0, decide yes;
	decide no.

To decide which figure-name is the monster-image of (M - enlightened gladiator):
	if M is male, decide on figure of enlightened gladiator;
	otherwise decide on figure of gladiator.

To decide which figure-name is the unfriendly-monster-image of (M - enlightened gladiator):
	if M is male, decide on figure of unfriendly enlightened gladiator;
	decide on the monster-image of M.

To set up (M - enlightened gladiator):
	reset M;
	now the monstersetup of M is 1;
	now the health of M is the maxhealth of M;
	now the raw difficulty of M is the starting difficulty of M + 6;
	if doomed is 5, SilentlyDifficultyUp M by 4;
	now M is male.

To say SummoningFlav of (M - enlightened gladiator):
	if M is in the dungeon:
		if M is in the location of the player, say "A space opens up in the centre of the circle, and a broken sword flies through. Two muscular arms follow closely behind, flexing as a mostly naked [man of M] pulls [himself of M] through. [big he of M] climbs to [his of M] feet as the portal closes behind [him of M], absent-mindedly [if M is male]pumping [his of M] [LongDickDesc of M][otherwise]fingering [himself of M][end if] as [he of M] looks around.";
		otherwise say "You hear the sound of a sword hitting stone coming from another part of the dungeon.";
	otherwise:
		if M is in the location of the player, say "The mummy's wrappings rip audibly as the gladiator inside them bursts free, [if M is male]vigorously pumping [his of M] [LongDickDesc of M][otherwise]fingering [himself of M] madly[end if] as the mummy silently reforms behind [him of M], none the worse for the wear.";
		otherwise say "You hear fabric tearing coming from another part of the mansion.".

To compute (M - a monster) stomping (N - enlightened gladiator):
	if M is in the location of the player, say "[BigNameDesc of N] leaps into [NameDesc of M][']s arms. [BigNameDesc of M][']s [LongDickDesc of M] throbs ominously as [he of M] presses it against [NameDesc of N][']s asshole. [big he of N] screams.[line break][first custom style]'Yes! FUCK M-!'[roman type][line break]but before [he of N] has even finished [NameDesc of M] has started fucking and cumming inside [him of N]. You watch as [his of N] belly grows in front of your eyes. After [NameDesc of N] is 'full', [NameDesc of M] tosses [him of N] to the ground, where [he of N] promptly faints.";
	otherwise say "You hear a [man of M] shouting[line break][first custom style]'Yes! FUCK M-!'[roman type][line break]from [if N is nearby]nearby![otherwise]somewhere in the dungeon![end if]";
	now N is fucked-silly;
	now the sleep of N is 600.

To say PresentAcceptanceFlav of (M - enlightened gladiator):
	if presented-orifice is penis, say "[speech style of M]'Admittedly I prefer to use my own [DickDesc of M], but...'[roman type][line break][BigNameDesc of M] seems convinced by your request!";
	otherwise say "[speech style of M]'Do not be ashamed. Anyone would desire the [Dickdesc of M] of a true woman.'[roman type][line break][BigNameDesc of M] seems convinced by your request!".

To compute unique periodic effect of (M - enlightened gladiator):
	if M is awake and M is not dangerous and M is undefeated and M is not seduced:
		if the refractory-period of M < a random number between -200 and -120: [is she horny?]
			if M is in the location of the player, say "You see [NameDesc of M] begin to openly masturbate, shuddering with pleasure as [he of M] blows [his of M] load all over the ground.";
			SemenPuddleUp 2 in (the location of M);
			now the refractory-period of M is -4;
	otherwise:
		if the class of the player is maid or a random number between 1 and 5 > 3, increase the milkTimer of M by 1;
		if a random number between 30 and 100 <= the milkTimer of M:
			now the milkTimer of M is 0;
			if M is in the location of the player:
				say "[BigNameDesc of M] shivers as a glob of [semen] drips out of [his of M] [HoleDesc of M] onto the floor.";
			SemenPuddleUp 1 in (the location of M).

To say CreampieFlav of (M - enlightened gladiator) in (F - a fuckhole):
	say "[one of][BigNameDesc of M] roars with pleasure, tightening [his of M] grip as warm [semen] begins flowing inside of you. [big he of M] continues to fuck you until [his of M] [DickDesc of M] goes completely soft and slips out on its own. You finally feel [his of M] hands leave your hips as [he of M] stands up, somehow as energetic as ever.[or][BigNameDesc of M] grunts, [his of M] [DickDesc of M] throbbing as [he of M] unloads into your [variable F]. [big he of M] sighs in satisfaction and roughly shoves you away, still as horny as ever but no longer interested in you.[or]You're used to this series of events by now, and find yourself clenching around [NameDesc of M][']s [DickDesc of M] as [he of M] shoots off several powerful jets of [semen] deep inside you. You wait expectantly, and then after a few seconds feel [him of M] shove you away, and [he of M] gets up, having lost interest.[then at random]".

To compute (M - enlightened gladiator) entering breasts:
	say "[speech style of M]'What kind of woman would I be if I did not love breasts?'[roman type][line break][if the titfuck addiction of the player < 5]You hold your body still and try to think of other things as [NameDesc of M] roughly slides [his of M] [DickDesc of M] between your [BreastDesc], thrusting forcefully until[otherwise]You massage [NameDesc of M][']s [DickDesc of M] with your [BreastDesc], doing your best to keep up with [his of M] forceful thrusting until[end if] [he of M] reaches an insanely fast climax, spraying [semen] all over your chest, face, and even your hair.";
	AnnouncedSquirt semen on face by 2;
	AnnouncedSquirt semen on breasts by 2;
	BreastsSensitivityUp 2;
	say "[speech style of M]'That is the seed of a true woman. Wear it proudly.'[roman type][line break]";
	TimesSubmittedUp M by 1;
	Orgasm bore M.

To say DamageReactSubmissive of (M - an enlightened gladiator):
	say "The gladiator huffs as [he of M] fights to keep [his of M] balance, gnashing [his of M] teeth and rubbing[his of M] thighs together.".

[If she is NOT willing to creampie vagina, it means she pulls out and fucks the player anally]
To decide if (M - enlightened gladiator) is willing to creampie (F - vagina):
	if asshole is actually occupied or the number of worn top level ass protection clothing > 0, decide yes;
	if the openness of vagina <= a random number between 2 and 7, decide yes;
	decide no.[she always wants more]

To decide if (M - enlightened gladiator) is willing to creampie (F - asshole):
	decide yes.

To compute (M - enlightened gladiator) pulling out of (F - vagina):
	say PullOutFlav of M in F;
	compute M finishing in F;
	now M is not penetrating vagina;
	now the sex-length of M is 2;
	now M is penetrating asshole;
	ruin Asshole.

To say CondomPieFlav of (M - enlightened gladiator) in (F - a fuckhole):
	let F be a random fuckhole penetrated by M;
	say "[BigNameDesc of M] grunts, tightening [his of M] grip as the condom begins to fill up with warm [semen]. [big he of M] continues fucking you until [his of M] supply of [semen] has been completely and thoroughly emptied inside of it.[line break][speech style of M]'Hmph. A waste.'[roman type][line break]You feel [his of M] hands squeeze your hips as [he of M] pulls out and carefully peels the condom off.".

To say CondomFailFlav of (M - enlightened gladiator) in (F - a fuckhole):
	say "[BigNameDesc of M] roars with pleasure as warm [semen] begins pouring into you. [if the semen addiction of the player < 5]You immediately realize something is wrong, and so does [he of M], from the way [he of M] suddenly[otherwise if the semen addiction of the player < 11]It takes you a split second to realize something is wrong, so at first you don't realize why [he of M][otherwise]You're so in love with the feeling of taking [his of M] hot load that you don't realize something is strange until [he of M][end if] tightens [his of M] grip. [if the semen addiction of the player >= 11]Luckily, there's[otherwise]There's[end if] nothing you can do about the apparently broken condom as [he of M] continues to fuck you, only stopping when [his of M] [load] has been completely emptied into your [variable F].[line break][speech style of M]'[one of]Do you understand? Protection cannot be relied on. Offence is the only true way.'[or]If you were in control, I never could have broken the condom. Remember this.'[or]Protection fails. You must remember never to trust it.'[in random order][roman type][line break]You feel [his of M] hands squeeze your hips as [he of M] pulls out.";

To say DefaultDeepthroatDeclaration of (M - enlightened gladiator):
	say "[first custom style]'I have conquered the art of deepthroating, and so will you!'[roman type][line break]";
	cutshow figure of gladiator cutscene 8 for M.

To say PullOutFlav of (M - enlightened gladiator) in (F - vagina):
	say "[one of][BigNameDesc of M] roars with pleasure, tightening [his of M] grip as [his of M] [DickDesc of M] explodes deep inside your [vagina][or][BigNameDesc of M] grunts, hilting you as [his of M] throbbing [DickDesc of M] unloads into your [vagina][at random]. Semen dribbles down the side of your leg as [he of M] slowly pulls out, panting with excitement.[line break][speech style of M]'[one of]I came... but, I am still hard. What to do...'[or]This thing is never satisfied... I know of only one solution.'[at random][roman type][line break][big he of M] flattens you with [his of M] full weight, pressing [his of M] [ChestDesc of M] into your back as [he of M] grinds [his of M] [semen]-dripping knob between your cheeks. You feel [his of M] arms lock underneath you as [he of M] abruptly [one of]slams[or]rams[or]shoves[at random] [his of M] [LongDickDesc of M] into your [asshole] and begins pounding you at full force.".

To say angry punishment clothing destruction of (M - enlightened gladiator) on (C - a clothing):
	say "[first custom style]'Show me!'[roman type][line break]".

To say angry punishment accessory confiscation of (M - enlightened gladiator):
	say "[first custom style]'Mine.'[roman type][line break]".

To compute kneeling reaction of (M - enlightened gladiator):
	say "[one of][BigNameDesc of M] licks [his of M] lips, eagerly stroking [his of M] [LongDickDesc of M] to a full, pulsating erection.[or][BigNameDesc of M] grins.[line break][speech style of M]'That's right. Allow me to pound my teachings into you.'[roman type][line break][or][BigNameDesc of M] steps closer, dropping [his of M] hardening [Dickdesc of M] onto your face with a rakish grin.[line break][speech style of M]'There are a lot of perks to having one of these.'[roman type][line break][or][BigNameDesc of M] grins, lazily stroking [his of M] [LongDickDesc of M] as [he of M] circles around you.[in random order]";
	if the player is not shameless, say " You shiver with shame.";
	strongHumiliate.

To say UnfriendlyResponse of (M - enlightened gladiator):
	say "[speech style of M]'Get on your knees so I can teach you!'[roman type]";

To say PrepTaunt of (M - enlightened gladiator) in (F - asshole):
	do nothing.

To say PrepTaunt of (M - enlightened gladiator) in (F - vagina):
	if pregnancy fetish is 1, say "[speech style of M]'[one of]There are many paths to true womanhood. Some are inside you.'[or]After you are impregnated, you will make a worthy mate for the deep one.'[or]If you become pregnant, it is simply the will of the [great ones].'[at random][roman type][line break]";

To say VaginalVirginityTaunt of (M - enlightened gladiator):
	say "[line break][speech style of M]'[one of]A rare treat.'[or]Is it your first time? How lucky...'[at random][roman type][line break]".

To say AnalVirginityTaunt of (M - an enlightened gladiator):
	say "[line break][speech style of M]'[one of]Don't worry, I know what I am doing.'[or]Ooh, you must have been a virgin.'[at random][roman type][line break]".

To say WhoAnswer of (M - enlightened gladiator):
	say "[speech style of M]'Rita the gladiator!'[roman type][line break]".

To say StoryAnswer of (M - enlightened gladiator):
	if lady fetish is 2:
		say "[speech style of M]'I was kidnapped by the cultists who dwell in this place. Furiously I resisted, but there were too many. I experienced their ritual, and again, I resisted. But when I felt the touch of mighty [Azathot], I relented, and through the insight of the [great ones], and I beheld the TRUTH! The moment I began my search for true womanhood - is the moment I became a true woman!'[roman type][line break]";
	otherwise:
		say "[speech style of M]'Hoh? Doesn't my body say it all? Indeed, I have a male part, but I am no male. If a male part resides on a true woman, it becomes a true woman's part. Indeed, I was once a mere warrior of superior strength and bust, but a mere WARRIOR I am not. I am a true woman. INDEED, I have read the teachings of the [great ones], and I have known the touch of [Azathot]! Through [his of herald] seed, I was enlightened, and realised the TRUTH! I AM A TRUE WOMAN!'[roman type][line break]".

To say EscapeAnswer of (M - enlightened gladiator):
	say "[speech style of M]'Find and penetrate the rear entrance. Then, you must find and pound the sensitive button until everything goes white.'[roman type][line break]".

To compute failed dominance punishment of (M - enlightened gladiator):
	if M is male:
		say "[line break][speech style of M]'[one of]Do I even need to say why you lost?[or]A true woman like me can never lose.[or]As you can see, even when a true woman loses, she still wins.[in random order] After we enjoy each other, you must think on this.'[roman type][line break][big he of M] gives your butt a light smack as [he of M] guides you onto your hands and knees.";
		now another-turn-flavour is the substituted form of "[BigFuckerDesc of M] holds you in place.";
		now another-turn is 1;
	otherwise:
		say "[line break][speech style of M]'[one of]Do I even need to say why you lost?[or]A true woman like me can never lose.[or]As you can see, even when a true woman loses, she still wins.[in random order] I trust you will think on this.'[roman type][line break]";
		Bore M.

Section 2 - Wild gladiator

wild gladiator is a gladiator. The text-shortcut of wild gladiator is "wgl". wild gladiator has a number called smoke. The smoke of wild gladiator is -1.

To decide which figure-name is the monster-image of (M - wild gladiator):
	if M is male, decide on figure of wild gladiator;
	otherwise decide on figure of gladiator.

To decide which figure-name is the unfriendly-monster-image of (M - wild gladiator):
	if M is male, decide on figure of unfriendly wild gladiator;
	decide on the monster-image of M.

To say MediumDesc of (M - wild gladiator):
	say "wild [GladiatorCurse of M]gladiator".

Definition: wild gladiator is dungeon dwelling: decide no.

Definition: wild gladiator is woods dwelling:
	if diaper quest is 0 and doomed > 0, decide yes;
	decide no.

To set up (M - wild gladiator):
	reset M;
	now the monstersetup of M is 1;
	now the raw difficulty of M is the starting difficulty of M + 3;
	now M is male;
	if doomed is 5, SilentlyDifficultyUp M by 1;
	now the health of M is the maxhealth of M.

To say SummoningFlav of (M - wild gladiator):
	if M is in the location of the player, say "You hear some grunting inside the statue, primal, but distinctly sexual in tone. A moment later, a nude [man of M] drops out of the stony opening[if futanari fetish is 1 or lady fetish is 2], scanning the surrounding area as [he of M] strokes the softening [DickDesc of M] hanging between [his of M] legs[otherwise], resting an intimidating looking sword over [his of M] shoulder as [he of M] scans the surrounding area[end if].";
	otherwise say "You hear leaves rustling from somewhere nearby.".

Definition: wild gladiator (called M) is uniquely unfriendly:
	if M is friendly-fucking or M is purified, decide no;
	if M is default uniquely unfriendly, decide yes;
	if breasts is lewdly exposed, decide yes;
	decide no. [If your breasts are exposed, she assumes you're a gladiator/gladiator hopeful and attacks]

To say SummoningFlav of (M - wild gladiator):
	say "You hear leaves rustling from somewhere nearby.".

To compute appearance assessment of (M - wild gladiator):
	if the player is a flatchested trap:
		if M is uniquely unfriendly:
			if tg fetish >= 1, say "[speech style of M]'I do not allow [if lady fetish is 2]unbound men[otherwise]men[end if] in my jungle. Kneel and let me transform you into a worthy trophy[if M is buddy]. You should know my expectations by now[end if].'[roman type][line break]";
			otherwise say "[speech style of M]'Masculinity is not welcome in my jungle. Kneel and allow me to transform you into a worthy trophy[if M is buddy]. Honestly, it's like you are trying to disrespect me with that ugly thing[end if].'[roman type][line break]";
			anger M;
		otherwise if the size of penis > min penis size:
			FavourDown M;
			if M is unfriendly:
				say "[speech style of M]'My [if full-lady fetish is 1]strapon[otherwise]own[end if] is the only penis I allow to be wielded in this jungle. Prepare yourself.";
			otherwise:
				say "[speech style of M]'You there. My [if full-lady fetish is 1]strapon[otherwise]penis[end if] is enough for this jungle. [one of]You have been useful in other ways, but I will not tolerate this disrespect forever.'[or]I will tolerate you for now, [if there is an alive djinn]but unlike the djinn, you do not offer me nearly enough for my graciousness to last forever[otherwise]but my graciousness will not last forever[end if].'[or]If you do not dare challenge me, shrink it or stay no longer. Wait too long and I will choose for you.'[or]Shrink it, or I will see it as a challenge. Do not wait for me to do it for you.'[at random][roman type][line break]";
		otherwise:
			if tg fetish >= 1, say "[speech style of M]'Hmm, your transformation should happen soon enough. Then, I can make you into a truly worthy trophy.'[roman type][line break]";
			otherwise say "[speech style of M]'You're a worthy trophy. Wander my jungle freely, as a symbol of my strength, and a token of my leadership.'[roman type][line break]";
			calm M;
	otherwise if M is uniquely unfriendly:[no need to determine flight since the wild gladiator is in the woods.]
		if breasts is not lewdly exposed:
			say "[speech style of M]'[one of]You there, I challenge you. Defeat me or become my prize!'[or]I challenge you, slut. Defend yourself or become my prize!'[stopping][roman type]";
		otherwise if the largeness of breasts > 3:
			say "[speech style of M]'[one of]Hmmph. Do you think yourself a warrior, with those breasts you display so proudly? Prove yourself. Fight me.'[or]You have yet to prove yourself! You have no right to display those breasts so proudly!'[stopping][roman type]";
		otherwise:
			say "[speech style of M]'[one of]How dare you display such a pitiful chest so proudly! Face me, whelp.'[or]Still you have no shame? I will not allow you to flaunt such a Spartan chest!'[at random]";
	otherwise if the breast-happy of M is 1:
		if the player is top-wardrobe-malfunctioning:
			compute tq nip slip reaction of M;
		otherwise:
			say "[speech style of M]'With breasts like those, you are a worthy trophy. Wander freely, show the jungle the standard of my leadership.'[roman type][line break]";
			calm M;
	otherwise:
		FavourDown M;
		if M is unfriendly:
			say "[speech style of M]'You have been pleasant to me, but a trophy should look the part. Prepare yourself.'[roman type][line break]";
		otherwise:
			say "[speech style of M]'You have been pleasant to me, but a trophy should look the part. Wander freely... for now.'[roman type][line break]".

To compute satisfaction of (M - wild gladiator):
	if the smoke of M is 0:
		satisfy M for 450 seconds;
		now the target-room of M is Capsule.[purposely left the de-smokification somewhere else in case the gladiator dies before the smoke is gone.]

To compute kneeling reaction of (M - wild gladiator):
	if M is male:
		say "[one of][BigNameDesc of M] licks [his of M] lips, eagerly stroking [his of M] [LongDickDesc of M] to a full, pulsating erection.[or][BigNameDesc of M] grins.[line break][speech style of M]'I love trophies that do not fight. They last longer.'[roman type][line break][or][BigNameDesc of M] steps closer, dropping [his of M] hardening [Dickdesc of M] onto your face with a rakish grin.[line break][speech style of M]'In my jungle, it is trophies that do the polishing.'[roman type][line break][or][BigNameDesc of M] grins, lazily stroking [his of M] [LongDickDesc of M] as [he of M] circles around you, as if admiring [his of M] prize.[or][BigNameDesc of M] wraps [his of M] hand around [his of M] [LongDickDesc of M].[line break][speech style of M]'So, what will you offer me?'[roman type][line break][or][BigNameDesc of M] places [his of M] hands on [his of M] hips, peering down at [his of M] hardening [DickDesc of M] with an expectant look on [his of M] face.[in random order]";
	otherwise:
		say "[BigNameDesc of M] smiles.[line break][speech style of M]'[one of]You become a better prize by the day.'[or]You will be a trophy worthy of my collection soon.'[or]Good. I am not finished with you yet.'[at random][roman type][line break]";
	if the player is not shameless, say "You shiver with shame.";
	strongHumiliate.

To say PresentAcceptanceFlav of (M - wild gladiator):
	say "[speech style of M]'[one of]I knew you would see things my way.'[or]I am glad you are beginning to learn your place.'[at random][roman type][line break] [BigNameDesc of M] seems convinced by your request!".

To say AnalVirginityTaunt of (M - wild gladiator):
	say "[line break][speech style of M]'[one of]You are welcome. Now, to put you to use.'[or]Learn to love this sensation. It is my favourite way to use my trophies.'[or]Now you are a worthy trophy.'[at random][roman type][line break]".

To say VaginalVirginityTaunt of (M - wild gladiator):
	say "[line break][speech style of M]'[one of]Idiot. If you told me, I would have kept you pure.'[or]You made me waste your purity, slave. IDIOT!'[or]You could have told me. Now your purity is wasted.'[at random][roman type][line break]";
	FavourDown M by 2.

[if the wild gladiator is NOT willing to creampie vagina, it means she pulls out and starts fucking the player anally]
To decide if (M - wild gladiator) is willing to creampie (F - vagina):
	if asshole is actually occupied or the number of worn top level ass protection clothing > 0, decide yes;
	if the reaction of the player is 0:[if you're resisting, she may decide to teach you a lesson]
		if the openness of vagina <= a random number between 2 and 7, decide yes;
		decide no;
	decide yes.

To compute (M - wild gladiator) pulling out of (F - vagina):
	say PullOutFlav of M in F;
	compute M finishing in F;
	now M is not penetrating vagina;
	now the sex-length of M is 4;
	now M is penetrating asshole;
	ruin Asshole.

To say PullOutFlav of (M - wild gladiator) in (F - vagina):
	say "[one of][BigNameDesc of M] roars with pleasure, tightening [his of M] grip as [his of M] [Dickdesc of M] explodes deep inside your [vagina][or][BigNameDesc of M] grunts, hilting you as [his of M] throbbing [DickDesc of M] unloads into your [vagina][at random]. Semen dribbles down the side of your leg as [he of M] slowly pulls out, panting with excitement.[line break][speech style of M]'[one of]I am not finished yet. If I am to break you... I will have to claim you thoroughly.'[or]We're not done yet, are we slut? You must be claimed thoroughly.'[or]I am afraid you have given me no choice. I will have to claim you... thoroughly.'[at random][roman type][line break][big he of M] instantly flattens you with [his of M] full weight, pressing [his of M] [ChestDesc of M] into your back as [his of M] grinds [his of M] slick knob between your cheeks. You feel [his of M] arms lock underneath you as [he of M] abruptly [one of]slams[or]rams[or]shoves[at random] [his of M] [LongDickDesc of M] into your [asshole] and begins pounding you at full force.".

To decide if (M - wild gladiator) is willing to creampie (F - asshole):
	if the reaction of the player is 2, decide no;
	decide yes.

To compute (M - wild gladiator) cleanly pulling out of (F - a fuckhole):[this is needed because the gladiator sleeps by default]
	get clean pull out image of M in F;
	say PullOutFlav of M in F;
	FavourDown M by 2;
	SemenPuddleUp the semen load of M.

To say MessyPullOutFlav of (M - wild gladiator) in (F - asshole):
	say "[BigNameDesc of M] chuckles to [himself of M] as [he of M] pulls out.[line break][speech style of M]'[one of]I will mark you.'[or]You are still to be marked.'[or]Receive my mark.'[in random order]'[roman type][line break][big he of M] holds [his of M] [DickDesc of M] against your cheek, gritting [his of M] teeth as [he of M] rapidly pumps [himself of M] to a hot, sticky orgasm across the side of your face.".

To say PullOutFlav of (M - wild gladiator) in (F - asshole):
	say "[BigNameDesc of M] pulls out, running [his of M] hand along the small of your back as [he of M] kneels next to your face.[line break][speech style of M]'[one of]I expect you to accept my seed next time.'[or]Know that I am making a concession for you.'[at random][roman type][line break][big he of M] looks at you sternly as [he of M] finishes [himself of M] off in the dirt.".

To compute creampie of (M - wild gladiator) in (F - a fuckhole):
	say CreampieFlav of M in F;
	compute M finishing in F.

To say CondomRejectFlav of (M - wild gladiator):
	say "[speech style of M]'[one of]Do not insult me.'[or]You are my trophy, I will do as I [please]. Speak no more of this.'[or]No. You will not deny me my right.'[at random][roman type][line break][if M is not seduced]Looks like [he of M][']s going in bare...[end if]".

To decide which number is the condom resistance of (M - wild gladiator):
	decide on 5.

To say CondomPieFlav of (M - wild gladiator) in (F - a fuckhole):
	say "[BigNameDesc of M] grunts, tightening [his of M] grip as the condom begins to fill up with warm [semen]. [big he of M] continues fucking you until [his of M] supply of [semen] has been completely and thoroughly emptied inside of it.[line break][speech style of M]'[one of]Hmph. I meant to break it.'[or]So, it didn't break. A pity.'[in random order][roman type][line break]You feel [his of M] hands squeeze your hips as [he of M] pulls out and carefully peels the condom off.".

To say CondomFailFlav of (M - enlightened gladiator) in (F - a fuckhole):
	say "[BigNameDesc of M] roars with pleasure as warm [semen] begins spurting into you. [if the semen addiction of the player < 5]You immediately realize something is wrong, and so does [he of M], from the way [he of M] suddenly[otherwise if the semen addiction of the player < 11]It takes you a split second to realize something is wrong, so at first you don't realize why [he of M][otherwise]You're so in love with the feeling of taking [his of M] hot load that you don't realize something is strange until [he of M][end if] tightens [his of M] grip. [if the semen addiction of the player >= 11]Luckily, there's[otherwise]There's[end if] nothing you can do about the apparently broken condom as [he of M] continues to fuck you, only stopping when [his of M] [load] has been completely emptied into your [variable F].[line break][speech style of M]'[one of]Even your condom submits to me.'[or]As always, I receive my just due.'[or]Protection is useless. I cannot be denied.'[in random order][roman type][line break][big he of M] slaps your ass as [he of M] pulls out.".

To say angry punishment clothing destruction of (M - wild gladiator) on (C - a clothing):
	say "[first custom style]'[if C is actually breast covering and the largeness of breasts > 3]Challenge me now, whore, and see what happens. Perhaps then you will not be so disrespectful.'[otherwise if C is ass covering and the player is not possessing a vagina]You belong to me. Perhaps if your [asshole] is on display, the jungle will reveal to you the slut you really are?[otherwise if C is ass covering]You belong to me. Perhaps if your [fuckholes] are on display, the jungle will reveal to you the slut you really are.'[otherwise]I own you, slut. You will no longer delude yourself by concealing your body from me!'[end if][roman type][line break]".

To say angry punishment accessory confiscation of (M - wild gladiator):
	say "[first custom style]'This trinket belongs to me. When you are ready to respect me, perhaps I will allow you to wear it again.'[roman type][line break]".

To say WhoAnswer of (M - wild gladiator):
	say "[speech style of M]'Ira the gladiator!'[roman type][line break]".

To say StoryAnswer of (M - wild gladiator):
	if lady fetish is 2, say "[speech style of M]'I realised I cared nothing for the teachings of my sisters and their 'path to the true warrior'. After casting them aside at last, I have found what I am looking for.'[roman type][line break]";
	otherwise say "[speech style of M]'I realised my sisters were blocking my path to true womanhood and after leaving them behind, at last I found true womanhood.'[roman type][line break]".

To say EscapeAnswer of (M - wild gladiator):
	say "[speech style of M]'[one of]Why are you asking me when you could be finding out yourself?'[or]There can be no safety in progress. Only when you have the will to rise beyond your girlish fears, will you truly find your way forward.'[or]If there is any question as to what you hope to achieve, you do not deserve to achieve it.'[at random][roman type][line break]".

To say DominanceFailure of (M - wild gladiator):
	say "You grab [NameDesc of M] by the wrist and try to wrench the sword out of [his of M] hand. [big he of M] reacts instantly, sweeping your legs from under you.".

To compute failed dominance punishment of (M - wild gladiator):
	if M is male and the player is getting unlucky:[She just fucks you; default]
		if player-fucker is penis, say "[speech style of M]'You may be a [if size of penis > 8]virile male[otherwise]powerful warrior[end if], but only I rule this forest.'[roman type][line break]You try your best to focus on the compliment and ignore the bobbing of [his of M] [LongDickDesc of M] as [he of M] guides you up onto your hands and knees.";
		otherwise say "[speech style of M]'You are fine warrior, but lust is a fatal weakness.'[roman type][line break]You can't help but agree with [NameDesc of M][']s words, eyes glued to [his of M] [LongDickDesc of M] as [he of M] guides you up onto your hands and knees.";
		slightDignify;
		say GotUnluckyFlav;
		now another-turn-flavour is the substituted form of "[BigFuckerDesc of M] holds you in place.";
		now another-turn is 1;
	otherwise if the player is getting lucky:[lucky; she doesn't do anything.]
		say "[speech style of M]'You were close, but this can only be called a loss. Out of respect for your skill, I will wait until later to remind you of your place.'[roman type][line break][BigNameDesc of M] loses interest in you.";
		say GotLuckyFlav;
		Bore M;
	otherwise:
		say "[speech style of M]'There is no such thing as partial victory. You lost. May the jungle determine your fate.'[roman type] [BigNameDesc of M] seems to lose interest you and begins walking away, but it seems like the game still has more in store for you!";
		compute sissification;
		Bore M.

Gladiator ends here.
