Mechanic by Monster begins here.

mechanic is a monster. mechanic is intelligent. mechanic is male.

Definition: mechanic is willing to urinate: decide yes.

Definition: mechanic is father material: decide yes.

Definition: mechanic is raunchy: decide yes.

Definition: mechanic is wenchy: decide yes.

Definition: mechanic is permanently banishable: decide no.

mechanic has a number called xavier-power. The xavier-power of mechanic is usually 0.[running counter of how much "demon juice" the mechanic has stored up. At five or more xavier-power he transforms]

mechanic has a number called power-stolen. The power-stolen of mechanic is usually 0.[essentially a flag that determines whether the mystical amulet was destroyed on the elder altar]

mechanic has a number called wrench-timer. The wrench-timer of mechanic is usually 0.


Understand "hotel" as mechanic.

To say ShortDesc of (M - mechanic):
	say "mechanic".

To say MediumDesc of (M - mechanic):
	say "hotel mechanic".

The text-shortcut of mechanic is "mc".

Figure of mechanic is the file "NPCs/Hotel/mechanic1.png".
Figure of female mechanic is the file "NPCs/Hotel/mechanic2.png".

To decide which figure-name is the monster-image of (M - mechanic):
	if lady fetish is 1, decide on figure of female mechanic;
	decide on figure of mechanic.

To say MonsterDesc of (M - mechanic):
	say "A tall, [if lady fetish is 0]good looking [man of M] wearing a denim vest that exposes [his of M] tattoos[otherwise]slim but busty [man of M] wearing a tight grey vest with nothing under it[end if]. A [if the intelligence of the player > 14]vanity[otherwise]utility[end if] belt of sorts is wrapped around [his of M] waist, equipped with all manner of strange gadgets and tools, but you get the feeling they're meant to distract you from the faint outline of the [DickDesc of M] in [his of M] pants. [if the item described is aggressive and the wrench-timer of M <= 0]Clutched in [his of M] hand is an over-sized steel wrench, which is remarkably simple in comparison to some of the things on [his of M] belt.[otherwise if the wrench-timer of M <= 0]Peeking out of [his of M] front pocket is an over-sized steel wrench, which is remarkably simple in comparison to some of the things on [his of M] belt.[end if][if item described is carrying mystical amulet][big he of M] is wearing the mystical amulet around [his of M] neck, and there is a very strange glint in [his of M] eye. You can't shake the feeling that [he of M] is now incredibly powerful.[end if]".

To say MonsterComment of (M - mechanic):
	if diaper quest is 1:
		do nothing;
	otherwise if the class of the player is priestess:
		if M is infernal, say "A wavering voice sounds in your head. [line break][second custom style]'Naive Sister, [one of]this [man of M] is none other than the demon king! Prepare yourself, sister! Hurry!'[or]the revival of the demon king is now inevitable. You cannot falter now, sister. You are the only one who can stop [him of M].[or][if the times-submitted of M > 0]I must reveal to you that which your body experienced. That [man of M] is the demon king in the flesh, and [his of M] revival is at hand. Find strength, sister, and vanquish [him of M]!'[otherwise]I must reveal to you the truth of this [man of M]. [big he of M] is the demon king in the flesh, and [his of M] revival is at hand. Gather power quickly sister, for you must be the one to stop [him of M]!'[end if][in random order][roman type][line break]";
		otherwise say "A wary voice sounds in your head. [line break][second custom style]'Innocent Sister, [one of]this [man of M] is more than [he of M] seems. You may not let [his of M] power grow[if the xavier-power of M > 0] any further[end if].'[or]this is no [man of M] at all. You must never trust [him of M].'[or][if the times-submitted of M > 0]you have already tasted the cruelty of this [man of M]. Defeat [him of M], sister, before [he of M] goes after someone else!'[otherwise]you know nothing of the evil that lies in the heart of this being. Defeat [him of M] at once, and never find out!'[end if][in random order][roman type][line break]";
	otherwise if M is infernal and the class of the player is worshipper:
		say "[variable custom style]'[one of]This [man of M]... why does [he of M] seem like a king?'[or]I can't fight [him of M] any more. Just who is [he of M]?!'[or]Why does this [man of M] feel like a demon? Can I even oppose [him of M]?'[in random order][roman type][line break]";
	otherwise if the bimbo of the player < 4 and the player is gendered male:[Originally this was one big block, but it was impossible to debug so now it's separated.]
		if lady fetish is 1:
			say "[first custom style][one of][big he of M]'s not just hot, [he of M]'s got style too![or][big he of M] doesn't seem like my type.[or]I bet [he of M]'s the one behind all the robots. Looks like I'll have to work my magic on [him of M].'[or][big he of M] looks like the star in some cheap porn movie, but that's my favourite kind![in random order][roman type][line break]";
		otherwise:
			say "[first custom style][one of]Where did [he of M] get those clothes? [big he of M] looks awesome!'[or]Seems like a normal dude. I wonder how [he of M] managed to get this far?[or][big he of M] must be the one responsible for all the robots I've been seeing. Maybe [he of M] knows a way to turn them off?'[or][big he of M] looks like the male star in a cheap porn movie, but it's probably better than walking around in a skirt![in random order][roman type][line break]";
	otherwise if the bimbo of the player < 4:
		say "[first custom style][one of]There is obviously something wrong with [him of M]. Just look at those clothes.'[or]Typical. Even authority figures in this game have no choice but to dress like that.'[or][big he of M] might be another player, but, [he of M] doesn't look affected at all.'[in random order][roman type][line break]";
	otherwise if the bimbo of the player < 8 and the player is gendered male:
		say "[first custom style][one of]Wrenches are so cool. I bet [he of M] could teach me a thing or two about them.'[or]I don't know why, but I can't stop staring at [his of M] [if full-lady fetish is 1]dildo collection[otherwise]crotch. [big he of M] must be stuffing it or something, heh[end if].'[or][big he of M]'s pretty good looking, I guess. Must be [his of M] clothes.'[in random order][roman type][line break]";
	otherwise if the bimbo of the player < 8:
		say "[first custom style][one of][big his of M] wrench is so big and hard. I could probably use it to protect myself from all the perverts around here!'[or][big he of M][']s pretty good looking. Obviously I'd never give Nintendolls the pleasure, but at least they know what to model for.'[or]I can't keep from looking at [his of M] crotch. Those fucking Nintendolls must be messing with my head!'[in random order][roman type][line break]";
	otherwise if the bimbo of the player < 12:
		say "[variable custom style][one of]I'd play with [his of M] wrench! Wait...'[or][big he of M] looks really intelligent. Totally fuckbuddy material, as long as [he of M] respects my boundaries!'[or]I can't stop myself from staring at [his of M] [if full-lady fetish is 1]crotch. I'm not even that attracted to [him of M], but I just know [his of M] dick is really big[otherwise]belt. It's not really fair to have so many toys out in the open like that[end if]!'[in random order][roman type][line break]";
	otherwise if the bimbo of the player < 16:
		say "[second custom style][one of]I'd play with [his of M] wrench. All night if [he of M] let me...[or][big he of M][']s SO cute, but, I don't want to just get on my knees right away. I should cook [him of M] dinner first.'[or]I bet [he of M]'s the smart guy that made all those fun robots!'[in random order][roman type][line break]";
	otherwise:
		say "[second custom style][one of]I wanna give [him of M] a blowjob!'[or][big he of M] looks SO smart. I bet [he of M] knows what I'm thinking. Teehee, it's naughty!'[or]I'd let [him of M] give my [if the player is not possessing a vagina]fuckhole[otherwise]pussy[end if] a tune-up anytime!'[in random order][roman type][line break]".

To XavierUp (M - a mechanic) by (N - a number):
	increase the xavier-power of M by N;
	if the xavier-power of M > 4, unseal xavier from M.

To decide which number is the girth of (M - mechanic):
	decide on 4.

Definition: mechanic (called M) is willing to shag:
	if M is awake and the scared of M is 0 and the boredom of M < 120, decide yes;
	decide no.

Definition: mechanic (called M) is willing to let go:
	unless M is mating, decide no;
	decide yes.

To decide which number is the base semen load of (M - mechanic):
	decide on 3 + the xavier-power of M.

To set up (M - mechanic):
	reset M;
	now the monstersetup of M is 1;
	now the raw difficulty of M is the starting difficulty of M;
	now M is soul-stolen;[he doesn't have a soul to steal]
	now the health of M is the maxhealth of M.

To decide which number is the starting difficulty of (M - mechanic): decide on 12.

This is the spawn initial mechanic rule:
	if mechanic is off-stage and demon lord is off-stage:
		if debugmode > 0, say "Summoning mechanic in hotel.";
		summon mechanic in the hotel.
The spawn initial mechanic rule is listed in the setting up hotel monsters rules.

To compute unique unsimulated periodic effect of (M - mechanic):
	if the wrench-timer of M > 0:
		decrease the wrench-timer of M by seconds;
		if the wrench-timer of M <= 0 and M is in the location of the player:
			say "A tiny flying robot zips into the room, landing on [NameDesc of M][']s shoulder.[line break][speech style of M]'Finally!'[roman type][line break][big he of M] reaches into the robot's chest compartment and pulls out an oversized steel wrench. The robot zips off as [NameDesc of M] tests the heft of [his of M] new tool.".

To say PregGrowth of (M - mechanic):
	say "the mechanic's [child]".

To compute labour to (M - mechanic):
	if M is regional and M is alive:
		compute pregnancy clothing displacement;
		say "[PregFlav][if the father is in the location of the player]The [father][otherwise]The [father] appears almost as if on cue! [big he of M][end if] kneels down on one knee and delivers the human baby, which immediately starts crying loudly. [big he of M] takes it into [his of M] arms and begins to cradle it.[line break][first custom style]'Ssshh, hush there, everything is okay, I'm your [daddytitle of M], little one!'[roman type][line break][big he of M] looks at you.[line break][first custom style]'[if the father is mating]A wonderful addition to our family.[otherwise]My first child. How magical - I will remember this moment for ever.'[roman type][line break]Without giving you a chance to react, never mind reply, [he of M] leaves you to recover from your ordeal.";
		if the father is in the location of the player:
			say "For some reason, you are filled with a sense of deep fulfilment. You feel great!";
			StrengthUp 1;
			DexUp 1;
			IntUp 1;
	otherwise if M is alive:
		Delay Labour.

Definition: mechanic is human: decide yes.
Definition: mechanic is infernal:[he only counts as infernal if he is able to transform]
	if the xavier-power of mechanic > 3 or mechanic is carrying mystical amulet, decide yes;
	decide no.

To compute monstermotion of (M - mechanic):
	let W be 0;
	let N be a random off-stage robochef;
	repeat with L running through leftovers in the location of M:
		if the leftover-type of L is 117 or the leftover-type of L is 118 or the leftover-type of L is 119 or the leftover-type of L is 127:
			now W is 1;
	if W is 1 and the wrench-timer of M <= 0:[he can't repair anything without his wrench]
		let D be the difficulty of M - the starting difficulty of M;
		if D < 0, now D is 0;
		let O be a random leftover in the location of M;
		if the leftover-type of O is 117:
			now N is a random off-stage robobellboy;
			if N is monster:
				set up N;
				SilentlyDifficultyUp N by D;
		otherwise if the leftover-type of O is 118:
			now N is a random off-stage robobutler;
			if N is monster:
				set up N;
				SilentlyDifficultyUp N by D;
		otherwise if the leftover-type of O is 127:
			now N is a random off-stage robomaid;
			if N is monster:
				set up N;
				SilentlyDifficultyUp N by D;
		otherwise if N is monster:
			set up N;
			SilentlyDifficultyUp N by D;
		if N is monster:
			now N is in the location of M;
			distract N;
			if M is in the location of the player, say " [BigNameDesc of M] kneels down in front of the pile.[line break][speech style of M]'[one of]Wow, this fucking bug again?'[or]Fucking broken again, huh?'[or]I swear I fixed that last time. Fucking bullshit.'[or]Ugh, I hate this framework.'[in random order][roman type][line break][big he of M] repairs and replaces the broken parts with inhuman speed, destroying [his of M] wrench in the process. Finishing the rest of the work with [his of M] hands, [he of M] presses a button and a brand new [ShortDesc of N] rises up in front of [him of M].";
			otherwise say "You hear swearing followed by some loud clanging somewhere else in the hotel.";
			now the wrench-timer of M is 150;[temporarily loses the wrench]
		destroy O;
	otherwise:
		compute room leaving of M.

Part 1 - Perception

To decide which number is the bimbo tolerance of (M - mechanic):
	if diaper quest is 1, decide on 9;
	decide on 18.

To decide which number is the outrage tolerance of (M - mechanic):
	if diaper quest is 1, decide on 6;
	decide on 9.

To decide which number is the bab tolerance of (M - mechanic):
	decide on 15.

To decide which number is the cringe tolerance of (M - mechanic):
	decide on 10.

To say BecomesAggressive of (M - mechanic):
	say "[big he of M] [if diaper quest is 0]unzips [his of M] jeans[otherwise if the wrench-timer of M <= 0]grips [his of M] wrench menacingly[otherwise]cracks [his of M] fingers[end if][line break][speech style of M]'[one of]I guess I've reached my limit.'[or]I think it's time we take our relationship to the next level.'[or]It'd be a crime NOT to do this, really...'[in random order][roman type][line break]".

To compute perception of (M - mechanic):
	say "[BigNameDesc of M] notices you[if the player is sluttily dressed].[otherwise]![end if]"; [The output for clothing humiliation takes place within the 'sluttily dressed' check.]
	if the player is soulless and the class of the player is not succubus and the class of the player is not avatar:
		say "[speech style of M]'Well look at you. Is there even anything in there anymore? Well don't worry, that makes you a perfect candidate for a new [']quest['].'[roman type][line break]";
		anger M;
	otherwise if the class of the player is succubus and M is not carrying mystical amulet:
		say "[speech style of M]Have you found it yet, slave?'[roman type][line break]";
		calm M;
	otherwise if mystical amulet is worn:
		say "[speech style of M]'That amulet! How did you get it? I have been searching for it for years! Give it to me!'[roman type][line break]";
		anger M;
	otherwise if there is a worn messed knickers and diaper quest is 0:
		say "[speech style of M]'Nope, nope nope, I'm going to pretend I can't smell that.'[roman type][line break]";
		bore M;
		if there is worn perceived unmessed knickers, compute state check of a random worn messed knickers;
	otherwise if the class of the player is living sex doll:
		say "[speech style of M]'Ooh, a sex doll. Perfect - I'll have a quick break to get my rocks off, then get back to work.'[roman type][line break]";
		anger M;
	otherwise if there is a worn steel collar:
		say "[speech style of M]'There you are! Do you have the amulet?! If not, I'm going to give you [if the times-dominated of M > 0]another[otherwise]a[end if] reminder of how much you're my [if diaper quest is 1]slave[otherwise]bitch[end if].'[roman type][line break]";
		anger M;
	otherwise if (there is a worn diaper or the diaper-duration of M > 0) and the player is immobile:
		say "[big he of M] seems to decide to leave you alone for now.";
		distract M;
	otherwise if there is soiled-diaper carried by M:
		say "[speech style of M]'[one of]I believe this is yours? Don't try and deny it. I'm going to teach you why babies should clean up after themselves[or]Once again I found evidence of your disgusting accidents just lying around the floor of my hotel. I'm never going to let you get away with something like this[stopping]...'[roman type][line break]";
		anger M;
	otherwise if diaper quest is 1 and ((there is a worn currently at least partially visible diaper and M is not uniquely unfriendly) or M is aware that the player needs a change):
		compute diaper check of M;
	otherwise if the diaper-duration of M > 0:
		if there is a worn diaper:
			compute diaper check of M;
		otherwise:
			say "[big he of M] swiftly walks up to you and holds [if diaper messing < 3]a hand to the front[otherwise]hands to the front and back[end if] of your crotch, pushing firmly to get a good feel.[line break][speech style of M]'YOU! Did I tell you that your punishment sentence was over? In this hotel, the submissives must obey every order of the Masters. Let me show you what happens if you don't.'[roman type][line break]";
			FavourDown M by 4;
			anger M;
	otherwise if the class of the player is faerie:
		say "[speech style of M]'Hey, fairy. Get the fuck over here and tell me what you've done with my amulet!'[roman type][line break]";
		anger M;
	otherwise if M is mating:
		say "[speech style of M]'Well if it isn't my babymomma! [if the player is flying]But what are you doing up there?!'[otherwise]How are you doing?'[end if][roman type][line break]";
		calm M;
	otherwise if the class of the player is princess:
		say "[speech style of M]'[if diaper quest is 0]Hey, [bitch]. [end if]You obviously don't know anything about that outfit you're wearing. Let me teach you a little lesson.'[roman type][line break]";
		anger M;
	otherwise if M is objectifying the player:
		say "[speech style of M]'You look like you're up for a fuck. Let's get it on.'[roman type][line break][if the sex addiction of the player < 12][variable custom style]Uh-oh...[roman type][line break][end if]";
		anger M;
	otherwise if M is babifying the player:
		say "[speech style of M]'You look like a stupid big baby! Let me help you enjoy yourself...'[roman type][line break][if the bimbo of the player < 12][variable custom style]Uh-oh...[roman type][line break][end if]";
		anger M;
	otherwise if the player is prone and M is not carrying mystical amulet and M is not acquaintance:
		say "[speech style of M]'Hey there, you look like you could use some help. Stay there for a moment, and let me give you this gift...'[roman type][line break]";
		anger M;
	otherwise if M is unfriendly:
		say "[speech style of M]'[if diaper quest is 0]You know what time it is, [slut][otherwise]I'm still angry with you. I dare you to fight me again[end if].'[roman type][line break]";
	otherwise if diaper quest is 0 and M is carrying mystical amulet and M is carrying pink-spraybottle:
		now pink-spraybottle is spray;
		say "[speech style of M]'Hey there. I guess it's time I returned this to you.'[roman type][line break][BigNameDesc of M] hands you another [ShortDesc of pink-spraybottle].";
		now pink-spraybottle is carried by the player;
	otherwise if M is cringe disapproving:
		say "[speech style of M]'I know I'm technically staff, but there are limits to how ridiculous a person can look before I myself can't help but enjoy a play session with them...'[roman type][line break]";
		FavourDown M with consequences;
	otherwise if M is outrage disapproving:
		FavourDown M;
		if M is friendly and M is groping:
			compute grope of M;
		otherwise:
			say "[speech style of M]'[if diaper quest is 0][one of]Dayum girl, you're making it difficult for me to keep my hands off of the merchandise, you know? Unless you're one of those 'free use' fetishists... Maybe you want me to fuck you[or]Your appearance still screams 'free use', you know[stopping][otherwise]Wow, you look pretty hot, babe! But you know this is an ADULT BABY fetish hotel, right? You're supposed to look like a pathetic baby, not a glamour model[end if].'[roman type][line break]";
			if M is unfriendly, say BecomesAggressive of M;
	otherwise:
		say "[speech style of M]'Hey there. [if M is carrying mystical amulet]Thanks again for the amulet.'[otherwise]Enjoying your stay?'[end if][roman type][line break]";
		calm M.

Part 2 - Misc Flavour

To compute kneeling reaction of (M - mechanic):
	say "[BigNameDesc of M] cracks a wide smile.[line break][speech style of M]'I'm glad we could come to an agreement.'[roman type][line break][if the player is not shameless]You shiver with shame.[end if]";
	strongHumiliate.

To compute delay of (M - mechanic):
	follow the mechanic unique punishment rules;
	unless the rule succeeded, say "[BigNameDesc of M] takes [his of M] time, relishing in the feeling of victory.".

To compute robot anger of (M - mechanic):
	if M is friendly or M is uninterested:
		say "[BigNameDesc of M] looks at you angrily.[line break][speech style of M]'Hey, [one of]don't damage my inventions!'[or]I've told you before, don't attack my robots!'[stopping][roman type][line break]";
		now M is interested;
		anger M;
		now the boredom of M is 0.

To say DiaperReaction of (M - mechanic):
	if there is a currently visible diaper or the player is shameless:
		say "[BigNameDesc of M] laughs.[line break][speech style of M]'We get the most fucked up people in this hotel, don't we?'[roman type][line break]";
		if the player is modest, say "[variable custom style][if the player is able to speak]'I don't want to have to wear diapers! You've got to believe me!'[otherwise][big he of M] thinks I want to be seen like this![end if][roman type][line break]";
		otherwise say "You [if the player is not disgraced]look down at the ground[otherwise]nod[end if] in shame.";
	otherwise:
		say "[BigNameDesc of M] almost seems to be trying to hide a smirk. But there's no way [he of M] could be able to tell what you're doing, right?".

Report slapping a robot:
	if mechanic is in the location of the player, compute robot anger of mechanic.

Report kneeing a robot:
	if mechanic is in the location of the player, compute robot anger of mechanic.

Report kicking a robot:
	if mechanic is in the location of the player, compute robot anger of mechanic.

Part 3 - Combat

Section 1 - Protect and Attack

To compute (M - mechanic) protecting against (X - a monster):
	if the player is monster stuck:
		if M is ally:
			say "[BigNameDesc of M] doesn't look like [he of M] wants to watch. [big he of M] turns to leave.";
			distract M;
		otherwise:
			say "[one of][or][BigNameDesc of M] seems to be enjoying watching you.[or][or][or][cycling]";
	otherwise if X is robot and M is not guardian:
		if the health of X < the maxhealth of X:
			say "[speech style of M]'HEY! Careful with that!'[roman type][line break][BigNameDesc of M] moves to defend [NameDesc of X]!";
			anger M;
	otherwise if M is ally:
		compute M default protecting against X;
	otherwise:
		say "[one of][BigNameDesc of M] watches you fight with mild interest.[or][or][or][or][cycling]".

To say AllyDamageFlav of (M - mechanic) on (X - a monster):
	say "[if X is robot][one of][line break][speech style of M]'Stupid thing must be malfunctioning...'[roman type][line break][or][stopping][end if][BigNameDesc of M] casually smacks the [X] with [his of M] [if the wrench-timer of M <= 0]wrench[otherwise]fist[end if].".

The latex punishment rule of mechanic is the no latex punishment rule.

The mechanic priority attack rules is a rulebook. The priority attack rules of mechanic is the mechanic priority attack rules.

This is the mechanic obtains amulet from ground rule:
	let A be mystical amulet;
	if A is in the location of mechanic:
		now A is worn by the player;
		follow the mechanic claims amulet rule;
		rule succeeds.
The mechanic obtains amulet from ground rule is listed in the mechanic priority attack rules.

The mechanic unique punishment rules is a rulebook. The unique punishment rule of mechanic is the mechanic unique punishment rules.
The mechanic diaper quest rules is a rulebook. The diaper quest rules of mechanic is the mechanic diaper quest rules.

This is the mechanic claims amulet rule:
	let A be mystical amulet;
	if mechanic is in the location of the player and A is held:
		increase the xavier-power of mechanic by 4;
		say "The [mechanic] rips the [A] from you.[line break][speech style of mechanic]'At last, it's mine! It's all mine!'[roman type][line break]";
		now mechanic is carrying A;
		let S be a random worn steel collar;
		if S is steel collar:
			say "With a snap of [his of mechanic] fingers, the steel collar unlatches itself and drops from your neck. ";
			now S is in the location of the player;
		increase the xavier-power of mechanic by 4;
		if diaper quest is 0 and ((a random number between 1 and 2 is 1 and the class of the player is not succubus) or the class of the player is priestess or there is a worn pure totem):[the mechanic will always transform if you are a demon, or if you've ever successfully stolen anything from him]
			say "[big he of mechanic] puts the amulet on, and you can feel pulses of powerful energy flowing throughout the room.[line break][speech style of mechanic]'I can feel the power running through my veins! Yes, yes! Haha! I am back, baby! Here, have a small reward for your troubles...'[roman type][line break]";
			compute xavier reward of mechanic;
			say "[BigNameDesc of mechanic] starts to wander off, completely ignoring you.";
			bore mechanic for 500 seconds;
		otherwise:
			say "[big he of mechanic] puts the amulet on, and you can feel pulses of powerful energy flowing throughout the room.[line break][speech style of mechanic]'I can feel the power running through my veins! Yes, yes, this is it! Behold, my true form, unleashed again upon this MORTAL PLANE!'[roman type][line break]";
			unseal xavier from mechanic;
		rule succeeds.
The mechanic claims amulet rule is listed last in the mechanic unique punishment rules.
The mechanic claims amulet rule is listed last in the mechanic diaper quest rules.

To compute xavier reward of (M - mechanic):
	let R be a random number from 1 to 6;
	let J be a random off-stage demon codpiece;
	if R is 1:
		say "[BigNameDesc of M] points at you with [his of M] hands, and lightning fires from [his of M] fingertips, enveloping your body. Instead of pain, though, you just feel your skin tingle gently. After a few moments, the lightning stops. You feel STRONG!";
		StrengthUp 4;
	otherwise if R is 2:
		say "[BigNameDesc of M] points at you with [his of M] hands, and lightning fires from [his of M] fingertips, enveloping your body. Instead of pain, though, you just feel your joints tingling, as if being massaged by a thousand tiny fingers. After a few moments, the lightning stops. You feel FLEXIBLE!";
		DexUp 4;
	otherwise if R is 3 and J is actually summonable and the player is possessing a penis:
		say "[BigNameDesc of M] points at you with [his of M] hands, and lightning fires from [his of M] fingertips, enveloping your crotch. Light converges around your [ShortDesc of penis] and a [printed name of J] materialises around your waist! You feel dominant!";
		summon J;
		bless J;
		DelicateDown 2;
	otherwise if R is 4 and demon tail plug is actually summonable:
		say "[BigNameDesc of M] points at you with [his of M] hands, and lightning fires from [his of M] fingertips, enveloping your body. It hurts, but somehow, you feel even more confident because of it! You feel your [asshole] being forced open as a [MediumDesc of demon tail plug] materialises inside you.";
		summon demon tail plug;
		now the body soreness of the player is 10;
		if the delicateness of the player > 4:
			DelicateDown 5;
		otherwise:
			SexAddictDown the 5 - delicateness of the player;
			DelicateDown the delicateness of the player;
	otherwise:[Double chance of this]
		say "[BigNameDesc of M] points at you with [his of M] hands, and lightning fires from [his of M] fingertips, enveloping your body. Instead of pain, though, you just feel your skin tingle gently. After a few moments, the lightning stops. You feel more intelligent!";
		IntUp 4;

This is the mechanic strips princess rule:
	if diaper quest is 0 and (the class of the player is "princess" or the class of the player is "deepthroat princess" or the class of the player is "trained fuck princess" or the class of the player is "virgin warrior princess") and bride-consort is throne and the player is a december 2020 top donator:
		let H be a random worn headgear;
		say "[speech style of current-monster]'At long last, release shall be mine. To dispel your magic, I need simply make you my bride...'[roman type][line break][big he of current-monster] touches your [ShortDesc of H].";
		transform H into tiara-veil;
		now the quest of H is betrothal-quest;
		now bride-consort is mechanic;
		let C be a random worn removable overdress;
		if C is a thing, WardrobeVanish C; [this would prevent the class summon below]
		class summon princess bride dress;
		satisfy current-monster;
		rule succeeds;
	otherwise if the class of the player is princess and the class of the player is not bride:
		if there is a monster penetrating a body part:
			rule succeeds; [Mechanic will wait until he has you alone]
		let D be a random worn headgear;
		if D is clothing:
			say "[BigNameDesc of current-monster] snatches your [ShortDesc of D] off your head. [speech style of current-monster]'If you want to play princess in my hotel, you're going to earn it, bitch.'[roman type][line break][big he of current-monster] unzips [his of current-monster] jeans.";
			destroy D;
		rule succeeds.
The mechanic strips princess rule is listed in the mechanic unique punishment rules.

This is the mechanic applies collar rule:
	let C be a random steel collar;
	if C is actually summonable and C is not in the location of the player and the class of the player is not living sex doll and the bimbo of the player <= 15 and the xavier-power of current-monster < 2 and the player is souled and the power-stolen of current-monster is 0 and bride-consort is not current-monster:
		if there is a monster penetrating face, rule succeeds; [Mechanic waits silently for an opening]
		say "[speech style of current-monster]'Haha[if diaper quest is 1], you're my baby slave now[end if]!'[roman type][line break]CLUNK! [BigNameDesc of current-monster] takes this opportunity to force [if C is in the location of the player or C is held]the[otherwise]a smooth, round[end if] steel collar around your neck and click it shut. The locking mechanism is completely internal, meaning it's impossible to remove.[line break][if the player is able to speak][variable custom style]'Hey, what the hell?'[line break][end if][speech style of current-monster]'This is my own special invention. It is completely impossible to take off without my knowledge, and when you get aroused, it will make sure you don't cool off until you orgasm.'[paragraph break]";
		summon C;
		say "[variable custom style][if the bimbo of the player < 10]Fuck, how did I get myself into this mess?[otherwise if the bimbo of the player < 15]I guess I should do whatever [he of current-monster] says...[otherwise]Oooh, this could be a fun game![end if][roman type][line break]";
		if diaper quest is 0, say "[BigNameDesc of current-monster] rubs [his of current-monster] chin.[line break][speech style of current-monster]'I have a... favour to ask. There's an amulet somewhere in this world, maybe you've encountered it already. Last I heard it was being guarded by a large monster. I want you to retrieve it for me. If you do that, I'll free you from the collar. I would get it myself, but why risk the journey when I could get adventurers like you to go on the quest for me?'[roman type][line break][variable custom style][if the bimbo of the player < 5]On the one hand, this is the first real quest I've been given all game. On the other hand, this guy is a bastard.[otherwise if the bimbo of the player < 10]Obviously this is just some ploy to get that monstrous beast in the dungeon to fuck me, but what other choice do I have?.[otherwise if the bimbo of the player < 15]If it's the only way to stop being [his of current-monster] slave...![otherwise]Playing with a monster, huh? Sounds kinky![end if][roman type][line break][big he of current-monster] pauses once more.[line break][speech style of current-monster]'And while you're here, I think you're going to do a little something extra for me.'[roman type][line break][big he of current-monster] unzips [his of current-monster] jeans.";
		otherwise say "[BigNameDesc of current-monster] rubs [his of current-monster] chin.[line break][speech style of current-monster]'I have a... favour to ask. There's an amulet somewhere in this world, maybe you've encountered it already. Last I heard it was being guarded by a spooky monster. I want you to retrieve it for me. If you do that, I'll free you from the collar. I would get it myself, but why risk the journey when I could get adventurers like you to go on the quest for me?'[roman type][line break][variable custom style][if the bimbo of the player < 5]On the one hand, this is the first real quest I've been given all game. On the other hand, this guy is a bastard.[otherwise if the bimbo of the player < 10]Obviously this is just some ploy to get that monstrous beast in the dungeon to dominate me, but what other choice do I have?.[otherwise if the bimbo of the player < 15]If it's the only way to stop being [his of current-monster] slave...![otherwise]Playing with a monster, huh? Sounds scary but fun![end if][roman type][line break][big he of current-monster] pauses once more.[line break][speech style of current-monster]'And while you're down there, I think I'm going to start training my newest baby slave.'[line break]";
		say "[variable custom style][if the bimbo of the player < 5]And [he of current-monster] isn't even satisfied having me doing [his of current-monster] dirty work for [him of current-monster]. Asshole.[otherwise if the bimbo of the player < 10]I guess I should have seen that coming.[otherwise if the bimbo of the player < 15]I saw that coming![otherwise]Oh yes PLEASE.[end if][roman type][line break]";
		rule succeeds.
The mechanic applies collar rule is listed last in the mechanic unique punishment rules.
The mechanic applies collar rule is listed last in the mechanic diaper quest rules.

This is the mechanic dark ritual rule:
	if the player is soulless and the class of the player is not succubus and the class of the player is not avatar:
		let M be current-monster;
		say "[BigNameDesc of M] seems to consider you for a second, then pulls out a swirling black and red gem.[line break][speech style of M]'You cannot imagine how difficult it was to come by this, you should be honoured to play host to one of my servants...'[roman type][line break]";
		say "You have no idea what the hell [he of M][']s talking about, but before you can react [he of M] plunges the stone into your chest. Agony overflows your body, and you briefly black out. When you come to, [he of M][']s still glancing down at you.[line break]";
		say "[speech style of M]'All better? Good. You serve me now. [unless mystical amulet is carried by M]You don't need to know the details, all you need to know is that you will have a place in my service for eternity if you can only recover the mystical amulet guarded by [NameDesc of minotaur] in the dungeon. Fail, and of course your spirit will fall to oblivion forever...'[otherwise]This is really all a formality since I already have the amulet I need, but you'll need to get to collecting souls. Slack off and your soul will fall to oblivion forever. Hop to it slut!'[end if][roman type][line break]";
		compute succubus transformation;
		bore M;
		rule succeeds.
The mechanic dark ritual rule is listed last in the mechanic unique punishment rules.

The choosing a diaper punishment rule is listed last in the mechanic diaper quest rules.

To set up sex length of (M - mechanic) in (F - a fuckhole):
	set up sex length (a random number between 2 and 3) of M in F.

To compute (M - mechanic) entering mouth:
	if watersports fetish is 1 and the latex-transformation of the player <= 4 and the charisma of the player > a random number between 0 and (the favour of M / 2) and M is not wrapped and M is unfriendly:
		say "[big he of M] cruelly grabs you by the hair, yanking you forward so your face is oriented straight at [his of M] crotch. [if the bimbo of the player < 13]You look on in [horror][otherwise]Your heart pumps with excitement[end if] as [he of M] begins urinating in your face.";
		FacePiss from M;
		if the blue-balls of M > 0, now the blue-balls of M is 0;
	otherwise:
		say MouthPenetrationFlav of M;
		now the sex-length of M is a random number between 2 and 3;
		now M is penetrating face.

To say NormalMouthPenetrationFlav of (M - mechanic):
	say "[one of][BigNameDesc of M] grabs you by the neck, squeezing painfully as [he of M] closes the gap between you and [his of M] crotch.[or][BigNameDesc of M] grabs a handful of your hair and wrenches your face into [his of M] crotch.[or][BigNameDesc of M] savagely pulls your hair, forcing your face right up against [his of M] pulsing erection.[or][BigNameDesc of M] seizes you by the hair, cruelly yanking your face right up to [his of M] crotch.[or][BigNameDesc of M] closes [his of M] fist around your ear and brutally yanks your head toward [his of M] crotch.[at random]";
	say "[one of]You blink back your tears as you obediently part your lips and allow [his of M] [DickDesc of M] to slide in.[or]You [if the oral sex addiction of the player < 4]snarl[otherwise if the oral sex addiction of the player > 6]can't help licking your [LipDesc][otherwise if the delicateness of the player > 5]stare at the floor[otherwise]look up at [him of M] hesitantly[end if] as you open your mouth and allow [his of M] [DickDesc of M] to slide right in.[or]You [if the delicateness of the player + the oral sex addiction of the player < 7]grunt defiantly[otherwise if the oral sex addiction of the player > 6]moan happily[otherwise]grunt noncommittally[end if] as [he of M] shoves [his of M] penis into your mouth.[or][if the oral sex addiction of the player < 4]You glare up at [him of M] as [he of M] forces [his of M] penis through your [LipDesc] and begins to thrust.[otherwise if the oral sex addiction of the player < 7]You shiver with a mixture of embarrassment and anticipation as [he of M] forces [his of M] penis though your [LipDesc] and begins to thrust.[otherwise]You part your [LipDesc], shivering with arousal and excitement as [his of M] penis slides into your mouth.[end if][at random]".

To say RingMouthPenetrationFlav of (M - mechanic):
	say "[one of][BigNameDesc of M] grabs you by the neck, squeezing painfully as [he of M] closes the gap between you and [his of M] crotch.[or][BigNameDesc of M] grabs a handful of your hair and wrenches your face into [his of M] crotch.[or][BigNameDesc of M] savagely pulls your hair, forcing your face right up against [his of M] pulsing erection.[or][BigNameDesc of M] seizes you by the hair, cruelly yanking your face right up to [his of M] crotch.[or][BigNameDesc of M] closes [his of M] fist around your ear and brutally yanks your head toward [his of M] crotch.[at random]";
	say "[one of]You gag involuntarily as [he of M] rams [his of M] [DickDesc of M] into your mouth and begins to thrust.[or]You [if the oral sex addiction of the player + the delicateness of the player < 10]struggle, but the ring in your mouth ensures [he of M] can shove [his of M] [DickDesc of M] into your mouth and thrust with impunity.[otherwise]do your best not to struggle, which [he of M] simply takes as an opportunity to shove [his of M] [DickDesc of M] into your mouth and thrust with impunity.[end if][or][if the oral sex addiction of the player < 6]Your eyes widen in surprise and indignation as [NameDesc of M] slides [his of M] [DickDesc of M] through your gag and into your mouth.[otherwise if the delicateness of the player > 3]You can do nothing but gag as [he of M] slides [his of M] penis through the ring and into your mouth.[otherwise]Your eyes widen with excitement as [NameDesc of M] slides [his of M] [DickDesc of M] through your gag and into your mouth.[end if][at random]".

To say SexDollMouthPenetrationFlav of (M - mechanic):
	say "[one of][BigNameDesc of M] grabs you by the neck, squeezing painfully as [he of M] closes the gap between you and [his of M] crotch.[or][BigNameDesc of M] grabs a handful of your hair and wrenches your face into [his of M] crotch.[or][BigNameDesc of M] savagely pulls your hair, forcing your face right up against [his of M] pulsing erection.[or][BigNameDesc of M] seizes you by the hair, cruelly yanking your face right up to [his of M] crotch.[or][BigNameDesc of M] closes [his of M] fist around your ear and brutally yanks your head toward [his of M] crotch.[at random]";
	say "[one of]You give [NameDesc of M] a dour look as [he of M] slides [his of M] penis through your [LipDesc][or]You can only stare up at [him of M] as [his of M] penis slides into padded hole you call a mouth.[or]Your [LipDesc] make faint squeaking noises as [he of M] slides [his of M] [DickDesc of M] into your mouth and begins to thrust.[or]You make [if the oral sex addiction of the player < 5]an annoyed noise[otherwise]a plaintive moan[end if] as [his of M] [DickDesc of M] enters your padded rubber mouth.[at random]".

Definition: A mechanic (called M) is peeling wrapper:
	if the class of the player is princess:
		if the player is a blowjob slut and a random number between 1 and 2 is 1, decide no;
	if a random number between 1 and 2 is 1:
		if the player is a blowjob slut, decide no;
		if the class of the player is priestess, decide no;
	decide yes.

To say StrikingSuccessFlav of (M - mechanic) on (B - a body part):
	if the wrench-timer of M <= 0, say "[BigNameDesc of M] [one of]strikes[or]whacks[or]smacks[at random] you [TargetName of B] with [his of M] wrench! Ouch!!";
	otherwise say "[BigNameDesc of M] [one of]punches[or]slaps[or]kicks[at random] you [TargetName of B]!".

To say StrikingFailureFlav of (M - mechanic) on (B - a body part):
	if the wrench-timer of M <= 0, say "[BigNameDesc of M] tries to [one of]strike[or]whack[or]smack[at random] you [TargetName of B] with [his of M] wrench! You narrowly avoid it.";
	otherwise say "[BigNameDesc of M] tries to [one of]punch[or]slap[or]kick[at random] you [TargetName of B]! You narrowly dodge.".

To compute (M - mechanic) hurting (B - a body part):
	if the wrench-timer of M <= 0, BodyRuin a random number between 1 and 2;[he does extra damage when he has the wrench]
	otherwise BodyRuin 1.

To compute (M - mechanic) hurting (B - breasts):
	if the wrench-timer of M <= 0, BodyRuin a random number between 2 and 3;
	otherwise BodyRuin 2.

To compute (M - mechanic) hurting (B - face):
	if the wrench-timer of M <= 0, BodyRuin a random number between 2 and 3;
	otherwise BodyRuin 2.

To say AnalVirginityTaunt of (M - mechanic):
	say "[line break][speech style of M]'[one of]Nothing beats the feeling of a fresh hole.'[or]Now that feels fresh.'[at random][roman type][line break]";

To say VaginalVirginityTaunt of (M - mechanic):
	say "[line break][speech style of M]'[one of]Heh, I knew you smelled pure. I'm so lucky![or]A virgin? It must be my lucky day!'[at random][roman type][line break]";
	now M is penetrating vagina;[we do this earlier than we would normally, so Xavier knows to stay in the player]
	XavierUp M by 1.

To decide if (M - mechanic) is losing wrapper in (F - a fuckhole):
	if the class of the player is princess, decide yes;[he hates princesses]
	if the reaction of the player is 0:
		unless the player is getting lucky, decide yes;
	otherwise:
		if the player is getting very unlucky, decide yes;
	decide no.

To say CondomFailFlav of (M - mechanic) in (F - a fuckhole):
	say "[BigNameDesc of M] suddenly pulls out. [one of]You think for a moment that it might be over, only to[or]you know better than to believe it's over, and a moment later you[stopping] hear a sharp *SNAP* as [he of M] tears off the condom and slams [his of M] [DickDesc of M] back in, [one of]completely bareback[or]fully bareback[or]fully raw[in random order].[line break][speech style of M]'[one of]I'm going to jizz inside you, bitch!'[or][if F is vagina and the player is able to get pregnant]Hope you're on the pill, bitch,[otherwise]Hope you like creampies, bitch,[end if] this load is going to be big!'[or]You're gonna take it all, bitch![or]That's right bitch, enjoy all my cum!'[at random][roman type][line break]";
	if the reaction of the player is 0, say "[if the semen addiction of the player < 7]You struggle as much as you can without setting [him of M] off immediately[otherwise if the semen addiction of the player < 12]You half-heartedly struggle to get away[otherwise]You playfully struggle to get away[end if], but [he of M] holds you down effortlessly, [one of][his of M] [DickDesc of M] continuing to slam in and out as wave after wave of [semen] rushes into your now unprotected [variable F][or]continuing to thrust as [his of M] [DickDesc of M] plants [his of M] [semen] nice and deep inside your now unprotected [variable F][or][his of M] [DickDesc of M] throbbing powerfully as it floods your unprotected [variable F] with [his of M] load, pushing it deeper with every thrust[at random].";
	otherwise say "[if the semen addiction of the player < 7]You shudder[otherwise if the semen addiction of the player < 12]You glance over your shoulder[otherwise]You look over your shoulder and lick your lips[end if] as [he of M] deposits [his of M] load deep inside your newly unprotected [variable F].";
	if the reaction of the player > 0 and the class of the player is not princess, say GotUnluckyFlav;

To say CondomPieFlav of (M - mechanic) in (F - a fuckhole):
	say "[one of][BigNameDesc of M] tightens [his of M] grip, pistoning fervently as the condom fills with warmth. [big he of M] slaps your ass as [he of M] pulls out.[or][BigNameDesc of M] groans, tightening [his of M] grip as [his of M] [DickDesc of M] shoots jet after jet of fresh [semen] into the condom. [big he of M] gives your ass a hearty spank as [he of M] pulls out.[at random]";
	if the reaction of the player is 0, say GotLuckyFlav;

To decide if (M - mechanic) is willing to creampie (F - a fuckhole):
	if the class of the player is princess, decide yes;[always creampies princess]
	if the reaction of the player is 2:[You can beg him not to cum in you. Charisma dependent]
		let C be the charisma of the player;
		if a random number between 0 and C > 0, decide no;
	decide yes.

To say CreampieFlav of (M - mechanic) in (F - a fuckhole):
	say "[one of][BigNameDesc of M] slams [his of M] [DickDesc of M] home, groaning with pleasure as [he of M] floods your [variable F] with [semen]. [big he of M] gives you a healthy smack across the ass as [he of M] pulls out, climbing to [his of M] feet and wiping a bit of sweat from [his of M] brow.[or][BigNameDesc of M] jams [his of M] [DickDesc of M] in as far as it will go, reaching underneath you to play with your [ShortDesc of breasts] [he of M] fills your [variable F] with [his of M] load. [big he of M] roughly shoves you off [his of M] [DickDesc of M], sighing in satisfaction as [he of M] gets to [his of M] feet.[or][BigNameDesc of M] groans, tightening [his of M] grip as [his of M] [DickDesc of M] shoots jet after jet of fresh [semen] directly into your [variable F]. [big he of M] finishes [himself of M] off with a few short thrusts before pulling out and climbing to [his of M] feet.[at random]".

To compute (M - mechanic) pulling out of (F - a fuckhole):
	if a2m fetish > 0 and face is not actually occupied and (M is infernal or the player is getting unlucky), compute M messily pulling out of F;
	otherwise compute M cleanly pulling out of F.

To compute (M - mechanic) messily pulling out of (F - a fuckhole):
	get messy pull out image of M in F;
	say MessyPullOutFlav of M in F;
	now M is not penetrating F;
	now the sex-length of M is 3;
	now M is penetrating face.

[TODO: work on a little more]
To say MessyPullOutFlav of (M - mechanic) in (F - a fuckhole):
	say "[BigNameDesc of M] suddenly slows down and pulls out.";
	if the class of the player is worshipper:
		say "[line break][speech style of M]'[one of]I bet you're dying to find out what your [if F is vagina][pussy][otherwise]ass[end if] tastes like.'[or]You're fine with [if F is vagina]tasting your own [pussy][otherwise]ass to mouth[end if], right?'[in random order][roman type][line break]";
	otherwise if the class of the player is priestess:
		say "[line break][speech style of M]'[one of]Alright, I won't cum inside you. There's more than one way to defile uppity priestesses, after all.'[or]Ok, priestess, I don't have to creampie you. After all, I have other ways of defiling you.'[in random order][roman type][line break]";
	otherwise:
		say "[line break][speech style of M]'[one of]Alright, I'll give your [if F is vagina][pussy][otherwise]ass[end if] a break. But [if M is infernal]I've been really full of energy recently, so we'll have to keep going.'[otherwise]I'm not about to let you blue-ball me, though.'[end if][or]Getting bored, are we? Me too.'[or]Tired already? Hmm, I guess I should make things more interesting.'[in random order][roman type][line break]";
	say "[big he of M] walks round to your face, casually grabbing a handful of your hair and dragging your head towards [his of M] [LongDickDesc of M]. You are given only a moment to contemplate whether avoiding a creampie is really worse than tasting your own [variable F] before [he of M] makes the decision for you, shoving [his of M] [DickDesc of M] into your mouth and beginning to thrust.[unless M is infernal] [GotUnluckyFlav][end if]".

To say PullOutFlav of (M - mechanic) in (F - a fuckhole):
	say "[BigNameDesc of M] pulls out, grunting as [he of M] blows [his of M] load all over the floor.[line break][speech style of M]'[one of]Next time, I'm going to nut inside you.'[or]Don't say I never did anything nice for you.'[or]It's your lucky day, bitch.'[in random order][roman type][line break]";
	SemenPuddleUp the semen load of M.

To compute happy reward of (M - mechanic):
	if M is friendly-fucking:
		let T be a random tiara;
		if M is carrying T:
			say "[line break][speech style of M]'[one of]Alright [']princess['], I guess you've earned this back.'[or]OK I feel better now. Maybe next time you'll bring the old princess and make it a threesome.'[or]Fuck, that was good. Here's your garbage back.'[or]I like you loads more than the old princess. Take it.'[at random][roman type][line break][BigNameDesc of M] hands you the [ShortDesc of T].";
			now T is carried by the player;
		otherwise if M is carrying pink-spraybottle:
			now pink-spraybottle is spray;
			say "[line break][speech style of M]'[one of]Good thing you're such a whore, you could have been out of a job. Value this chance.'[or]Now I remember why I hired you. You're fucking easy! Better stay easy if you're gonna be so fucking careless.'[or]Ah, I never get tired of fucking stupid whores. Don't lose this bottle though, I'll be pissed.'[at random][roman type][line break][BigNameDesc of M] hands you another [ShortDesc of pink-spraybottle].";
			now pink-spraybottle is carried by the player;
		otherwise if the employee-record of senior robobellboy > 4 and the player is hotel employed:
			let J be a random off-stage plentiful accessory;
			now J is emerald;
			set shortcut of J;
			say "[speech style of M]'Normally I don't pay whores on principle, but since you work for me and all...'[roman type][line break][BigNameDesc of M] hands you a [printed name of J].";
			now J is in the location of the player;
			compute autotaking J;
		otherwise if the employee-record of senior robobellboy > 2 and black maid headdress is off-stage and black maid headdress is actually summonable:
			say "[speech style of M]'That was actually pretty nice. Plus, given what I've heard about you... You're hired!'[roman type][line break][BigNameDesc of M] pulls out a [printed name of black maid headdress] and fixes it on top of your head.";
			summon black maid headdress cursed;
		otherwise if the employee-record of senior robobellboy < -2:
			if the player is hotel employed, say "[speech style of M]'To be honest, I don't see why you get such terrible reviews. After you've done some more training, come back for another fuck.'[roman type][line break]";
			otherwise say "[speech style of M]'That was pretty good, but I don't trust interns. I still want you to do some proper training later on.'[roman type][line break]";
		otherwise:
			say "[speech style of M]'You're not an awful fuck as far as whores go. Don't expect me to pay you though.'[roman type][line break]".

Section 2 - DQ

Definition: mechanic is willing to spank: decide yes.

Definition: mechanic is willing to deliver enemas: decide yes.

To decide which number is the enema plug reluctance of (M - mechanic):
	decide on 2. [Set this to 0 to have the monster never plug after an enema]

To say EnemaDeclarationFlav of (M - mechanic):
	say "[speech style of M]'I've got too much damn work to do to change you as often as you need. So you're getting this![roman type][line break]".

To say EnemaAfterFlav of (M - mechanic):
	say "[speech style of M]'I've fixed enough pipes to know what's gonna happen to you soon.'[roman type][line break]".

To say EnemaPlugAfterFlav of (M - mechanic):
	if M is intelligent, say "[speech style of M]'Don't fuss, I'm a trained professional in blockage.'[roman type][line break]".

Definition: mechanic is willing to confiscate: decide yes.

To say ConfiscationDeclarationFlav of (M - mechanic) on (C - a clothing):
	say "[speech style of M]'[if C is plentiful accessory]This might be worth something to m... I mean BABIES like you shouldn't have this!'[otherwise if C is equippable]Hmph, you're WAY too old to be using this... thing. Into the toolbox it goes.'[otherwise]It's so considerate that you're helping me childproof this hotel by bringing me things like this!'[end if][roman type][line break]".

To say ConfiscationAfterFlav of (M - mechanic) on (C - a clothing):
	let K be a random worn knickers;
	say "[speech style of M]'You're tempting me to dig into that [if K is knickers][ShortDesc of K][otherwise]inventory[end if] of yours and see what -else- you're hiding!'[roman type][line break]".

Definition: mechanic is diaper disciplining: decide yes.

To say DiaperChangeComment of (M - mechanic):
	if the diaper-duration of M <= 0, say "[speech style of M]'[one of]You see my tool box? Do you want to see what's in this tool box? Stay in that diaper then[or]There we go. You keep your hands off that until it's as backed up as the pipes around here[or]Good, now get~ And keep those huggies on if you know what's good for you[in random order]. Understand?'[roman type][line break]";
	otherwise say "[speech style of M]'There we go. And remember, diapering you will stop being fun for both of us if you don't keep it on.'[roman type][line break]".

Definition: mechanic is willing to change diapers: decide yes.

Definition: mechanic is willing to donate diapers: decide yes.

Definition: mechanic is willing to double diapers: decide yes.

To say DoubleDiaperAnnounceFlav of (M - mechanic):
	say "[BigNameDesc of M] starts fishing in [his of M] toolbox for ANOTHER diaper.[line break][speech style of M]'[one of]You see this load, little one? It's that full on purpose, isn't it? It's because you wanted two of [']em, right?'[or]I don't get paid enough to double diaper you... but you've made it completely necessary.'[in random order][roman type][line break]".

To say DoubleDiaperAfterFlav of (M - mechanic):
	say "[speech style of M]'See? Now I've rubbed all the oil smudges off the first diaper... looks clean as a whistle!'[roman type][line break]".

Definition: mechanic is willing to punish untidiness: decide yes.

To say DQSpankResistReactionFlav of (M - mechanic):
	say "[BigNameDesc of M] harrumphs.[line break][speech style of M]'[one of]I just bent a pipe back into place not 10 minutes ago, what chance do you have, brat?'[or]I'm not one for cute, but dammit if your pathetic display ain't that!'[or]That's okay, I don't mind a slave with a little fire in them!'[or]It's brats like you that are the reason I have a dozen things to do in this dump and not just half a dozen. Hold still!'[in random order][roman type][line break]".

Section 3 - Damage

To compute damage reaction of (M - mechanic):
	if the health of M > 0 or M is carrying mystical amulet:
		if M is uninterested:
			say "[big he of M] shouts angrily!";
		otherwise:
			if M is friendly:
				say "[BigNameDesc of M] looks surprised, but lowers [his of M] gaze and takes an offensive stance!";
				if the class of the player is succubus, say "[speech style of M]'A betrayal eh? I will show you your place, slave'[roman type][line break]";
			otherwise:
				let FLAV be 0;
				if the woman-status of woman-player is 91 and the mechanic-scene of woman-player <= 4 and woman-player is in the location of the player:
					say "[BigNameDesc of M] roars with frustration.[line break][speech style of M]'Fine, have it your way!'[roman type][line break][big he of M] pulls [his of M] [if diaper quest is 1]wand vibrator away[otherwise][DickDesc of M] out of [NameDesc of woman-player][']s throat[end if] and turns to face you.";
					if the woman-bimbo of woman-player > 4 + diaper quest:
						say "[BigNameDesc of woman-player] coos softly.[line break][speech style of woman-player]Aww, [please] put it back, [literalMistress of M]!'[roman type][line break]";
					otherwise:
						say "[BigNameDesc of woman-player] hyperventilates a couple of times and then passes out. ";
						bore woman-player;
						now the sleep of woman-player is 300;
					say "It doesn't look like [he of woman-player][']s going to be much help...";
					now the mechanic-scene of woman-player is 6;
				otherwise if the health of M < the maxhealth of M / 3:
					if the health of M <= 0 and (the xavier-power of M >= 4 or M is carrying mystical amulet):[gives the player a chance to steal the amulet]
						say "[BigNameDesc of M] [if M is carrying mystical amulet]grips the amulet[otherwise]clenches [his of M] fists[end if].[line break][speech style of M]'Fine, have it your way!'[roman type][line break]";
						unseal xavier from M;
					if demon lord is in the location of the player:
						now demon lord is interested;
						anger demon lord;
						now FLAV is 1;
					[otherwise if there is a worn steel collar:
						say "[BigNameDesc of M] roars with pain.[line break][speech style of M]'Fine, if I take the collar off, will you leave me alone?!'[roman type][line break]";
						let S be a random worn steel collar;
						if S is steel collar:
							say "With a snap of [his of M] fingers, the steel collar unlatches itself and drops from your neck.";
							now S is in the location of the player;
							Bore M;
						now FLAV is 1;]
				if FLAV is 0:[we didn't have anything special to say so we use the normal damagereaction function]
					say DamageReaction (the health of M) of M.

To say DamageReactHealthy of (M - mechanic):
	say "[BigNameDesc of M] takes the hit, clearly not even taking you seriously.".

To say DamageReactDamaged of (M - mechanic):
	say "[BigNameDesc of M] sneers menacingly. [if the xavier-power of M >= 4][big his of M] eyes glow red[one of].[line break][speech style of M]'You don't want to make me have to use my full power, trust me on this.'[roman type][line break][or].[stopping][otherwise][big he of M]'s still got a lot of fight left in him![end if]".

To say DamageReactTired of (M - mechanic):
	say "[BigNameDesc of M] grunts as [he of M] takes the hit.".

To say DamageReactWeak of (M - mechanic):
	say "[BigNameDesc of M] recoils in pain.".

To say DamageReactSubmissive of (M - mechanic):
	if M is carrying mystical amulet or the wrench-timer of M <= 0, say "[BigNameDesc of M] recoils in pain, seeming to be looking for somewhere to escape to.";
	otherwise say "[BigNameDesc of M] recoils in pain, looking especially wary of you.".

To say BanishForceFlav of (M - mechanic):
	say "You point towards the rear of the hotel, clearly demanding [he of M] leaves. ".

To say BanishFleeFlav of (M - a mechanic):
	say "[speech style of M]'Oh mark my words, I'll be back.'[roman type][line break][BigNameDesc of M] threatens, as [he of M] takes [his of M] leave.".

To compute unique banishment of (M - a mechanic):
	if there is worn demonic wearthing:
		say "What happens next it looks like neither of you were expecting - a red pentagram appears on the floor underneath [him of M], and it sort of looks like the floor is melting where the pentagram sits. [BigNameDesc of M] begins to sink down through the pentagram.[line break][speech style of M]'Wait what? How?!'[roman type][line break][big he of M] tries to resist but there's nothing [he of M] can do to stop [himself of M] from being dragged into what looks like hell.[line break][speech style of M]'N-no, so... close... Curse you[if the class of the player is succubus]r... betrayal[end if]...'[roman type][line break]";
		if gladiatorcurse is 1, uncurse gladiators;[You don't have to unleash the mechanic to purify the gladiators]
		now M is permanently banished.

To say TaxDesc of (M - mechanic):
	say "Demand [if there is a worn steel collar]you remove the steel collar[otherwise]an item[end if] in return for mercy.".

To compute tax return of (M - mechanic):
	let S be a random worn steel collar;
	if S is steel collar:
		say "With a snap of [his of M] fingers, the steel collar unlatches itself and drops from your neck.[line break][speech style of M]'You're going to pay for making me waste such an expensive gadget.'[roman type][line break]";
		now S is in the location of the player;
	otherwise:
		let X be nothing;
		repeat with B running through off-stage cans:
			if the fill-type of B is 3:
				now X is B;
				now X is blessed;
				break;
		if a random number between 1 and 3 is 1:
			now X is a random off-stage strapon-dildo;
			now the strap-length of X is 8;
		if X is a thing:
			say "[BigNameDesc of M] drops a [printed name of X] at your feet.[line break][speech style of M]'I hope you find it useful... because you're going to suffer for it greatly the next time I get my hands on you.'[roman type][line break]";
			now X is in the location of the player;
			compute autotaking X;
		otherwise:
			compute default tax return of M.

To standard loot (M - mechanic):
	let X be a random off-stage plentiful bracelet;
	unless X is nothing:
		now X is in the location of the player;
		now X is solid gold;
		set shortcut of X;
		say "The defeated [M] [if the loot dropped of M > 0]also [end if]dropped a [printed name of X]!";
		increase the loot dropped of M by 1;
		compute autotaking X.

Part 4 - Conversation

To IdentifiablePosterReaction of (M - mechanic):
	say "[BigNameDesc of M] looks at you, then at the banner, then back to you. Upon realising that it is you, [he of M] puts [his of M] hands on [his of M] hips and laughs loudly.";
	say "You turn bright red with shame.";
	humiliate the lewdness of a random poster in the location of the player * 2.

To UnidentifiablePosterReaction of (M - mechanic) with (P - a poster):
	say "[BigNameDesc of M] looks at the banner with a big grin on [his of M] face. [big he of M] doesn't seem to realise it is you, but is clearly enjoying looking at it.";
	say "You turn slightly red but don't say a word.";
	humiliate the lewdness of a random poster in the location of the player / 2.

To say RewardFlav of (M - mechanic) for (T - a thing):
	say "[speech style of M]'Don't ask me where I got this.'[roman type][line break][BigNameDesc of M] puts a [T] on the ground in front of you.".

To say OfferFriendshipFlav of (M - mechanic):
	say "[speech style of M][if M is guardian]'You and I could conquer the world[otherwise if M is ally]'You have friends in high places now[otherwise if M is buddy]'Make yourself at home[otherwise if M is acquaintance]'I'm very glad you chose to visit my hotel[otherwise]'Perhaps you won't be the first one thrown into the Pit of Unending Molestation when the demons take over this realm. ...Forget I said anything[end if].'[roman type][line break]".

To decide which number is the bartering value of (T - a submissive collar) for (M - a mechanic):
	decide on the unworn outrage of T / 3.

To say MonsterOfferAcceptFlav of (M - a mechanic) to (T - a submissive collar):
	say "[BigNameDesc of M] smirks.[line break][speech style of M]'I do have a weak spot for collars like this. I just love to collar a bitch and make her my own, you know?'[roman type][line break]".

Section 1 - Greeting

To say FirstResponse of (M - mechanic):
	say "[speech style of M]'Hi there.'[roman type][line break]".

To say RepeatResponse of (M - mechanic):
	if M is unfriendly:
		if the player is hotel employed, say "[speech style of M]'[one of]In your contract, it said something about waxing hard poles. Get on your knees, I'll demonstrate what I mean.'[or]It's time you did some real work for a change, maid. Get on your knees.'[or]Do you feel like a fuck? Because if you value your job, you do.'[or]Hey maid. I'm giving you a break from serving patrons. Get on your knees, because you're going to serve me instead.'[or]Guess what, your boss is horny, get on your knees.'[at random]";
		otherwise say "[speech style of M]'[one of]Shut up, or I'll make you.'[or]If you value your pretty face, you'll get on your knees. Hurry, before I lose my patience.'[or]Shut your mouth.'[or]If you keep running your mouth, I'll have to put something in it.'[at random][roman type][line break]";
	otherwise if the class of the player is maid:
		say "[speech style of M]'[one of]The patrons are looking forward to having you clean up in their rooms. Don't keep them waiting.'[or]Hey, aren't you the maid? Stop flirting and get back to work.'[or]I'm not paying you to make conversation, maid. Granted I'm not really paying you to [']clean['] either...'[or]Ugh, is this about the pay? The patrons will compensate you when you do your job. Better get going, they might give less if you keep them waiting.'[or]If you're here looking for instructions, you're in luck. Stop bothering me and get back to work. Clear anything up?'[at random][roman type][line break]";
	otherwise if the player is hotel employed:
		say "[speech style of M]'[one of]I'd really prefer it if you kept your flirting to the paying customers.'[or]Don't you have a knob you're supposed to be sitting on, somewhere? Ugh, why do I pay you?'[or]I'm not paying you to make conversation. Get back to work.'[or]Ugh, is this about the pay? I swear, it's like you whores have never read a contract before.'[or][if the employee-record of senior robobellboy > 1]I hear you do good work, but I'm not a whore, so I'm not planning to give you a bonus for free, if you know what I mean[otherwise if the employee-record of senior robobellboy < -1]I hear you pissed off some of my customers. Clean up your act or it's going to come up on your next performance review[otherwise]If you have time to talk to me, you have time to suck dick. Go find a customer[end if].'[at random][roman type][line break]";
	otherwise:
		say "[speech style of M]'Hi again.'[roman type][line break]".

To say SubmissiveResponse of (M - mechanic):
	if the player is hotel employed:
		FavourDown M;
		say "[speech style of M]'[one of]Ha. I knew there was a reason I kept sluts like you on my dime. Get on your knees.[or]You want dick in lieu of a paycheck this month? Great, get on your knees.[or]Anything not to do your job, eh? Alright, get on your knees.[or]I think I've heard this one. So horny that you can't focus on your job. I'll bite. Get on your knees.[at random][if M is not unfriendly] That, or stop bothering me and get your lazy ass back to work.'[otherwise].'[end if][roman type][line break]";
	otherwise if M is not unfriendly:
		say "[speech style of M]'[one of]Ha ha, yes this is my realm - er, I mean hotel, and I'll fuck whoever I want, whenever I want!'[or]You're still on about that? Ha, you're welcome, I guess.'[at random][roman type][line break]";
	otherwise:
		say "[speech style of M]'[one of]Back for more, slut?'[or]Did remembering what happened earlier made you horny? Can't say I blame you, you obviously can't help being a tart.'[or]Horny again, are we? I'll help.'[or]Not satisfied with [the times-submitted of M] dickings? OK, let's make it [the times-submitted of M + 1]!'[or]Ah! It's a good thing you showed up, I was watching you in my security cameras and thought, Man, I'd like to bang that slut again.'[at random][roman type][line break]".

To say InvitationRejected of (M - mechanic) with (N - a monster):
	say "[speech style of M]'[one of]Heh, how could I say no to a face like that?'[or]You need help from the boss, huh? Alright, I can do that.'[or]Hurting for the boss's [DicKDesc of M], huh? I guess I can sate you.'[at random][roman type][line break]";

To say AssistanceRejected of (M - mechanic) with (N - a monster):
	if M is unfriendly:
		say "[speech style of M]'[one of]If it's help you want, I know just what to do.'[or]I'm going to help. Oh yes indeed.'[or]What kind of guy would I be if I ignored a [man of the player] in distress?'[at random][roman type][line break]";
	otherwise:
		say "[speech style of M]'[one of]I'm sorry, I'm a bit busy at the moment. Have fun!'[or]Why would I do that?'[at random][roman type][line break]".

To say UnAnnoyedResponse of (M - mechanic):
	say "[speech style of M]'[one of]Haha! Take it!'[or]Yeah, take it slut!'[or]How does it feel to get pounded by an important man!'[or]Think of your resume after this. You fucked the hotel manager!'[at random][roman type][line break]".

To say MildAnnoyedResponse of (M - mechanic):
	say "[speech style of M]'[one of]I know you love it!'[or]Take it hard, bitch!'[or]Yeah, keep kidding yourself, bitch.'[at random][roman type][line break]".

Section 2 - Questioning

To say WhereAnswer of (M - mechanic):
	say "[speech style of M]'You're in the best fetish hotel in all the lands. Enjoy your stay!'[roman type][line break]".

To say WhoAnswer of (M - mechanic):
	say "[speech style of M]'[if the class of the player is virgin warrior][one of]You'll know who I am soon enough. Just you wait.'[or]You really don't know? I guess any idiot can become a warrior as long as they're a prude.'[or]Who am I? Like you don't already know.'[or]If you want to know who I am, you should give me a go at that cherry of yours first.'[or]I'll tell you who I am... if you let me pop that cherry of yours.'[at random][otherwise]I'm the mechanic, I designed and made all those lovely robots you see wandering around. That's right, I'm not just a pretty face!'[end if][roman type][line break]".

To say StoryAnswer of (M - mechanic):
	say "[speech style of M]'[one of]I'm an extra planar demon, cursed to forever walk this mortal plane as a shadow of my true self[if the class of the player is not succubus]. Just kidding, I'm just looking for a pay check more than anything[end if].'[or]Well, I love kinky sex and I love making robots, so when Nintendolls gave me this opportunity, how could I turn it down?'[or]I entered an internet sweepstake to get my robot design featured in the kinkiest game of all time. Naturally, I blew all the other entrants out of the water, but just to make sure I won, I hacked into the design database and sabotaged all the other contestants. Nintendolls found out, but the company was so impressed they gave me a permanent job creating and maintaining every robot on this level.'[or]This will probably go over your head, but this is a virtual reality game. I'm simply a programming construct meant to resemble an actual human man.'[as decreasingly likely outcomes][roman type][line break]".

To say EscapeAnswer of (M - mechanic):
	if the class of the player is maid:
		say "[speech style of M]'[one of]You are not going anywhere. Get back to work.[or]A-ah! We'll discuss quitting time when it's actually quitting time, yeah?'[or]Leaving so soon? You've barely done any work.'[or]I'd tell you, but we're actually a bit understaffed at the moment. See, there's this maid who'd rather engage in idle chitchat than do the work [he of the player][']s being paid for. I might fire [him of the player] soon.'[in random order][roman type][line break]";
	otherwise:
		say "[speech style of M]'[one of]Err, probably through the front door?'[or]Probably the same way you came in?'[at random][roman type][line break]".

To say AdviceAnswer of (M - mechanic):
	if the class of the player is not succubus:
		say "[speech style of M]'[one of]My laundry robots won't bother you if you crawl into the laundry room on your hands and knees[if the appearance of the player > 4]. Heh, perfect position for you, right?'[otherwise].'[end if][or]The hotel is full of cameras. Try not to look like an idiot, or you might end up with your picture plastered to a wall somewhere.'[or][if the player is gendered male]The wrestler is into some really kinky shit. My advice is to leave [him of a random wrestler] alone if you don't want to play [his of a random wrestler] games.'[otherwise]Sluts tend to come through here often, so you'll probably find the wrestler good company. [big he of a random wrestler][']s a bit more dominant than [he of a random wrestler] lets on, though.'[end if][or]Your appearance can say a lot about you. For example, [if the lips of face > 1]big lips are a dead giveaway for sluts who'd love being deep-throated by my huge cock[otherwise if bukkake fetish is 1 and the make-up of face > 1]sluts who wear lots of makeup usually love a layer of jizz on top[otherwise if the player is exposed and the appearance of the player > 2]naked sluts usually love a nice deep ass-fucking[otherwise]that goth slut in the woods. Loves anal[end if].'[in random order][roman type][line break]";
	otherwise:
		say "[speech style of M]'Do I look like I have all day? I've already got some agents in the forest, ask them.[roman type][line break]".

To compute teaching of (M - mechanic):
	if diaper quest is 0:
		say "[speech style of M]'When girls like you get fucked too many times by guys like me, it starts to affect the way you hold yourself. Basically, if you're a [if the player is presenting as female]slut[otherwise]sissy[end if] your body language will broadcast it to everybody around you, and nobody's going to want to deal with the humiliation of knowing they got fucked by someone like you. But if you hold yourself like you have a massive dick, it'll do the opposite, [if the player is not possessing a penis]no matter how slutty you actually are[otherwise]no matter how pitiful the genuine article actually is[end if].'[roman type][line break]";
		teach fuckskill;
	otherwise:
		say "[speech style of M]'Hmm, maybe in a version of this game soon I'll have something to teach you.'[roman type][line break]".

Section 3 - Drink Requesting

To compute friendly drink of (M - mechanic):
	if M is interested:
		say "[BigNameDesc of M][']s smile fades slightly.[line break][speech style of M]'Sorry, we're not allowed to give out free drinks, it is pretty much the only way we make money after all!'[roman type][line break]";
	otherwise:
		say "[BigNameDesc of M] acts as if [he of M] didn't even hear you.".

To compute unfriendly drink of (M - mechanic):
	say "[speech style of M]'Do you think you DESERVE a drink? I don't.'[roman type][line break]";
	now M is interested;
	now the boredom of M is 0.

Definition: mechanic is willing to give snacks: decide yes.

Part 5 - Trading

To decide which number is the bartering value of (T - mystical amulet) for (M - mechanic):
	decide on 99.

To compute (M - mechanic) considering (T - mystical amulet):
	say "[speech style of M]'Holy SHIT, where did you find that?? Of course I'll take that off your hands.'[roman type][line break]";
	now T is worn by the player;
	follow the mechanic claims amulet rule.

Part 6 - Dominant Sex

[

If the player can steal the mechanic's wrench, the dominant sex scene is about the mechanic trying to steal it back. If he has the amulet, the scene is about that, and it's a lot harder to hold onto.

Three outcomes for the item the mechanic is carrying:
1. Player holds onto it the whole time
2. Player drops the item
3. Mechanic steals the item back

If the player drops the item, they have a chance to grab it once the sex is over. They can degrade themselves to distract him, but then they'll have to degrade themselves to distract him. Otherwise, the player has a simple dexterity check to be able to grab the item first.

If the mechanic gets his item back before the sex is over, the player will need to choose between degrading themselves or getting a punishment.

Either way, if the player degrades themself, their employee record improves and they might get a new headgear.

When the mechanic's wrench is stolen, he no longer does wrench attacks for a while. Eventually he will have a robot bring him a replacement, but until then he can't repair the robots the player breaks.
When the mechanic's amulet is stolen, he loses a lot of strength and probably can't transform into Xavier for a while

]
To suggestFucker (F - a body part) for (M - mechanic):
	if F is penis:
		say "Do you want to see if you can make [him of M] suck your [SexDesc of penis]?";
		if the player is consenting:
			now player-fucker is F;
			now player-fuckchoice is FUCK-BLOWJOB;
	otherwise if F is a fuckhole:
		say "Do you want to try [if M is carrying a mystical amulet]stealing the amulet. You can't think of anyway to distract [him of M], except your [variable F][otherwise if the wrench-timer of M <= 0]stealing [his of M] wrench? You might be able to use your [variable F] to distract [him of M][otherwise]riding [him of M]? [big he of M] might turn the tables on you[end if]...";
		if the player is consenting:
			now player-fucker is F;
			now player-fuckchoice is FUCK-RIDE;
	otherwise:
		say "You decide against it.".

To decide which number is the dominationtype of (M - mechanic) using (F - penis):
	decide on FUCK-BLOWJOB.

To decide which number is the submissiveness base of (M - mechanic):
	let D be the health of M;
	decrease D by the times-dominated of M * 2;
	if player-fuckchoice >= 0:
		increase D by the times-submitted of M;[If you're having trouble dominating the mechanic, fuck him a couple times]
		if M is carrying a mystical amulet, increase D by 3;[It's much harder to steal the amulet]
	decrease D by player-fuckchoice * 2;[player-fuckchoice corresponds to the type of sex.]
	decide on D.

To say PowerBottomComment of (M - mechanic):
	if the player is not able to speak:
		say "You gesture for [him of M] to lie down.";
	otherwise if the bimbo of the player < 6:
		if the player is gendered male:
			say "[first custom style]'[one of]Lie down. This isn't gay, I just really need you in my ass right now.'[or]Lie down. And NO, there's nothing gay about this. Except the anal, I guess.'[or]It's your lucky day, you get to fuck me. Lie down.'[at random][roman type][line break]";
		otherwise:
			say "[first custom style]'[one of]You understand then. Good. Lie down.'[or]Lie down. Now.'[or]Lie down and don't move a muscle.'[at random][roman type][line break]";
	otherwise if the bimbo of the player < 12:
		say "[variable custom style][one of]Lie down and get nice and hard for me.'[or]Lie down. We're going to have sex.'[or]Lie down for me, alright?'[at random][roman type][line break]";
	otherwise:
		say "[second custom style]'[one of]Lie down, baby. I'm going to take care of everything.'[or]Lie down. I'm dying to have you inside me.'[or]Don't worry baby, I'll do everything. Lie down for me.'[or]Lie down and don't worry about a thing. You're in [NameBimbo][']s hands now, honey.'[at random][roman type][line break]";

To compute failed dominance punishment of (M - mechanic):
	let H be trainee hood;
	if H is alive or H is not actually summonable or the player is a trained hooker, now H is black maid headdress;
	let B be a random off-stage trainee bra;
	if B is not clothing or the player is a trained hooker, now B is a random off-stage pasties;
	let E be a random off-stage trainee thigh highs;
	if E is not clothing or the player is a trained hooker, now E is a random off-stage rollerskates;
	if H is off-stage and H is actually summonable:
		say "[big he of M] forces a [ShortDesc of H] onto your head! ";
		summon H cursed;
		Satisfy M;
	otherwise if B is clothing and B is actually summonable:
		say "[big he of M] forces a [ShortDesc of B] onto your chest! ";
		summon B cursed;
		Satisfy M;
	otherwise if E is clothing and E is actually summonable:
		say "[big he of M] forces a [ShortDesc of E] onto your feet!";
		summon E cursed;
		Satisfy M;
	otherwise:
		say "[line break][speech style of M]'It's true you're a little violent, but I like that bold streak. Consider your interview underway.'[roman type][line break]";
		now another-turn-flavour is the substituted form of "[BigFuckerDesc of M] holds you in place.";
		now another-turn is 1.

To say DominanceFailure of (M - a mechanic):
	say "You grab [NameDesc of M] by the wrists and attempt to force [him of M] to [his of M] knees, but [he of M][']s stronger than [he of M] looks, and [he of M] forces you to the ground before you can find a weakness to take advantage of.".

To blowjob dominate (M - mechanic):
	if sexual-penis-length > 8:
		say "You force [NameDesc of M] to [his of M] knees, shoving your [SexDesc of penis] in [his of M] face.[line break][speech style of M]'N-no.'[roman type][line break][big he of M] stammers, unable to take [his of M] eyes off your huge [sexual-player-penis]. You alternate cock-slapping either side of [his of M] face until [his of M] cheeks are an angry red.[line break][speech style of M]'...Yes.'[roman type][line break][big he of M] looks up at you, shivering as [he of M] takes you into [his of M] mouth. To [his of M] credit, [he of M]'s a fairly obedient cocksucker, but [if the times-submitted of M > 0]you haven't forgotten how [he of M] treated you when the tables were turned[otherwise][he of M] still needs to be taken down a couple pegs[end if]. You force [him of M] to gag on your [sexual-player-penis] over and over, until you finally [if bukkake fetish is 1]shove [him of M] away and bust a massive nut all over [his of M] face[otherwise]shove [him of M] down and unleash your load right down [his of M] throat[end if].";
		BlowGet;
		obsceneDignify;
		orgasm;
	otherwise if sexual-penis-length > 3:
		say "You force [NameDesc of M] to [his of M] knees, looking down expectantly as you present [him of M] with your [SexDesc of penis].[line break][speech style of M]'No.'[roman type][line break]You slap [him of M]. Hard.[line break][speech style of M]'N-no.'[roman type][line break]You alternate slapping both sides of [his of M] face until [his of M] cheeks are an angry red.[line break][speech style of M]'N-....Yes.'[roman type][line break][big he of M] looks up at you with a defeated look in [his of M] eyes as [he of M] takes you into [his of M] mouth. To [his of M] credit, [he of M]'s a fairly obedient cocksucker, and [if the times-submitted of M > 0]as much as [he of M] deserves some roughness[otherwise]as much as you want to rough [him of M] up[end if], you simply let [him of M] do the work. After a little while, you [if bukkake fetish is 1]pull out and pump out your load on [his of M] face[otherwise]fill [his of M] mouth with your load[end if].";
		BlowGet;
		severeDignify;
		orgasm;
	otherwise:
		let P be a random off-stage generic-appropriate patron;
		say "You force [NameDesc of M] to [his of M] knees, looking down hopefully as you present [him of M] with your [SexDesc of penis].[line break][speech style of M]'No.'[roman type][line break][big his of M] outright refusal to comply with your demand is pretty damaging to your confidence, and you're about to give up, but just as you're about to let [him of M] go, a [ShortDesc of P] walks into the room.[line break][speech style of M]'Oh, am I interrupting?'[roman type][line break]You grin, kneeling down behind [NameDesc of M] and pinning [his of M] arms behind [his of M] back.[line break][variable custom style]'My friend here lost a bet and [he of M] doesn't want to pay up. Can you help us out?'[roman type][line break][NameDesc of P] doesn't even hesitate, immediately crossing the room and shoving [his of P] [DickDesc of P] into [NameDesc of M][']s mouth. [NameDesc of M] shoots you an indignant glare, but to [his of M] credit, [he of M]'s an obedient cocksucker, submissively polishing the [ShortDesc of P]'s [DickDesc of P] until [he of P] jizzes straight down [his of M] throat. You release [NameDesc of M] as [ShortDesc of P] walks away.";
		Bore P;
		strongDignify;
		now player-fucking is DOMINANT-NEUTRAL;
		Arouse 300;
	say AfterDominationComment 7 of M.

To ride dominate (M - mechanic):
	let J be mystical amulet;
	unless J is carried by M, now J is wrench;
	unless the wrench-timer of M <= 0, now J is throne;
	say "You grab [NameDesc of M] by the wrists and attempt to force [him of M] to [his of M] knees, but [he of M][']s stronger than [he of M] looks, and you frantically search around for a weakness as [he of M] begins to overpower you. [if J is mystical amulet]Your eyes find [his of M] amulet, and you desperately grab it and yank it off [his of M] neck. [big he of M] glares at you furiously[otherwise if J is wrench]Your eyes find [his of M] wrench, and you desperately wrest it out of [his of M] hand. That seems to have the desired effect, although [he of M] gives you a confused look[otherwise]Your eyes find a dangerous looking doo-hickey hanging from [his of M] belt, and you make a desperate lunge to yank it off [his of M] belt and point it at [him of M]. [big his of M] eyes widen[end if] as [he of M] slowly drops to [his of M] knees with [his of M] hands in the air. [PowerBottomComment of M] [BigNameDesc of M] nods and gets on [his of M] back, keeping [his of M] hands up.";
	now refractoryperiod is 1;[Ensures the player does not cum just from being penetrated]
	if player-fucker is asshole and the player is not possessing a vagina, anal ride dominate M;
	otherwise vaginal ride dominate M.

To vaginal ride dominate (M - mechanic):
	let J be mystical amulet;
	unless J is carried by M, now J is wrench;
	if the wrench-timer of M > 0, now J is the throne;
	otherwise now J is carried by the player;
	now M is penetrating vagina;
	check vaginal dominate entrance of M for J;[does the player get too excited]
	if player-fucking is not DOMINANT-SHAMEFUL, check vaginal dominate vigilance of M for J;[if the player wasn't too excited, do they pay attention?]
	if player-fucking is not DOMINANT-SHAMEFUL, check vaginal dominate focus of M for J;[if the player paid attention, do they lose focus]
	FuckCount;
	compute domination aftermath of M for J;
	now M is not penetrating vagina.

To check vaginal dominate entrance of (M - a mechanic) for (J - a thing):
	let G be the openness of vagina - the girth of M;
	now refractoryperiod is 1;
	let R be the semi-dominance roll for M;
	if R < 0:[immediate loss]
		if debugmode > 0, say "[bold type]FAILED![roman type][line break]";
		now player-fucking is DOMINANT-SHAMEFUL;
		say "You lick your lips in anticipation of how good it's going to feel to have [him of M] inside you, hungrily eyeing [his of M] [DickDesc of M] as you lower yourself into [his of M] lap. [BigNameDesc of M] immediately grabs you by the wrists[if J is clothing], knocking the [ShortDesc of J] out of your hand as [he of M] easily wrestles[otherwise] and easily wrestles[end if] you over onto your back.[line break][speech style of M]'Don't worry, bitch, I'll get you some dick. Hang on...'[roman type][line break]";
		unless J is throne, now J is in the location of the player;
		if J is amulet:[if you want to steal the amulet, you actually need to dominate him properly]
			say "[big he of M] snatches the [ShortDesc of J] off the floor and puts it around [his of M] neck. [big he of M] seems invigorated, roughly [if G < -1]forcing[otherwise]slamming[end if] [his of M] [DickDesc of M] into your [vagina] and eagerly beginning to thrust. ";
			now M is carrying J;
		otherwise if M is wrapped:
			if J is clothing and a random number between 1 and the appearance of the player < 5:[the hotter you are, the more likely he'll forget]
				say "[big he of M] peels the condom off [his of M] [DickDesc of M] and slides it into your [vagina] completely bareback.[line break][speech style of M]'Oh, can't forget this!'[roman type][line break][BigNameDesc of M] snatches the [ShortDesc of J] off the ground, smirking down at you as [he of M] begins to thrust. ";
				now M is carrying J;
			otherwise:
				say "[big he of M] peels the condom off [his of M] [DickDesc of M] and slides it into your [vagina] completely bareback.[line break][speech style of M]'[if J is not clothing]Much better[otherwise]You should have known better than to try this looking like that[end if].'[roman type][line break][BigNameDesc of M] smirks, grabbing your waist as [he of M] begins to thrust. ";
			now M is unwrapped;
		otherwise:
			if J is clothing and a random number between 0 and the appearance of the player < 10:
				say "[big he of M] snatches the [ShortDesc of J] off the floor and stows it in the pocket of [his of M] discarded pants.[line break][speech style of M]'Now, let's get started.'[roman type][line break][BigNameDesc of M] smirks, grabbing your waist as [he of M] begins to thrust. ";
				now M is carrying J;
			otherwise:
				say "[big he of M] grabs your cheeks, forcing you to [if face is actually occupied]look [him of M] directly in the eye as [he of M] spits in your face[otherwise if there is a worn ringagged clothing]look [him of M] directly in the eye as [he of M] spits in your mouth[otherwise]part your lips as [he of M] spits in your mouth[end if]. [if the delicateness of the player < 6]You seethe in rage and disgust[otherwise if the delicateness of the player < 12]You shiver in disgust, but don't look away[otherwise]You don't dare look away[end if] as [he of M] [if G < -1]eases[otherwise]slides[end if] [his of M] [DickDesc of M] into your [vagina] and eagerly begins to thrust. ";
				slightHumiliate;
		Ruin vagina times 2;
		say "Your thoughts are divided between [if the delicateness of the player > 5]the rush[otherwise]the humiliation[end if] of not being in control, and how stupid you were to try and take control in the first place. It's obvious now that there's only one natural position for you, and [NameDesc of M] emphasises where that is with every thrust. You [if G < -1]feel yourself being stretched out more with every moment[otherwise if G < 2]enjoy yourself more with every moment[end if], and you begin to moan as the pleasure builds and builds. [big he of M] doesn't show any signs of stopping, and you clench your fists as your lips form into a large, submissive 'O.'";
		now refractoryperiod is 0;
		vaginally orgasm shamefully;
		say "[line break][BigNameDesc of M] doesn't let up at all, roughly smacking your tits as [he of M] erodes your inhibitions away with every thrust. You hold eye contact with [him of M], moaning shamelessly as [he of M] uses you as nothing but a [if G < 2]tight[otherwise]warm[end if] sleeve for relieving [his of M] lust. Excitement wells up inside you as [his of M] [DickDesc of M] rapidly begins to spasm, and [he of M] jams [himself of M] in as far as [he of M] can go, groaning like the primal [man of M] [he of M] is as [he of M] pumps your [vagina] full of potent [semen].";
		PussyFill the semen load of M;
		strongHumiliate;
		orgasm M;
	otherwise:
		if debugmode > 0, say "[bold type]PASSED![roman type][line break]";
		say "You take a seat in [NameDesc of M][']s lap, watching [NameDesc of M] out of one eye as you [if G < -1]ease[otherwise]slide[end if] [his of M] [DickDesc of M] into your hole. ";
		Ruin vagina;
		say "[big he of M] stifles a grunt as you slowly begin to ride [him of M], and you allow your eyes to flutter closed as you savour the [if G < -1]intense [end if]feeling of [his of M] [DickDesc of M] moving in and out of your [vagina]. [BigNameDesc of M] shifts slightly underneath you, breathing slowly as [he of M] begins to thrust in time with the movement of your hips. [run paragraph on]".

To check vaginal dominate vigilance of (M - mechanic) for (J - a thing):
	let R be the semi-dominance roll for M;
	if R < 0:[player gets too excited and the mechanic grabs J or makes player drop it]
		if debugmode > 0, say "[bold type]FAILED![roman type][line break]";
		let G be the openness of vagina - the girth of M;
		now player-fucking is DOMINANT-SHAMEFUL;
		say "It feels so good that you don't even notice [him of M] grabbing your wrists until it's too late, and after an embarrassingly brief struggle, [he of M] rolls on top of you and pins you to the ground.[line break][speech style of M]'Don't say I never let you have a turn.'[roman type][line break][BigNameDesc of M] barely [if J is clothing]gives you time to realise you dropped the [ShortDesc of J][otherwise]leaves you time to gasp[end if] as [he of M] immediately begins to thrust at twice your original pace. [if G < -1][big he of M]'s painfully big, but it's[otherwise]It's[end if] impossible to not enjoy the feeling of [his of M] [DickDesc of M] persistently rubbing up against your G-spot, and pleasure rapidly builds as you [if the player is ashamed]begin to moan. You close your eyes in anticipation of your climax, unable to ignore how much better it feels now that [he of M]'s[otherwise]desperately try not to moan. You shut your eyes in reluctant anticipation of your climax, silently trying to convince yourself that it felt just as good when you were[end if] doing the fucking.";
		unless J is throne, now J is in the location of the player;
		moderateHumiliate;
		if M is wrapped:
			let N be the semen load of M;
			passively stimulate vagina from M;
			say "But instead of finishing you off, [he of M] pulls out.[line break][speech style of M]'Lose this.'[roman type][line break][big he of M] gestures at the condom covering [his of M] [DickDesc of M]. Pull it off? It might be your only chance to cum...";
			if the player is bimbo consenting:
				say "You rip the condom off without missing a beat, gasping as [his of M] [DickDesc of M] slams back in completely bareback.[line break][speech style of M][if the semen addiction of the player < 8]I can't believe I did that! I CAN'T BELIEVE I DID THAT[otherwise if pregnancy fetish is 1 and the pregnancy of the player is 0]I could get pregnant... I-I could get fucking pregnant[otherwise]I'm going to take it all in my fucking [vagina][end if]![roman type][line break]";
				now M is unwrapped;
				now refractoryperiod is 0;
				vaginally orgasm shamefully;
				say "[BigNameDesc of M] isn't far behind, slamming [himself of M] home and groaning with pleasure as [his of M] cock floods your [vagina] with potent [semen]. [big he of M] plants it nice and deep with every thrust, making sure to fully drive the consequences of your actions home.";
				if the womb volume of vagina < 5 - N and the pregnancy of the player is 0, WombFill N;
				otherwise PussyFill N;
				severeHumiliate;
			otherwise:
				say "[BigNameDesc of M] rolls [his of M] eyes[if J is clothing] and grabs the [ShortDesc of J] off the ground[end if].";
				if J is clothing, now M is carrying J;
		otherwise:
			if J is clothing and a random number between 0 and the appearance of the player < 10, now M is carrying J;
			say "But instead of finishing you off, [he of M] pulls out.[line break][variable custom style]'W-why did you stop?'[roman type][line break]You blurt, eliciting a nasty grin from your fucktoy turned stud.[line break][speech style of M]'Oh, just making sure you don't cum.'[roman type][line break][big he of M] [if M is carrying J]grabs the [ShortDesc of J] off the ground[otherwise]smirks[end if], jerking off to stay hard as [he of M] waits for you to cool off. You can only look up at [him of M] in dejectedly as [he of M] slams [his of M] [DickDesc of M] back in and ejaculates within only a few thrusts. Equal parts embarrassment and frustration swirl inside you as [he of M] floods your [vagina] with [semen].";
			passively stimulate vagina from M;
			slightHumiliate;
			PussyFill the semen load of M;
	otherwise:
		if debugmode > 0, say "[bold type]PASSED![roman type][line break]";
		say "You smack [his of M] hand away as [he of M] tries to [if J is clothing]sneak the [ShortDesc of J] out of your grip[otherwise]grab one of your wrists[end if], and you open your eyes just long enough to stare [him of M] down until [he of M] looks away. Putting [him of M] in [his of M] place eggs you on, and you ride [him of M] harder and harder, [if the relevant sex addiction of the player < 7]panting quietly[otherwise]moaning to yourself[end if] as [his of M] tip strokes your G-spot. [run paragraph on]".

To check vaginal dominate focus of (M - mechanic) for (J - a thing):
	let R be the semi-dominance roll for M;
	if R < 0:[player is distracted by how it feels and drops J]
		if debugmode > 0, say "[bold type]FAILED![roman type][line break]";
		say "Just as soon as you begin to really enjoy yourself, [big he of M] actually grabs your wrists, and you struggle to shake [him of M] off and [if J is clothing]hold onto the [ShortDesc of J][otherwise]stay on top[end if] at the same time. After a short scuffle, you fail at both, and [NameDesc of M] pins your arms firmly behind your back.[line break][speech style of M]'Looks like I WIN, bitch.'[roman type][line break]";
		unless J is throne, now J is in the location of the player;
		now player-fucking is DOMINANT-SHAMEFUL;
		if M is wrapped:
			say "[big he of M] pulls out, shrugging off your attempts to break out of [his of M] hold as [he of M] peels off [his of M] rubber with a sharp *SNAP.* You [if the relevant sex addiction of the player > 7]can't even begin to stifle your moan[otherwise]can't stifle your gasp[end if] as [he of M] slides [his of M] bare [DickDesc of M] back in, which feels incredible after going so long with the condom on. [if the player is not disgraced]You don't want to cum in such a shameful way[otherwise]You know it would be shameful to cum this way[end if], but there's nothing you can do as [NameDesc of M] slams [himself of M] home, flooding your [vagina] with potent [semen]. ";
			now M is unwrapped;
			now refractoryperiod is 0;
			vaginally orgasm shamefully;
			PussyFill the semen load of M;
			orgasm M;
		otherwise:
			say "[big he of M] immediately begins to thrust, shrugging off your attempts to break out of [his of M] hold as [he of M] rapidly fucks you to the finish. Although you're close, the scuffle ruined your concentration, and you don't have time to catch up as [NameDesc of M] ejaculates in only a few thrusts, groaning primally as [he of M] fills your [vagina] with [his of M] big, creamy load.";
			PussyFill the semen load of M;
			orgasm M;
			passively stimulate vagina from M;
		slightHumiliate;
	otherwise:
		if debugmode > 0, say "[bold type]PASSED![roman type][line break]";
		say "[big he of M] compensates with enthusiasm of [his of M] own, panting in an off rhythm with your [if the sex addiction of the player < 7]growing moans[otherwise]increasingly throaty moans[end if] as the pleasure comes to a peak. [run paragraph on]";
		if M is wrapped:
			if J is amulet:
				now player-fucking is DOMINANT-NEUTRAL;
				say "[BigNameDesc of M] grabs your wrists just before go over the edge, both of you gasping with pleasure as the struggle pushes [him of M] into you at a sudden angle. You lose your grip on the [ShortDesc of J] as you cum, and [he of M] roughly pins your arms behind your back as orgasm crashes through your body. [big he of M] isn't far behind, and [he of M] emits a primal groan as the condom floods with warmth";
				now J is in the location of the player;
			otherwise:
				say "[BigNameDesc of M] grabs your wrists just before go over the edge, both of you gasping with pleasure as the struggle pushes [him of M] into you at a sudden angle. [big he of M] groans, loosening [his of M] grip as [his of M] [DickDesc of M] spasms, and you finish at the same time. Orgasm crashes heavily through your body as the condom fills with [his of M] load.";
			orgasm;
		otherwise:
			if J is amulet:
				now player-fucking is DOMINANT-NEUTRAL;
				say "[BigNameDesc of M] grabs your wrists just before go over the edge, both of you gasping with pleasure as the struggle pushes [him of M] into you at a sudden angle. You go over the edge as [he of M] forces your arms together behind your back, and you drop the [ShortDesc of J] as orgasm rocks your body. [big he of M] stays right on your tail, groaning primally as [he of M] floods your [vagina] with [his of M] [semen].";
				now J is in the location of the player;
			otherwise:
				say "[BigNameDesc of M] grabs your wrists just before go over the edge, both of you gasping with pleasure as the struggle pushes [him of M] into you at a sudden angle. [big he of M] groans, loosening [his of M] grip as [he of M] floods your [vagina] with [semen]. You finish at the same time, little fireworks going off behind your eyes as orgasm crashes heavily through your body.";
			orgasm;
			PussyFill the semen load of M;
		orgasm M.

To anal ride dominate (M - mechanic):
	let J be mystical amulet;
	unless J is carried by M, now J is wrench;
	if the wrench-timer of M > 0, now J is the throne;
	otherwise now J is held by the player;
	now M is penetrating asshole;
	check anal dominate entrance of M for J;[does the player get too excited]
	if player-fucking is not DOMINANT-SHAMEFUL, check anal dominate vigilance of M for J;[if the player wasn't too excited, does she pay attention?]
	if player-fucking is not DOMINANT-SHAMEFUL, check anal dominate focus of M for J;[if the player paid attention, do they lose focus]
	AnalCount;
	compute domination aftermath of M for J;
	now M is not penetrating asshole.

To check anal dominate entrance of (M - a mechanic) for (J - a thing):
	let C be a random worn chastity cage;
	let G be the openness of asshole - the girth of M;
	now refractoryperiod is 1;
	let R be the semi-dominance roll for M;
	if R < 0:[immediate loss]
		if debugmode > 0, say "[bold type]FAILED![roman type][line break]";
		say "[if C is worn or the player is not possessing a penis]You giggle[otherwise]You're already hard[end if] in anticipation of how good it's going to feel to have [him of M] inside you, hungrily eyeing [his of M] [DickDesc of M] as you lower yourself into [his of M] lap. [BigNameDesc of M] immediately grabs you by the wrists[if J is clothing], knocking the [ShortDesc of J] out of your hand as [he of M][otherwise] and[end if] wrestles you over onto your back.[line break][speech style of M]'Don't worry, [sissy slut], I can handle this by myself. Hang on...'[roman type][line break]";
		now player-fucking is DOMINANT-SHAMEFUL;
		unless J is throne, now J is in the location of the player;
		if J is amulet:[if you want to steal the amulet, you actually need to dominate him properly]
			say "[big he of M] snatches the [ShortDesc of J] off the floor and puts it around [his of M] neck. [big he of M] seems invigorated, roughly [if G < -1]forcing[otherwise]slamming[end if] [his of M] [DickDesc of M] into your [asshole] and eagerly beginning to thrust. ";
			now M is carrying J;
		otherwise if M is wrapped:
			if J is clothing and a random number between 1 and the appearance of the player < 5:[the hotter you are, the more likely he'll forget]
				say "[big he of M] peels the condom off [his of M] [DickDesc of M] and slides it into your [asshole] completely bareback.[line break][speech style of M]'Oh, can't forget this!'[roman type][line break][BigNameDesc of M] snatches the [ShortDesc of J] off the ground, smirking down at you as [he of M] begins to thrust. ";
				now M is carrying J;
			otherwise:
				say "[big he of M] peels the condom off [his of M] [DickDesc of M] and slides it into your [asshole] completely bareback.[line break][speech style of M]'[if J is not clothing]You like that?[otherwise]You should have known better than to try this looking like that[end if].'[roman type][line break][BigNameDesc of M] smirks, grabbing your waist as [he of M] begins to thrust. ";
			now M is unwrapped;
		otherwise:
			if J is clothing and a random number between 0 and the appearance of the player < 10:
				say "[big he of M] snatches the [ShortDesc of J] off the floor and stows it in the pocket of [his of M] discarded pants.[line break][speech style of M]'Now, let's get started.'[roman type][line break][BigNameDesc of M] smirks, grabbing your waist as [he of M] begins to thrust. ";
				now M is carrying J;
			otherwise:
				say "[big he of M] grabs your cheeks, forcing you to [if face is actually occupied]look [him of M] directly in the eye as [he of M] spits in your face[otherwise if there is a worn ringagged clothing]look [him of M] directly in the eye as [he of M] spits in your mouth[otherwise]part your lips as [he of M] spits in your mouth[end if]. [if the delicateness of the player < 6]You seethe in rage and disgust[otherwise if the delicateness of the player < 12]You shiver in disgust, but don't look away[otherwise]You don't dare look away[end if] as [he of M] [if G < -1]eases[otherwise]slides[end if] [his of M] [DickDesc of M] into your [asshole] and eagerly begins to thrust. ";
				slightHumiliate;
		Ruin asshole times 2;
		say "[if G < -1]It's way too big, but the pain is overshadowed by the feeling of [his of M] tip ramming against your prostate[otherwise][big his of M] tip feels incredible ramming up against your prostate[end if], and [if C is worn]clear precum dribbles out of your cage as it jiggles[otherwise if the size of penis > 6]clear precum forms a squiggly line on your belly as your [ShortDesc of penis] jiggles[otherwise if the player is possessing a penis]clear precum pools on your belly as your [ShortDesc of Penis] bobs[otherwise]waves of pleasure wash over you as you pant[end if] in time with [NameDesc of M][']s powerful thrusts. You [if the player is ashamed]eagerly moan[otherwise]moan involuntarily[end if] as [he of M] pounds away, shame rushing through you as you realise that not only did you instantly mess everything up, but it never would have felt this good if you were still in control.[line break][second custom style]'[if face is actually occupied]MMMGG MMMHHH!'[otherwise]OOOH, FUCK ME!'[end if][roman type][line break]";
		now refractoryperiod is 0;
		anally orgasm shamefully;
		if previous penis length is 0 or refractoryperiod is 0 or the player is not possessing a penis:
			say "You don't ejaculate, but the look on [NameDesc of M][']s face tells you [he of M] definitely knows you [if refractoryperiod > 0]came[otherwise]almost did[end if]. [run paragraph on]";
		otherwise if the size of penis < 4 or C is worn:
			say "You moan uncontrollably as [semen] dribbles out of your [sissy-penis], forming a pitiful white pool on your belly. [run paragraph on]";
			AnnouncedSquirt semen on belly by the semen load of the player;
		otherwise if the size of penis < 8:
			say "You gasp sharply as long ropes of [semen] shoot out of your [manly-penis] in a short arc, leaving a sticky reminder of the nature of your orgasm splattered across your [ShortDesc of breasts]. [run paragraph on]";
			AnnouncedSquirt semen on breasts by the semen load of the player;
		otherwise:
			say "You shiver as long ropes of [semen] shoot out of your [manly-penis] in a huge arc, leaving a sticky reminder of the nature of your orgasm splattered across your face. [run paragraph on]";
			AnnouncedSquirt semen on face by the semen load of the player;
		say "[big he of M] doesn't let up on at all, eroding your inhibitions away with every thrust. You hold eye contact with [him of M], moaning shamelessly as [he of M] uses you as nothing but a [if G < 2]tight[otherwise]warm[end if] sleeve for relieving [his of M] lust. Excitement wells up inside you as [his of M] [DickDesc of M] rapidly begins to spasm, and [he of M] jams [himself of M] in as far as [he of M] can go, groaning like the real, primal man [he of M] is as [he of M] pumps your [asshole] full of [semen]. ";
		AssFill the semen load of M;
		orgasm M;
		strongHumiliate;
	otherwise:
		if debugmode > 0, say "[bold type]PASSED![roman type][line break]";
		say "You take a seat in [NameDesc of M][']s lap, watching [NameDesc of M] out of one eye as you [if G < -1]ease[otherwise]slide[end if] [his of M] [DickDesc of M] into your hole. ";
		Ruin asshole;
		say "[big he of M] stifles a grunt as you slowly begin to ride [him of M], and you allow your eyes to flutter closed as you savour the [if G < -1]intense [end if]feeling of [his of M] [DickDesc of M] moving in and out of your [asshole]. [BigNameDesc of M] shifts slightly underneath you, breathing slowly as [he of M] begins to thrust in time with the movement of your hips. [run paragraph on]".

To check anal dominate vigilance of (M - mechanic) for (J - a thing):
	let C be a random worn chastity cage;
	let R be the semi-dominance roll for M;
	if R < 0:[player gets too excited and the mechanic grabs J or makes player drop it]
		if debugmode > 0, say "[bold type]FAILED![roman type][line break]";
		let G be the openness of asshole - the girth of M;
		now player-fucking is DOMINANT-SHAMEFUL;
		say "It feels so good that you don't even notice [him of M] grabbing your wrists until it's too late, and after an embarrassingly brief struggle, [he of M] rolls on top of you and pins you to the ground.[line break][speech style of M]'Don't say I never let you have a turn.'[roman type][line break][BigNameDesc of M] barely [if J is clothing]gives you time to realise you dropped the [ShortDesc of J][otherwise]leaves you time to gasp[end if] as [he of M] immediately begins to thrust at twice your original pace. [if G < -1][big he of M]'s painfully big, but it's[otherwise]It's[end if] impossible not to enjoy the feeling of [his of M] [DickDesc of M] prodding your prostate, your [if C is worn]cage jiggling uselessly[otherwise if the size of penis >= 4][manly-penis] flopping against your belly[otherwise if the player is possessing a penis][sissy-penis] bobbing unimpressively[otherwise]nipples hardening[end if] as you [if the player is ashamed]begin to moan. You close your eyes in anticipation of your climax, unable to ignore how much better it feels now that [he of M]'s[otherwise]desperately try not to moan. You shut your eyes in reluctant anticipation of your climax, silently trying to convince yourself that it felt just as good when you were[end if] doing the fucking.";
		unless J is throne, now J is in the location of the player;
		moderateHumiliate;
		if M is wrapped:
			passively stimulate asshole from M;
			say "But instead of finishing you off, [he of M] pulls out.[line break][speech style of M]'Lose this.'[roman type][line break][big he of M] gestures at the condom covering [his of M] [DickDesc of M]. Pull it off? It might be your only chance to cum...";
			if the player is bimbo consenting:
				say "You rip the condom off without missing a beat, gasping as [his of M] [DickDesc of M] slams back in completely bareback.[line break][variable custom style]I'm going to take it all in my fucking ass![roman type][line break]";
				now M is unwrapped;
				if previous penis length is 0 or refractoryperiod is 0 or the player is not possessing a penis:
					say "You [if refractoryperiod > 0]cum[otherwise if the player is possessing a penis]don't ejaculate[otherwise]don't cum[end if], but [NameDesc of M] doesn't seem to notice, groaning primally as as [he of M] floods your [asshole] with [his of M] thick, creamy [semen].";
				otherwise if the size of penis < 4 or C is worn:
					say "You moan uncontrollably as [semen] dribbles out of your [sissy-penis], forming a shameful white pool on your belly. It sits there, a sticky reminder of the shameful nature of [i]your[/i] orgasm as [NameDesc of M] has one of [his of M] own, tightening [his of M] grip as [he of M] floods your [asshole] with [his of M] thick, creamy load.";
					AnnouncedSquirt semen on belly by the semen load of the player;
				otherwise if the size of penis < 8:
					say "You gasp sharply as long ropes of [semen] shoots out of your [manly-penis] in a short arc, leaving a sticky reminder of the nature of your orgasm splattered across your [ShortDesc of breasts]. [BigNameDesc of M] slams [himself of M] home a moment later, groaning primally as [his of M] [DickDesc of M] floods your [asshole] with [his of M] thick, creamy load.";
					AnnouncedSquirt semen on breasts by the semen load of the player;
				otherwise:
					say "You shiver as long ropes of [semen] shoot out of your [manly-penis] in a huge arc, leaving a sticky reminder of the nature of your orgasm splattered across your face. [BigNameDesc of M] slams [himself of M] home a moment later, groaning primally as [his of M] [DickDesc of M] floods your [asshole] with [his of M] thick, creamy load.";
					AnnouncedSquirt semen on face by the semen load of the player;
				orgasm quietly;
				Assfill the semen load of M;
				orgasm M;
				severeHumiliate;
			otherwise:
				say "[BigNameDesc of M] rolls [his of M] eyes[if J is clothing] and grabs the [ShortDesc of J] off the ground[end if].";
				if J is clothing, now M is carrying J;
		otherwise:
			if J is clothing and a random number between 0 and the appearance of the player < 10, now M is carrying J;
			say "But instead of finishing you off, [he of M] pulls out.[line break][variable custom style]'W-why did you stop?'[roman type][line break]You blurt, eliciting a nasty grin from your fucktoy turned stud.[line break][speech style of M]'Oh, just making sure you don't cum.'[roman type][line break][big he of M] [if M is carrying J]grabs the [ShortDesc of J] off the ground[otherwise]smirks[end if], jerking off to stay hard while [he of M] waits for you to cool off. You look up at [him of M] dejectedly as [he of M] slams [his of M] [DickDesc of M] back in and ejaculates within only a few thrusts. Equal parts embarrassment and frustration swirl inside you as [he of M] floods your [asshole] with [semen].";
			slightHumiliate;
			AssFill the semen load of M;
			orgasm M;
			passively stimulate asshole from M;
	otherwise:
		if debugmode > 0, say "[bold type]PASSED![roman type][line break]";
		say "You smack [his of M] hand away as [he of M] tries to [if J is clothing]sneak the [ShortDesc of J] out of your grip[otherwise]grab one of your wrists[end if], and you open your eyes just long enough to stare [him of M] down until [he of M] looks away. Putting [him of M] in [his of M] place eggs you on, and you ride [him of M] harder and harder, [if the relevant sex addiction of the player < 7]panting quietly[otherwise]moaning to yourself[end if] as [his of M] tip repeatedly hits your prostate. [run paragraph on]".

To check anal dominate focus of (M - mechanic) for (J - a thing):
	let R be the semi-dominance roll for M;
	if R < 0:[player is distracted by how it feels and drops J]
		if debugmode > 0, say "[bold type]FAILED![roman type][line break]";
		say "Just as soon as you begin to really enjoy yourself, [big he of M] actually grabs your wrists, and you struggle to shake [him of M] off and [if J is clothing]hold onto the [ShortDesc of J][otherwise]stay on top[end if] at the same time. After a short scuffle, you fail at both, and [NameDesc of M] pins your arms firmly behind your back.[line break][speech style of M]'REAL men always come out on top, [sissy slut].'[roman type][line break]";
		unless J is throne, now J is in the location of the player;
		now player-fucking is DOMINANT-SHAMEFUL;
		if M is wrapped:
			say "[big he of M] pulls out, shrugging off your attempts to break out of [his of M] hold as [he of M] peels off [his of M] rubber with a sharp *SNAP.* You [if the relevant sex addiction of the player > 7]can't even begin to stifle your moan[otherwise]can't stifle your gasp[end if] as [he of M] slides [his of M] bare [DickDesc of M] back in, which feels incredible after going so long with the condom on. [if the player is not disgraced]You don't want to cum in such a shameful way[otherwise]You know it would be shameful to cum this way[end if], but there's nothing you can do as [NameDesc of M] slams [himself of M] home, flooding your [asshole] with thick [semen]. ";
			now M is unwrapped;
			AssFill the semen load of M;
			now refractoryperiod is 0;
			anally orgasm shamefully;
			if previous penis length is 0 or refractoryperiod is 0 or the player is not possessing a penis:
				do nothing;
			otherwise if the size of penis < 4 or there is a worn chastity cage:
				say "You moan uncontrollably as [semen] dribbles out of your [sissy-penis], leaving a pitiful reminder of the nature of your orgasm pooling on your belly.";
				AnnouncedSquirt semen on belly by the semen load of the player;
			otherwise if the size of penis < 8:
				say "You gasp sharply as long ropes of [semen] shoot out of your [manly-penis] in a short arc, leaving a sticky reminder of the nature of your orgasm splattered across your [ShortDesc of breasts].";
				AnnouncedSquirt semen on breasts by the semen load of the player;
			otherwise:
				say "You shiver as long ropes of [semen] shoot out of your [manly-penis] in a huge arc, leaving a sticky reminder of the nature of your orgasm splattered across your face.";
				AnnouncedSquirt semen on face by the semen load of the player;
			orgasm M;
		otherwise:
			say "[big he of M] immediately begins to thrust, shrugging off your attempts to break out of [his of M] hold as [he of M] rapidly fucks you to the finish. Although you're close, the scuffle ruined your concentration, and you don't have time to catch up as [NameDesc of M] ejaculates in only a few thrusts, groaning primally as [he of M] fills your [asshole] with [his of M] big, creamy load.";
			AssFill the semen load of M;
			orgasm M;
			passively stimulate asshole from M;
		slightHumiliate;
	otherwise:
		if debugmode > 0, say "[bold type]PASSED![roman type][line break]";
		say "[big he of M] compensates with enthusiasm of [his of M] own, panting in an off rhythm with your [if the sex addiction of the player < 7]growing moans[otherwise]increasingly throaty moans[end if] as the pleasure comes to a peak. [run paragraph on]";
		if M is wrapped:
			if J is amulet:
				now player-fucking is DOMINANT-NEUTRAL;
				say "[BigNameDesc of M] grabs your wrists just before go over the edge, both of you gasping with pleasure as the struggle pushes [him of M] into you at a sudden angle. You lose your grip on the [ShortDesc of J] as you cum, and [he of M] roughly pins your arms behind your back as [if the player is possessing a penis]your [semen] dribbles out on [his of M] belly[otherwise]orgasm crashes through your body[end if]. [big he of M] isn't far behind, and [he of M] emits a primal groan as the condom floods with warmth";
				now J is in the location of the player;
			otherwise:
				say "[BigNameDesc of M] grabs your wrists just before go over the edge, both of you gasping with pleasure as the struggle pushes [him of M] into you at a sudden angle. [big he of M] groans, loosening [his of M] grip as [his of M] [DickDesc of M] spasms, and you finish at the same time. [if the player is possessing a penis]Your [semen] dribbles out on [his of M] belly[otherwise]Orgasm crashes heavily through your body[end if] as the condom fills with [his of M] load.";
			orgasm;
		otherwise:
			if J is amulet:
				now player-fucking is DOMINANT-NEUTRAL;
				say "[BigNameDesc of M] grabs your wrists just before go over the edge, both of you gasping with pleasure as the struggle pushes [him of M] into you at a sudden angle. You go over the edge as [he of M] forces your arms together behind your back, and you drop the [ShortDesc of J] as [if the player is possessing a penis]your load dribbles out on [his of M] belly[otherwise]orgasm rocks your body[end if]. [big he of M] stays right on your tail, groaning primally as [he of M] floods your [asshole] with [semen].";
				now J is in the location of the player;
			otherwise:
				say "[BigNameDesc of M] grabs your wrists just before go over the edge, both of you gasping with pleasure as the struggle pushes [him of M] into you at a sudden angle. [big he of M] groans, loosening [his of M] grip as [he of M] floods your [asshole] with [semen]. You finish just after [him of M], little fireworks going off behind your eyes as [if the player is possessing a penis]your [semen] dribbles out on [his of M] belly[otherwise]orgasm crashes heavily through your body[end if].";
			orgasm;
			AssFill the semen load of M;
		orgasm M.

To compute domination aftermath of (M - mechanic) for (J - a clothing):
	if player-fucking is DOMINANT-SHAMEFUL, now the stance of the player is 1;
	let F be player-fucker;
	if M is carrying J:
		if face is not actually occupied and a2m fetish > 0:
			say "[BigNameDesc of M] grabs you by the hair as [he of M] stands up, holding your face in front of [his of M] softening [DickDesc of M]. [if face is not actually occupied]Do you clean it off? [end if]";
			if the player is bimbo consenting:
				say "[if the relevant sex addiction of the player < 5]You try to ignore the taste of your[otherwise]You revel in the taste of your[end if] own [variable F] as you obediently slurp the leftover [semen] off [his of M] shaft. [big he of M] makes sure you keep going until you've swallowed every last drop.";
				now M is penetrating face;
				BlowCount;
				StomachSemenUp 1;
				moderateHumiliate;
				say AfterDominationComment 1 of M;["Thanks for the sex, here's a reward!"]
			otherwise:
				say AfterDominationComment 3 of M;["Clean up your messes, or something. no reward!"]
		otherwise:
			compute sissification;
			say AfterDominationComment 2 of M;["Thanks for the sex, here's a reward!"]
	otherwise if J is not held:
		if a2m fetish > 0, say "[line break]Your eyes meet as you both pant with exhaustion, and you turn toward the [ShortDesc of J] at the same time. [big he of M]'s still hard. Do you try to distract [him of M]?";
		if a2m fetish > 0 and the player is bimbo consenting:
			now player-fucking is DOMINANT-SHAMEFUL;[you can't be dominant if you do this]
			say "You kick the [ShortDesc of J] away, looking at [him of M] [if the sex addiction of the player < 8]with forced enthusiasm[otherwise]hungrily[end if] as you grab [his of M] still-hard [DickDesc of M].[if face is not actually occupied][line break][variable custom style]'Are you really satisfied? I can keep going...'[roman type][line break][end if]You make the sluttiest face you can, hoping [he of M] takes the bait.";
			let D be 10;
			if J is amulet, increase D by 5;
			if a random number between 0 and the appearance of the player < D and face is not actually occupied:
				say "[big he of M] scoffs, unceremoniously shoving you away as [he of M] crosses the room and snatches the [ShortDesc of J] off the ground.";
				slightHumiliate;[You're still humiliated because even though you didn't degrade yourself, you intended to]
				only destroy J;
				if J is amulet:
					now M is carrying J;
				say AfterDominationComment 6 of M;
			otherwise:
				say "[big he of M] grins, grabbing you by the hair and dragging you down to eye-level with [his of M] softening shaft. You have no choice but to wrap your lips around it, [if the relevant sex addiction of the player < 3]pretending what you're tasting isn't your own [variable F][otherwise]knowing what you're tasting is your own [variable F][end if] as you obediently polish [his of M] shaft. [big he of M] makes sure you slurp off every last drop, and then some, forcing you to keep going until [he of M] shoves you off and blows a second load all over your face.";
				now M is penetrating face;
				BlowCount;
				StomachSemenUp 1;
				if bukkake fetish is 1, CumFaceUp the semen load of M;
				severeHumiliate;[more humiliating because you chose to do it]
				say AfterDominationComment 1 of M;
				now J is in the location of the player;
		otherwise:
			let D be a random number between the difficulty of M * -1 and the dexterity of the player;
			if J is amulet, decrease D by 5;
			if D > 0:
				say "You slip out of [NameDesc of M][']s grip, snatching the [ShortDesc of J] off the ground as you jump to your feet!";
				if J is wrench, say AfterDominationComment 5 of M;
				otherwise say AfterDominationComment 4 of M;
				now J is held by the player;
			otherwise:
				say "You slip out of [NameDesc of M][']s grip, but it's too late! [big he of M] snatches the [ShortDesc of J] and shoves you off [him of M] before you can steal it back.";
				say AfterDominationComment 6 of M;
			severeDignify;
	otherwise if J is wrench:[You got his wrench!]
		say "You slip out of [NameDesc of M][']s grip and jump to your feet, [ShortDesc of J] firmly held in your hand.";
		ultraDignify;
		now the wrench-timer of M is 300;
		say AfterDominationComment 5 of M;
	otherwise:[You got the amulet.]
		say "You leave [NameDesc of M] on the ground as you get to your feet, [ShortDesc of J] firmly held in your hand.";
		ultraDignify;
		decrease the xavier-power of M by 4;
		say AfterDominationComment 4 of M.

To compute domination aftermath of (M - mechanic) for (J - throne):
	if player-fucking is DOMINANT-SHAMEFUL:
		now the stance of the player is 1;
		if face is not actually occupied and a2m fetish > 0:
			say "[BigNameDesc of M] grabs you by the hair as [he of M] stands up, holding your face in front of [his of M] softening [DickDesc of M]. [if face is not actually occupied]Do you clean it off? [end if]";
			if the player is bimbo consenting:
				say "[if the relevant sex addiction of the player < 5]You try to ignore the taste of your[otherwise]You revel in the taste of your[end if] own [variable player-fucker] as you obediently slurp the leftover [semen] off [his of M] shaft. [big he of M] makes sure you keep going until you've swallowed every last drop.";
				now M is penetrating face;
				BlowCount;
				StomachSemenUp 1;
				moderateHumiliate;
				say AfterDominationComment 1 of M;["Thanks for the sex, here's a reward!"]
			otherwise:
				say AfterDominationComment 3 of M;["Clean up your messes, or something. no reward!"]
		otherwise:
			compute sissification;
			say AfterDominationComment 2 of M;["Thanks for the sex, here's a reward!"]
	otherwise:
		say "You get to your feet with an overwhelming feeling of confidence bubbling up from your core.";
		ultraDignify;[getting to this point is difficult, so the reward is big]
		say AfterDominationComment 7 of M.

[The rewards for failing to dominate the mechanic should be better than the rewards for sex, since it's way more humiliating, creampie chance is 100%, and he gets a difficulty boost]
To say AfterDominationComment (N - a number) of (M - mechanic):
	if N is 1:[the player cleaned him off after sex]
		let H be trainee hood;
		unless H is off-stage and H is actually summonable, now H is black maid headdress;
		increase the employee-record of senior robobellboy by 2;[Worth more than a normal review!]
		if the player is hotel employed:
			say "[speech style of M]'[one of]Nice roleplay session. I really believed you were trying to steal it[or]That was a pretty good time. Nice acting, too[or]That was fun, and WOW are you good at acting[at random]. Consider this a successful employee review.'[roman type][line break]";
		otherwise if H is actually summonable and H is off-stage:
			say "[speech style of M]'[one of]You're actually not half bad. In fact, you're hired.'[or]That was a pretty good time. Welcome to my staff.'[or]You just ACED that interview. Welcome aboard, bitch.'[at random][roman type][line break][BigNameDesc of M] pulls out a [ShortDesc of H] and forces you into it!";
			summon H;
		otherwise:
			say "[speech style of M]'[one of]If this were an interview you would have ACED it. I'd love to creampie you again sometime.'[or]You know, I'd be glad to have a fuckhole like you on my staff. Let's do this again sometime.'[or]Come work for me sometime. It pays well, and I'll let you have clean-up duty whenever you want.'[at random][roman type][line break]";
	otherwise if N is 2:[the player didn't have the option to clean him off]
		let H be trainee hood;
		unless H is off-stage and H is actually summonable, now H is black maid headdress;
		if the player is hotel employed:
			increase the employee-record of senior robobellboy by 1;
			say "[speech style of M]'[one of]Good roleplay, but I felt like something important was missing.[or]Your acting was OK, but I think your performance was missing something.[or][if pregnancy fetish is 1]Breeding[otherwise]Nutting in[end if] you was fun, but I didn't really *believe* you were trying to steal it.[at random]'[roman type][line break]";
		otherwise:
			if the employee-record of senior robobellboy < 0, increase the employee-record of senior robobellboy by 1;
			say "[speech style of M]'[one of]Good fuck, but I don't know if I'd hire you.'[or]That was fun, but if this were an interview, I'd say you didn't bring your A-game.'[or]That felt good, but if you were trying to impress me with your acting, you're going to need to do better.'[at random][roman type][line break]";
	otherwise if N is 3:[the player had the option to clean him off and didn't]
		consider angry punishment of M;
	otherwise if N is 4:[the player stole the amulet]
		say "[speech style of M]'[one of]This is not over. I will have my amulet one way or another.'[or]You can't even unleash the amulet's full power. It was foolish to take it.'[or]You think you've won, but you haven't. I WILL have my amulet.'[or]You are a fool to think you can truly steal that from me.'[at random][roman type][line break]";
	otherwise if N is 5:[the player stole the wrench]
		say "[speech style of M]'[one of]Ugh, whatever. I'll find a fucking replacement, how's that?'[or][if the player is gendered female]Women[otherwise]Sluts[end if] are so annoying. Whatever. I'll just have to replace it.'[or]OK, you win. Keep it. I'll fucking buy a replacement.'[at random][roman type][line break]";
	otherwise if N is 6:
		say "[speech style of M]'[one of]You ALMOST had it. Just kidding. Stupid bitch.'[or]Try stealing it again and you're going to wish you hadn't.'[or]I didn't get to where I am today letting stupid bitches like you steal my possessions.'[at random][roman type][line break]";
	otherwise:
		say "[speech style of M]'[one of]Nasty bitch. I won't hold back next time.'[or]Fucking [cunt]. Try that again and see what happens.'[or]I'll remember this for next time, don't you worry bitch.'[at random][roman type][line break]";

Mechanic ends here.
