Slutty Sisters by Monster begins here.

A slutty sister is a kind of monster. A slutty sister is usually intelligent. Understand "Nintendoll" as a slutty sister.

Definition: a slutty sister is wenchy:
	if the player is not an april 2025 top donator, decide no;
	decide yes.

Definition: a slutty sister is raunchy: decide yes.
Definition: a slutty sister is summoningRelevant: decide no. [Doesn't count towards the number of monsters in the region for the purposes of summoning portals.]
Definition: a slutty sister is presenting as male:
	if lady fetish is 2, decide yes;
	decide no.
Definition: a slutty sister is a urinater: decide no. [If they went to the bathroom they'd not be very good guards]
Definition: a slutty sister is ready to entice: decide no. [Never entices]
Definition: a slutty sister is willing to do licking: decide no.

bulging-slutty-sister is a slutty sister.
The printed name of bulging-slutty-sister is "[if item described is in the location of the player][TQlink of item described][end if][input-style][ShortDesc of item described][if item described is asleep] (exhausted)[end if][shortcut-desc][roman type][if item described is in the location of the player][TQxlink of item described][verb-desc of item described][end if]". Understand "bloated", "cumfilled", "cum", "filled", "empty", "bulging" as bulging-slutty-sister. The text-shortcut of bulging-slutty-sister is "bu".
bulging-slutty-sister has a number called belly contents. bulging-slutty-sister has a number called cum overload.

Definition: bulging-slutty-sister is willing to do oral: decide yes.

futanari-slutty-sister is a slutty sister. futanari-slutty-sister is male. Understand "futa", "hung", "sword-wielding", "swordswoman", "sword" as futanari-slutty-sister.
The printed name of futanari-slutty-sister is "[if item described is in the location of the player][TQlink of item described][end if][input-style][ShortDesc of item described][if item described is asleep] (exhausted)[end if][shortcut-desc][roman type][if item described is in the location of the player][TQxlink of item described][verb-desc of item described][end if]". The text-shortcut of futanari-slutty-sister is "fu".

Definition: futanari-slutty-sister is willing to do oral: decide no.

Definition: futanari-slutty-sister is willing to do titfucks: decide no.

To say DickDesc of (M - futanari-slutty-sister):
	[say "[if futanari fetish is 0 and lady fetish < 2]dildo sword[otherwise if mythical creature fetish is 1]horsecock[otherwise][manly-penis][end if]".]
	say "[if lady fetish is 2][manly-penis][otherwise]dildo sword[end if]".

To say LongDickDesc of (M - futanari-slutty-sister):
	say "massive [DickDesc of M]".

Definition: a slutty sister is a sword-wielding-doll:
	if it is bulging-slutty-sister, decide no;
	if it is presenting as male, decide no;[
	if futanari fetish is 1, decide no;]
	decide yes.
Definition: a slutty sister is a penis-wielding-doll:
	if it is bulging-slutty-sister, decide no;
	if it is presenting as male, decide yes;[
	if futanari fetish is 1, decide yes;]
	decide no.

To say LongHoleDesc of (M - futanari-slutty-sister):
	if M is not a sword-wielding-doll, say "perfectly slick asshole";
	otherwise say "perfectly slick pussy".

To say HoleDesc of (M - futanari-slutty-sister):
	if M is not a sword-wielding-doll, say "asshole";
	otherwise say "pussy".

To say ShortDesc of (M - bulging-slutty-sister):
	say "[if the belly contents of M > 14]bulging[otherwise if the belly contents of M > 7]bloated[otherwise if the belly contents of M > 0]cumfilled[otherwise]empty[end if] Nintendoll".

To say LongHoleDesc of (M - bulging-slutty-sister):
	let adj be "perfectly wet";
	if the belly contents of M > 0, now adj is "[semen]-glazed";
	if the belly contents of M > 7, now adj is "[semen]-filled";
	if the belly contents of M > 14, now adj is "[semen]-drooling";
	if M is presenting as male, say "[adj] asshole";
	otherwise say "[adj] pussy".

To say ShortDesc of (M - futanari-slutty-sister):
	say "[if M is a sword-wielding-doll]sword-wielding[otherwise]hung[end if] Nintendoll".

To say MediumDesc of (M - a slutty sister):
	say ShortDesc of M.

Figure of dildo sword slutty sister is the file "NPCs/Bosses/SluttySister/sluttysister1a.png".
Figure of futanari slutty sister is the file "NPCs/Bosses/SluttySister/sluttysister1b.png".
Figure of bulging slutty sister belly 0 is the file "NPCs/Bosses/SluttySister/sluttysister2a.png".
Figure of bulging slutty sister belly 1 is the file "NPCs/Bosses/SluttySister/sluttysister2b.png".
Figure of bulging slutty sister belly 2 is the file "NPCs/Bosses/SluttySister/sluttysister2c.png".
Figure of bulging slutty sister belly 3 is the file "NPCs/Bosses/SluttySister/sluttysister2d.png".
Figure of male slutty sister is the file "NPCs/Bosses/SluttySister/sluttysister3.png".
Figure of male bulging slutty sister is the file "NPCs/Bosses/SluttySister/sluttysister4.png".
Figure of Slutty Sisters Cutscene 1 is the file "NPCs/Bosses/SluttySister/sluttysister-start1.jpg".
Figure of Slutty Sisters Cutscene 2 is the file "NPCs/Bosses/SluttySister/sluttysister-start2.png".

To decide which figure-name is the monster-image of (M - futanari-slutty-sister):
	if lady fetish is 2, decide on figure of male slutty sister;
	[if futanari fetish is 0, ]decide on figure of dildo sword slutty sister;
	decide on figure of futanari slutty sister.

To decide which figure-name is the monster-image of (M - bulging-slutty-sister):
	if lady fetish is 2, decide on figure of male bulging slutty sister;
	if the belly contents of M > 14, decide on figure of bulging slutty sister belly 3;
	if the belly contents of M > 7, decide on figure of bulging slutty sister belly 2;
	if the belly contents of M > 0, decide on figure of bulging slutty sister belly 1;
	decide on figure of bulging slutty sister belly 0.

To say MonsterDesc of (M - a slutty sister):
	say "This is one of the two [boy of M]s who [if the bimbo of the player < 8]tricked[otherwise if the bimbo of the player < 13][']helped['][otherwise]helped[end if] you into the game. [big he of M] is dressed exactly how you remember - a tiny white latex microskirt with a blue line at the waist, and a small white latex bra with blue straps. ";
	if M is futanari-slutty-sister:
		say "However, [if futanari fetish is 0]you're pretty sure the foot long, mega thick dildo sword is new[otherwise]you're pretty sure that in real life [he of M] didn't have a foot long, mega thick [DickDesc of M] dangling between [his of M] legs[end if].";
	otherwise if M is bulging-slutty-sister:
		if a2m fetish < 2 and lady fetish is 2, say "[big he of M] currently has a wand vibrator with the word 'Nintendolls' printed down the side, and a [if the belly contents of M > 14]giant bulging ballsack[otherwise if the belly contents of M > 7]large, bloated ballsack[otherwise if the belly contents of M > 0]visibly swollen ballsack[otherwise]small, normal-sized ballsack[end if].";
		otherwise say "[big he of M] currently has a wand vibrator with the word 'Nintendolls' printed down the side, and a [if the belly contents of M > 14]giant bulging belly[otherwise if the belly contents of M > 7]large, bloated belly[otherwise if the belly contents of M > 0]visibly distended belly[otherwise]flat, empty belly[end if].".

To say MonsterComment of (M - futanari-slutty-sister):
	say "[line break][variable custom style][if item described is penetrating an fuckhole]Uuuuugh! So big![otherwise if the anal sex addiction of the player < 5 and the vaginal sex addiction of the player < 5]Keep that monster of a thing away from me![otherwise if the anal sex addiction of the player < 8 and the vaginal sex addiction of the player < 8]I don't know if I'll survive a round with that...[otherwise]I wonder if I can take that without fainting. Sounds like a challenge![end if][roman type][line break]".

To say MonsterComment of (M - bulging-slutty-sister):
	if the belly contents of item described > 0, say "[line break][variable custom style][if item described is penetrating face][']Mmmmmmmmph!['][otherwise if the semen addiction of the player < 10]I'm so glad that's inside [him of M] and not inside me![otherwise if the semen taste addiction of the player < 15 and the belly contents of item described > 7]I think my stomach would explode if I had to drink all of that...[otherwise]I bet [his of M] [brother of M]'s cum tastes soooo good!![end if][roman type][line break]";

To set up (M - a slutty sister):
	reset M;
	now the monstersetup of M is 1;
	now the raw difficulty of M is the starting difficulty of M;
	if M is bulging-slutty-sister, now the belly contents of M is 20;
	now the health of M is the maxhealth of M;
	now M is in FinalBoss01.

To decide which number is the starting difficulty of (M - a slutty sister):
	decide on 11.

To compute unique unsimulated periodic effect of (M - bulging-slutty-sister): [futa pumps bulging up with more cum]
	if the belly contents of M < 20:
		if futanari-slutty-sister is in the location of M and M is awake and futanari-slutty-sister is awake and M is uninterested and futanari-slutty-sister is uninterested and M is not in the location of the player, increase the belly contents of M by 1.

To decide which number is the initial maxhealth of (M - a slutty sister):
	decide on 20 + (4 * game difficulty).

To decide which number is the girth of (M - futanari-slutty-sister):
	decide on 10.

To decide which number is the semen-load of (M - futanari-slutty-sister):
	decide on 18.

Definition: a slutty sister is too intimidating: decide no. [The player never refuses to fight the final boss.]

Definition: a slutty sister is able to remove cursed plugs: decide yes.

Definition: a slutty sister is concealment immune: decide yes.

Definition: a slutty sister is butt slut immune: decide no. [Special case where they are immune to concealment but obey butt slut.]

This is the spawn initial slutty sisters rule:
	if diaper quest is 0:
		if futanari-slutty-sister is off-stage:
			if debugmode > 0, say "Summoning futanari sister in hotel.";
			summon futanari-slutty-sister in the hotel;
		if bulging-slutty-sister is off-stage:
			if debugmode > 0, say "Summoning bulging sister in hotel.";
			summon bulging-slutty-sister in the hotel.
The spawn initial slutty sisters rule is listed in the setting up hotel monsters rules.

Definition: a slutty sister is human: decide yes.

Part 1 - Perception

Definition: a slutty sister (called M) is objectifying the player:
	if M is not interested or M is not in the location of the player:
		now the objectification of M is 0;
		decide no;
	if the objectification of M is 1, decide yes;
	if the wealth of the player >= 20:
		now the objectification of M is 1;
		decide yes;
	decide no.

To compute perception of (M - a slutty sister):
	say "[BigNameDesc of M] notices you[if the player is sluttily dressed].[otherwise]![end if]";
	if the latex-transformation of the player > 6:
		if M is bulging-slutty-sister:
			say "[speech style of M]'You shouldn't be here in your current state. Try to solve the curse first.'[roman type][line break][big he of M] snaps [his of M] fingers and suddenly, you aren't there any more.";
			teleport to Hotel01;
		bore M;
	otherwise if M is objectifying the player:
		let H be the number of worn humility-stone;
		if H > 0:
			if M is futanari-slutty-sister, say "[speech style of M]'Can you even handle that many humility stones? You won't be able to end the game unless you actually get past us and press the STOP button.'[roman type][line break]";
			otherwise say "[speech style of M]'Ooh, yay, you made it at last! Yep, were the final boss and you... [if H is 6]collected all 6. Impressive.'[otherwise]collected [H]. Interesting.'[end if][roman type][line break]";
		otherwise:
			if M is futanari-slutty-sister, say "[speech style of M]'[one of]About fucking time, I was getting tired of [if lady fetish is 2 or futanari fetish > 0]just fucking Little Miss Cum Balloon here over and over[otherwise]toying with this airheaded bimbo over and over[end if].'[or]Yum, let's go again.'[stopping][roman type][line break]";
			otherwise say "[one of]Ooh, yay, you made it at last! Yep, we're the final boss! Surprise! Get past us and press that STOP button to end the game. But we won't make it easy!'[or]Do your best, sweetie!'[stopping][roman type][line break]";
		if the times-met of M is 0 and M is futanari-slutty-sister:
			if lady fetish is 2:
				alwayscutshow figure of slutty sisters cutscene 2 for M;
			otherwise if futanari fetish > 0:
				alwayscutshow figure of slutty sisters cutscene 1 for M;
		anger M; [Should be unnecessary but just in case]
	otherwise:
		say "[speech style of M]'[if M is bulging-slutty-sister][one of]Oh dear honey, you've arrived at the final boss! That's us. Usually we would force you to fight us, but you don't even have enough prize money to pay back the game fee yet.'[or]Oh, you're back again.'[stopping][otherwise][one of]So if you do push the button now, you'll be working for us for a whole year. So we're not gonna stop you!'[or]Have you changed your mind? You gonna end the simulation early and dedicate yourself to work for us for a year?'[stopping][end if][roman type][line break]";
		calm M.

To compute friendly boredom of (M - a slutty sister):
	if M is not in the location of the player:
		now M is uninterested;
		now the boredom of M is 0.

Part 2 - Motion

To compute monstermotion of (M - a slutty sister):
	if M is not in FinalBoss01 and M is alive:
		say "BUG: Nintendoll appeared outside of boss room. Please report this to Aika with the following information:[line break]Current monster's turn: [current-monster][line break]Player's location: [location of the player][line break]NPC state: in [location of M]; [unless M is interested]not [end if]interested; [unless M is asleep]not [end if]asleep[paragraph break]";
		now M is in FinalBoss01.

To compute (M - a slutty sister) seeking (D - a direction):
	do nothing.

Definition: a slutty sister is scarable: decide no.

To compute room leaving of (M - a slutty sister): [This CANNOT be replaced with a function that potentially doesn't make them leave the room, for any NPC. Some while loops rely on this to eventually succeed or the game will freeze.]
	if M is in FinalBoss01:
		finally destroy M;
		say "BUG: Nintendoll forced to leave room. Please report this to Aika with the following information:[line break]Current monster's turn: [current-monster][line break]Player's location: [location of the player][line break]NPC state: [unless M is interested]not [end if]interested; [unless M is asleep]not [end if]asleep[paragraph break]";
	otherwise:
		now M is in FinalBoss01.

To compute sleep reduction of (M - a slutty sister):
	if M is asleep:
		decrease the sleep of M by seconds;
		if the M is awake:
			now the sleep of M is 0;
			if M is in the location of the player, say "[BigNameDesc of M] perks up, [he of M] looks ready for another round! Uh-oh...".

To compute labour to (M - a slutty sister):
	say DefaultBirthScene.
To compute fatherhood to (M - a slutty sister): [if alive, do not change the status of the slutty sister]
	dislodge M.

To compute diaper mess reaction of (M - a slutty sister):
	do nothing.
To compute diaper mess reaction of (M - futanari-slutty-sister): [Need to make sure she doesn't leave the room and also that she can still fuck the player]
	say "[BigNameDesc of M] rolls [his of M] eyes.[line break][speech style of M]'This is NOT the time.'[roman type][line break][big he of M] waves [his of M] hands and suddenly you're not wearing and underwear at all, and you're completely clean!";
	let D be a random worn knickers;
	if D is knickers, destroy D.

Part 3 - Combat

Definition: a slutty sister is seducable: decide no.

Section 1 - Attack

This is the nintendoll pop latex punishment rule:
	if the latex-transformation of the player >= 5:
		say "[speech style of current-monster]'Pop goes the weasel!'[roman type][line break][BigNameDesc of current-monster] grips your stomach with [his of current-monster] sharp fake nails, and you hear a loud 'POP'. Everything goes black.";
		Execute Fainting.
The latex punishment rule of a slutty sister is usually the nintendoll pop latex punishment rule.

To compute kneeling reaction of (M - futanari-slutty-sister):
	say "[BigNameDesc of M] stands over you, [his of M] [DickDesc of M] swaying gently like a pendulum.[line break][speech style of M]'It's business time.'[roman type][line break][if the player is not shameless]You shiver with shame.[end if]";
	strongHumiliate.

To compute kneeling reaction of (M - bulging-slutty-sister):
	say "[BigNameDesc of M] shoves two fingers inside [his of M] [HoleDesc of M], and begins to frig [himself of M] gently.[line break][speech style of M]'It's dinner time.'[roman type][line break][if the player is not shameless]You shiver with shame.[end if]";
	strongHumiliate.

To say LandingTaunt of (M - a slutty sister):
	say "[BigNameDesc of M] [one of]smiles widely[or]laughs mockingly[cycling].";
	moderateHumiliate.

The futanari unique punish rules is a rulebook.
This is the futanari unique punishment rule:
	follow the futanari unique punish rules;
	if the rule succeeded, rule succeeds.
The unique punishment rule of futanari-slutty-sister is usually the futanari unique punishment rule.

This is the futanari lets bulging go first rule:
	let M be current-monster;
	if there is a worn messed knickers:
		if bulging-slutty-sister is asleep and bulging-slutty-sister is in the location of the player:
			say "[speech style of M]'Me next! Open wide, bitch!'[roman type][line break]Just as you think you're going to get a chance to properly breathe, [NameDesc of M] plugs your throat with [his of M] [LongDickDesc of M]. You choke around it, gasping and clawing for breath in vain. A few seconds later, your eyes roll back as you [if the bladder of the player > 0]wet yourself and [end if]pass out.";
			now delayed fainting is 1;
			now the fainting reason of the player is 99;
		otherwise:
			say "[BigNameDesc of M] watches you, masturbating[one of] and laughing at the same time[or] rapidly[or] whilst grinning widely[or][or][in random order].";
		rule succeeds;
	if the number of monsters penetrating face are 0 and bulging-slutty-sister is combative, rule succeeds. [This means that the bulging girl is about to sit on the player's face.]
The futanari lets bulging go first rule is listed first in the futanari unique punish rules.

To say PresentAcceptanceFlav of (M - futanari-slutty-sister):
	say "[speech style of M]'Oh, the little slut thinks [he of the player] can choose where I stuff my giant [DickDesc of M]? Well, go on, just this once, I guess, I'll let you have it your way. Aren't I so kind?'[roman type][line break]".

To say PresentRejectionFlav of (M - futanari-slutty-sister):
	say "[speech style of M]'I'll put this where I want, not where you want, bitch.'[roman type][line break]".

To say StrikingSuccessFlav of (M - futanari-slutty-sister) on (B - a body part):
	say "[BigNameDesc of M] spins rapidly, thwacking you [TargetName of B] with [his of M] [DickDesc of M]!".

To say StrikingFailureFlav of (M - futanari-slutty-sister) on (B - a body part):
	say "[BigNameDesc of M] spins rapidly towards you, but you manage to jump out the way!".

To compute damaging attack of (M - bulging-slutty-sister) on (B - a body part):
	if the belly contents of M <= 7:[If her belly gets too low, she connects with an attack every time.]
		let B be the painful-part of M;
		say "[BigNameDesc of M] spins towards you, landing a brutal roundhouse kick [TargetName of B]!";
		compute M striking B;
	otherwise:
		compute striking attack of M.

To say StrikingSuccessFlav of (M - bulging-slutty-sister) on (B - a body part):
	say "[BigNameDesc of M] uses [his of M] [if nintendolls-wand is not held and nintendolls-wand is not in the location of the player]wand[otherwise]fingers[end if] to strike you [TargetName of B] with several arcs of blue energy!".

To say StrikingFailureFlav of (M - bulging-slutty-sister) on (B - a body part):
	say "[BigNameDesc of M] uses [his of M] [if nintendolls-wand is not held and nintendolls-wand is not in the location of the player]wand[otherwise]fingers[end if] to send several arcs of blue energy toward you, but you duck out of the way!".

To compute tripping attack of (M - futanari-slutty-sister):
	if bukkake fetish is 1 and bulging-slutty-sister is combative:
		if a random number between (the dexterity of the player - the semen addiction of the player) and 4 < 8:
			if a random number between (the semen taste addiction of the player + the dexterity of the player) and 4 > 12:
				say "[BigNameDesc of M] delicately strokes [his of M] [DickDesc of M], aiming it at you. You react quickly as a huge, unrealistic jet of [semen] blasts from the tip, catching most of it in your mouth and letting the rest splatter liberally across your face and [BreastDesc].";
				FaceFill semen by 4;
				AnnouncedSquirt semen on face by 2;
				UnannouncedSquirt semen on breasts by 2;
			otherwise:
				say "[BigNameDesc of M] delicately strokes [his of M] [DickDesc of M], aiming it at you. You [if the semen addiction of the player < 5][one of]are too shocked to dodge[or]are too slow to dodge[stopping][otherwise]too turned on to dodge[end if] as a huge, unrealistic jet of [semen] blasts from the tip and hits you straight in the mouth, coating your face and [BreastDesc].";
				AnnouncedSquirt semen on face by 5;
				UnannouncedSquirt semen on breasts by 5;
		otherwise:
			say "[BigNameDesc of M] delicately strokes [his of M] [DickDesc of M], aiming it at you at you at the last second. You react quickly enough to dodge out of the way as a quick jet of [semen] blasts from the tip and splatters on the floor.";
			SemenPuddleUp 1;
	otherwise:
		compute striking attack of M.

This is the sister facesitting prevents breathing rule:
	if there is bulging-slutty-sister penetrating face, decide yes;
	decide no.
The sister facesitting prevents breathing rule is listed in the breathing blocking rules.

To compute extra suffocation of (M - bulging-slutty-sister):
	do nothing. [no extra suffocation in this scene because it takes a long time for her to climax]

To compute (M - bulging-slutty-sister) entering mouth:
	if the player is clit stuck, say "[BigNameDesc of M] yanks on your clit lead and forces you to roll over onto your back!";
	otherwise say "[BigNameDesc of M] rolls you over onto your back!";
	if presented-orifice is face, say "You let [him of M], and [he of M] immediately sits on your face. ";
	otherwise say "[big he of M] succeeds, and immediately sits on your face. ";
	if a2m fetish >= 2, say "[if lady fetish is 2]Facing your forehead, [he of M] pinches your nose shut with two fingers and covers your mouth with [his of M] cum-filled [asshole], cutting off your ability to breathe.[otherwise]Facing your forehead, [he of M] covers your nose with the top of [his of M] vagina, and your mouth with [his of M] taint, giving you access to both [his of M] creampied pussy and cum-filled asshole, and cutting off your ability to breathe.[end if][line break][speech style of M]'[one of][if the belly contents of M > 10]You've got two options slut, try to swallow it all out of me, or faint trying.'[otherwise]You've got two options slut, bring me to orgasm, or faint trying.'[end if][or]Deja vu, bitch. You know the drill by now. Best of luck this time!'[stopping][roman type][line break]";
	otherwise say "[if lady fetish is 2]Facing your forehead, [he of M] pinches your nose shut with two fingers and fills your mouth with the tip of [his of M] cum-leaking [manly-penis], cutting off your ability to breathe.[otherwise]Facing your forehead, [he of M] covers your nose with the top of [his of M] creampied pussy, and cutting off your ability to breathe.[end if][line break][speech style of M]'[one of][if the belly contents of M > 10]You've got two options slut, try to swallow it all out of me, or faint trying.'[otherwise]You've got two options slut, bring me to orgasm, or faint trying.'[end if][or]Deja vu, bitch. You know the drill by now. Best of luck this time!'[stopping][roman type][line break]";
	if bukkake fetish is 1 and (lady fetish < 2 or a2m fetish >= 2):
		say "[big his of M] [semen] starts to seep out of [if lady fetish is 2][his of M] hole[otherwise]both [his of M] holes[end if] and [if the semen coating of face is 0]mess up[otherwise]add to the mess on[end if] your face.[if the semen addiction of the player < 7][line break][first custom style]Fucking hell! Yuck.[roman type][line break][end if][line break]";
		if the semen coating of face < 10, CumFaceUp 1;
	now the sex-length of M is 4;
	now the cum overload of M is 0;
	now M is filling face.

To compute facial sex of (M - bulging-slutty-sister):
	if the oral sex addiction of the player > 6, passively stimulate face from M;
	if bukkake fetish is 1 and (lady fetish < 2 or a2m fetish >= 2):
		CumFaceUp 1;
	compute facesit sex of M;
	if delayed fainting is 0 and the sex-length of M is 0 and the reaction of the player > 0:
		if lady fetish is 2, say "[BigNameDesc of M] climaxes on top of you, shooting several extra strings of [semen] [if a2m fetish >= 2]across your forehead[otherwise]inside your mouth[end if]. [if the belly contents of M > 0]But [he of M] doesn't get off on top of you - it looks like [he of M]'s still determined to make you drink every last drop of the [semen] inside of [him of M]![otherwise][big he of M] droops forward, steadying [himself of M] with [his of M] hands.[end if]";
		otherwise say "[BigNameDesc of M] climaxes on top of you, and [his of M] vaginal secretions sweeten the taste of the [semen] in your mouth. [if the belly contents of M > 0]But [he of M] doesn't get off on top of you - it looks like [he of M]'s still determined to make you drink every last drop of the [semen] inside of [him of M]![otherwise][big he of M] droops forward, steadying [himself of M] with [his of M] hands.[end if]".

To say FacesitResisting of (M - bulging-slutty-sister):
	say "[one of]You keep your mouth closed, winning the battle but fighting a losing war. There's no way to escape the inevitability of fainting except to [if lady fetish is 2 and a2m fetish < 2]suck [him of M] off[otherwise]lick [him of M] out[end if]. [or]You keep your mouth shut, deciding you'd rather faint than submit. [or]You continue to keep your mouth shut, and await the inevitable. [stopping]".

To say FacesitResistingResponse of (M - bulging-slutty-sister):
	say "[BigNameDesc of M] mercilessly holds [himself of M] in place.".

To say FacesitSubmissionResponse of (M - bulging-slutty-sister):
	if the belly contents of M > 0:
		let SL be the square root of (a random number between 1 and the semen taste addiction of the player);
		if the stomach of the player < 10:
			if a2m fetish >= 2:
				say "[one of]You lick the [boy of M][']s [HoleDesc of M] with your tongue, swallowing the [semen] as it slowly flows into your mouth.[or]You move your tongue downwards and dig it into the Nintendoll's asshole, which immediately rewards you with a thick glob of salty [semen].[or]Digging further into [his of M] asshole, you let your tongue explore its texture and taste, felching all the [semen] you can into your mouth.[or]You keep up rhythmic pumping motions with your tongue, allowing a steady supply of [semen] to ooze its way down your throat.[or]You use your neck muscles to pump your tongue even faster and deeper into [his of M] butthole. You are rewarded with another several gulps full of [semen].[cycling]";
			otherwise if M is presenting as female:
				say "[one of]You lick the [boy of M][']s cunt with your tongue, swallowing the [semen] as it slowly flows into your mouth.[or]You keep up rhythmic pumping motions with your tongue, allowing a steady supply of [semen] to ooze its way down your throat.[or]You use your neck muscles to pump your tongue even faster and deeper into [his of M] pussy. You are rewarded with another several gulps full of [semen].[cycling]";
			otherwise:
				say "[one of]You pleasure the [boy of M][']s [manly-penis] with your tongue, swallowing the [semen] as it slowly flows into your mouth.[or]You keep up rhythmic pumping motions with your mouth, allowing a steady supply of [semen] to ooze its way down your throat.[or]You use your neck muscles to pump your mouth even faster and deeper around [his of M] [manly-penis]. You are rewarded with another several gulps full of [semen].[cycling]";
			StomachSemenUp SL;
		otherwise if the stomach of the player - 10 <= the semen taste addiction of the player:
			say "[if the stomach of the player + 10 <= the semen taste addiction of the player]Your stomach is so full of [semen] that you have to put extra effort in to keep swallowing. But you love [semen] so much, you know you can find room![otherwise if the stomach of the player + 6 <= the semen taste addiction of the player]You are so full of [semen] you feel like you could explode! But you keep on obediently swallowing all the same.[otherwise if the stomach of the player + 2 <= the semen taste addiction of the player]Your bloated stomach screams at you - there's no more room for more [semen]! But it keeps coming, so you have to keep swallowing.[otherwise if the stomach of the player - 2 <= the semen taste addiction of the player]There's so much [semen] inside if you that you are really struggling to gulp any more down at all. Your bloated belly hurts badly. You feel like you could pass out any second.[otherwise]Thick streams of [semen] run out your nose as you begin to choke on your [semen] filled airpipe. Your eyes roll into the back of your head.[end if]";
			increase the stomach-semen of the player by SL * 2;
			SlowSemenTasteAddictUp 1;
		otherwise:
			say "Your mind goes blank as [NameDesc of M][']s unending stream of [semen] fills your lungs. You white out.";
			now delayed fainting is 1;
			now the fainting reason of the player is 22;
		decrease the belly contents of M by SL;
		if delayed fainting is 0:
			if the belly contents of M <= 0, say "The flow of [semen] seems to slow down and then dry up. [if the semen taste addiction of the player < 8]Hopefully[otherwise if the semen taste addiction of the player < 14 or the stomach of the player >= 10]Maybe[otherwise]Oh no,[end if] that's the last of it?[if the sex-length of M > 0][line break][BigNameDesc of M] continues to ride your face. It looks like you're not going to be allowed to breathe until you've made [him of M] cum![end if]";
			otherwise say "[if SL <= 1]You only get through a small[otherwise if SL is 2]You manage to consume a decent[otherwise]You are able to bring yourself to guzzle down a huge[end if] amount of [semen] this turn.";
	otherwise:
		if a2m fetish >= 1, say "You [one of]flick your tongue along [NameDesc of M][']s [if lady fetish is 2][DickDesc of M][otherwise]clit[end if], causing a squeak of satisfaction from the [boy of M] above.[or]give the outside of [NameDesc of M][']s asshole a passionate French kiss, which makes [him of M] writhe around on top of you with pleasure.[or]force your tongue as far as it can go into [NameDesc of M][']s asshole, and [he of M] responds by shuddering in pleasure.[or]You explore the depths of [NameDesc of M][']s [HoleDesc of M] with your tongue, pushing it in as deep as you can. [big he of M] groans with pleasure.[in random order]";
		otherwise say "You [one of]flick your tongue along [NameDesc of M][']s [if lady fetish is 2][DickDesc of M][otherwise]clit[end if], causing a squeak of satisfaction from the [boy of M] above.[or]give [if lady fetish is 2][NameDesc of M][']s [manly-penis][otherwise]the outside of [NameDesc of M][']s pussy[end if] a passionate French kiss, which makes [him of M] writhe around on top of you with pleasure.[or]force your tongue as far as it can go [if lady fetish is 2]along [NameDesc of M][']s shaft[otherwise]into [NameDesc of M][']s pussy[end if], and [he of M] responds by shuddering in pleasure.[in random order]".

To say NearingClimaxFacesit of (M - bulging-slutty-sister):
	say FacesitSubmissionResponse of M;
	say "[big his of M] [HoleDesc of M] spasms rapidly. [big he of M]'s getting close!".

To decide which number is the rounds of sex left of (M - bulging-slutty-sister):
	if the belly contents of M <= 0, decide on the default rounds of sex left of M;
	decide on 10.

To compute facial climax of (M - bulging-slutty-sister):
	compute facesit climax of M.

To compute facesit climax of (M - bulging-slutty-sister):
	TimesSubmittedUp M by 1;
	say "[BigNameDesc of M] stands up weakly, removing [his of M] crotch from your face, and allowing you to breathe again.[line break][speech style of M]'Okay, you win, that's more than enough for me for today.'[roman type][line break][big he of M] staggers over to one wall, where [he of M] slouches down with fatigue.";
	compute M sleeping 1000 after sex;
	orgasm bore M.

To say FacesitClimaxFlav of (M - bulging-slutty-sister):[actual orgasm flavour is handled by the facial sex function]
	say "[BigNameDesc of M] stands up weakly, removing [his of M] crotch from your face, and allowing you to breathe again.[line break][speech style of M]'Okay, you win, that's more than enough for me for today.'[roman type][line break][big he of M] staggers over to one wall, where [he of M] slouches down with fatigue.".

To say AssholePenetrationFlav of (M - futanari-slutty-sister):
	now the sex-length of M is 5 + (the health of M / 5);
	say "[if the number of slutty sisters penetrating face > 0][BigNameDesc of M] pulls your legs off the ground, forcing your butt into the air[otherwise][BigNameDesc of M] lifts your knees off the ground and forces them up over your shoulders[end if] as [he of M] drives [his of M] [LongDickDesc of M] into your [asshole]![line break][speech style of M]'[one of]Hold on tight honey, I'm taking you for a ride!'[or]I hope you're comfortable, this might take a while.'[at random][roman type][line break][if the openness of asshole > 8]Your gaping hole still has to stretch a bit further to take the girth of [his of M] [DickDesc of M].[otherwise if the openness of asshole > 5]Your loose hole still has to stretch painfully wide to accept [his of M] thick [DickDesc of M].[otherwise]Your eyes almost fly out of their sockets as your poor tight hole is forced wide, wider and then wider still as [his of M] girthy [DickDesc of M] slowly forces its way inside. You can't believe it's even physically possible for it to fit inside![end if]".

To say VaginaPenetrationFlav of (M - futanari-slutty-sister):
	now the sex-length of M is 5 + (the health of M / 5);
	say "[BigNameDesc of M] [if bulging-slutty-sister is penetrating face]spreads your legs[otherwise]spreads your legs, grabs your hips[end if] and drives [his of M] [LongDickDesc of M] into your [vagina]![line break][speech style of M]'[one of]Hold on tight honey, I'm taking you for a ride!'[or]I hope you're comfortable, this might take a while.'[at random][roman type][line break][if the openness of vagina > 8]Your gaping hole still has to stretch a bit further to take the girth of [his of M] [DickDesc of M].[otherwise if the openness of vagina > 5]Your loose hole still has to stretch painfully wide to accept [his of M] thick [DickDesc of M].[otherwise]Your eyes almost fly out of their sockets as your poor tight hole is forced wide, wider and then wider still as [his of M] girthy [DickDesc of M] slowly forces its way inside. You can't believe it's even physically possible for it to fit![end if]".

To compute fuckhole sex of (M - futanari-slutty-sister):[the sister is facing you so we can do some fun stuff we couldn't do normally]
	let F be a random fuckhole penetrated by M;
	say "[one of][BigNameDesc of M] continues pumping [his of M] [LongDickDesc of M] in and out of your [variable F].[or][BigNameDesc of M] slams [his of M] [LongDickDesc of M] in and out of your [variable F].[or][BigNameDesc of M] grins [if the reaction of the player is 0]cruelly[otherwise]knowingly[end if] as [he of M] relentlessly pounds your [variable F].[or][if the player is gagged][BigNameDesc of M] pounds you viciously, forcing you to grunt and moan through the [printed name of a random worn ballgag] in your mouth.[otherwise if bulging-slutty-sister is penetrating face][BigNameDesc of M] high fives [his of M] partner as [he of M] viciously pumps away.[otherwise][BigNameDesc of M] forces [his of M] tongue into your mouth, making exaggerated moaning noises as [he of M] pumps away.[end if][or][BigNameDesc of M] keeps pounding your [variable F], [if the largeness of breasts > 4]groping your [ShortDesc of breasts] as they flop against your chest.[otherwise]laughing cruelly as [he of M] brutally twists your nipples.[end if][or][BigNameDesc of M] moans with pleasure as [his of M] [LongDickDesc of M] slams in and out of your [variable F].[or][BigNameDesc of M] tosses you around like a living fleshlight, jamming your [variable F] into every thrust of [his of M] [LongDickDesc of M].[in random order]"; [TODO expand]
	decrease the sex-length of M by 1.

To compute anal sex of (M - futanari-slutty-sister):
	say "[one of][or][or][line break][speech style of M]'[big boy of the player], your butthole is FINE!'[roman type][line break][or][or][line break][speech style of M]'Unnngh, you still conscious there? Unf, you really are an ass bandit, huh?' [roman type][line break][or][stopping]";
	compute fuckhole sex of M;
	ruin asshole.

To compute vaginal sex of (M - futanari-slutty-sister):
	say "[one of][or][or][line break][speech style of M]'[big boy of the player], your pussay is TOP CLASS SHIT!'[roman type][line break][or][or][line break][speech style of M]'Unnngh, you still conscious there? Unf, you really are a naughty fuckslut, huh?' [roman type][line break][or][stopping]";
	compute fuckhole sex of M;
	ruin vagina.

To compute unique climax of (M - futanari-slutty-sister) in (F - asshole):
	compute creampie of M in F;
	now the sleep of M is 300;
	if delayed fainting is 0:
		if lady fetish < 2 and futanari fetish is 0, say "[speech style of M]'Ah fuck, that drained the last of my magic and energy...'[roman type][line break][BigNameDesc of M] collapses onto [his of M] ass, [his of M] [DickDesc of M] shrinking and going soft as [he of M] pulls out.";
		otherwise say "[speech style of M]'Ugh, you win... I'm done. Phew...'[roman type][line break][BigNameDesc of M] collapses onto [his of M] ass, [his of M] [DickDesc of M] quickly going limp as [he of M] pulls out.".

To compute unique climax of (M - futanari-slutty-sister) in (F - vagina):
	compute creampie of M in F;
	now the sleep of M is 300;
	if delayed fainting is 0:
		if lady fetish < 2 and futanari fetish is 0, say "[speech style of M]'Ah fuck, that drained the last of my magic and energy...'[roman type][line break][BigNameDesc of M] collapses onto [his of M] ass, [his of M] [DickDesc of M] shrinking and going soft as [he of M] pulls out.";
		otherwise say "[speech style of M]'Ugh, you win... I'm done. Phew...'[roman type][line break][BigNameDesc of M] collapses onto [his of M] ass, [his of M] [DickDesc of M] quickly going limp as [he of M] pulls out.".

To say CreampieFlav of (M - futanari-slutty-sister) in (F - a fuckhole):
	if lady fetish < 2 and futanari fetish is 0, say "[speech style of M]'This sword has one final trick for you... Coming right up!'[roman type][line break]";
	otherwise say "[speech style of M]'Unf... So [if the openness of F < 8]tight, so [end if]good! Aaah!'[roman type][line break]";
	say "[BigNameDesc of M][if futanari fetish is 0][']s magic sword starts pumping synthetic [semen][otherwise] starts to ejaculate[end if] deep inside your [variable F]! It feels like there's a powerful hosepipe shoved inside your belly!";

Section 2 - Damage

To compute damage reaction of (M - futanari-slutty-sister):
	if M is awake:
		if the health of M > the maxhealth of M / 2, say "[BigNameDesc of M] growls[one of], with a look of sexual hunger in [his of M] eyes[or] angrily[stopping]!";
		otherwise say "[one of][BigNameDesc of M][']s growl is definitely getting weaker. But [his of M] [DickDesc of M] is just throbbing even harder![or][BigNameDesc of M] grunts with pain.[stopping]";
	otherwise:
		now the sleep of M is 0;
		say "Suddenly, [NameDesc of M][']s [DickDesc of M] springs back to a full erection! [big he of M] looks very angry.[line break][variable custom style]Maybe that wasn't such a good idea...[roman type][line break]".

To compute damage reaction of (M - bulging-slutty-sister):
	if M is awake:
		if attack-type is 2 and the belly contents of M > 0:
			say "Your knee right in [his of M] [if a2m fetish < 2 and lady fetish is 2]swollen scrotum[otherwise]stomach[end if] causes [him of M] to double over in pain as a huge gush of [semen] flows out [his of M] [if a2m fetish >= 2][asshole][otherwise if lady fetish is 2][manly-penis][otherwise][vagina][end if]! [big he of M] [one of]looks at you with shock, pain and anger in [his of M] eyes. However if anything the smaller [if a2m fetish < 2 and lady fetish is 2]ballsack[otherwise]belly[end if] has just improved [his of M] ability to move and fight[or]moans loudly[stopping].";
			if the belly contents of M >= 4:
				SemenPuddleUp 4;
				decrease the belly contents of M by 4;
			otherwise:
				SemenPuddleUp the belly contents of M;
				now the belly contents of M is 0;
			increase the raw difficulty of M by 2;
		otherwise:
			if the health of M > the maxhealth of M / 2, say "[BigNameDesc of M] squeaks with anger!";
			otherwise say "[BigNameDesc of M] squeals with pain!";
	otherwise:
		now the sleep of M is 0;
		say "[BigNameDesc of M] jumps to [his of M] feet! [big he of M] looks very angry.[line break][variable custom style]Maybe that wasn't such a good idea...[roman type][line break]".

To compute defeat of (M - bulging-slutty-sister):
	say "[speech style of M]'Aack! [if bulging-slutty-sister is combative]I'm done for. Show [him of the player] who's boss, partner...'[otherwise]I can't believe this, you actually won...'[end if][roman type][line break][BigNameDesc of M] falls unconscious[if nintendolls-wand is not held and nintendolls-wand is not in the location of the player], [his of M] wand falling out of [his of M] hand[end if].";
	dislodge M; [might be wrangling arms]
	now the sleep of M is 300;
	now the health of M is 1;
	if nintendolls-wand is not held:
		now nintendolls-wand is in the location of the player;[you might still be in combat, so no autotaking.]
	if the sleep of futanari-slutty-sister > 0:
		compute dom offer of M.

To compute defeat of (M - futanari-slutty-sister):
	say "[speech style of M]'Unf! [if bulging-slutty-sister is combative]Fuck [him of the player] up, partner...'[otherwise]Fine, you win. Well done...'[end if][roman type][line break][BigNameDesc of M] falls unconscious.";
	dislodge M; [might be wrangling arms]
	now the health of M is 1;
	now the sleep of M is 300;
	if the sleep of bulging-slutty-sister > 0:
		compute dom offer of M.

To compute dom offer of (M - a slutty sister):
	let LT be a list of texts;
	let PT be the substituted form of "[PityDesc of M]";
	let PeT be the substituted form of "[PenisFuckDesc of M]";
	let AT be the substituted form of "[AssRideDesc of M]";
	let VT be the substituted form of "[VaginaRideDesc of M]";
	add PT to LT;
	if the latex-transformation of the player < 6 and (the player is not feeling submissive or the player is a nympho):
		if M is penis-fuckable and the player is penis-fuckable, add PeT to LT;
		if M is vagina-rideable and the player is vagina-rideable, add VT to LT;
		if M is ass-rideable and the player is ass-rideable, add AT to LT;
	if the number of entries in LT is 0:
		do nothing;
	otherwise:
		let T be entry 1 in LT;
		if the number of entries in LT > 1:
			reset multiple choice questions; [ALWAYS REMEMBER THIS WHEN MAKING A MULTIPLE CHOICE QUESTION]
			repeat with X running through LT:
				set next numerical response to X;
			compute multiple choice question;
			now T is chosen numerical response;
			if T is PT:
				do nothing;
			otherwise if T is PeT:
				now player-fucker is penis;
				compute dominating M;
			otherwise if T is VT:
				now player-fucker is vagina;
				compute dominating M;
			otherwise if T is AT:
				now player-fucker is asshole;
				compute dominating M;
			otherwise:
				say "BUG: Unable to understand defeat choice.".

To say PityDesc of (M - a slutty sister):
	say "Leave [NameDesc of M] alone..".

To say PenisFuckDesc of (M - a slutty sister):
	say "Attempt to dominate [NameDesc of M] with your [PenisFucker].".

To say VaginaRideDesc of (M - a slutty sister):
	say "Attempt to dominate [NameDesc of M] with your [vagina].".

To say AssRideDesc of (M - a slutty sister):
	say "Attempt to dominate [NameDesc of M] with your [asshole].".

Section 3 -  Dominant sex

To say WeaknessDesc of (M - a slutty sister):
	if the noun is undefeated:
		if the health of the noun < the maxhealth of the noun / 4:
			if the noun is wenchy and saved-flat-intelligence > 6:
				if the number of worn humility-stone < 3:
					say "[BigNameDesc of M] looks near defeat, but [he of M] doesn't seem to think of you as a threat at all. Maybe if you had some higher tier of power...";
				if saved-flat-intelligence > 11:
					if the number of worn humility-stone < 6:
						say "[BigNameDesc of M] looks ready to admit defeat, but there's will in those eyes even when [he of M] looks at your stones.";
					otherwise:
						say "[BigNameDesc of M] looks ready to admit defeat, especially when [he of M] looks at your stones.";
			otherwise:
				say "[BigNameDesc of noun] looks near defeat.";
		otherwise if the health of the noun < the maxhealth of the noun / 2:
			say "[BigNameDesc of noun] seems to be quite injured.".

To decide which number is the mental dominance roll for (M - a slutty sister):
	let X be the number of worn humility-stone;
	if debugmode > 0, say "[input style]Nintendoll Humility Stone Check... AUTOMATIC [if X < 3]FAILURE[otherwise]SUCCESS[end if][line break]";
	if X < 3:
		decide on -99;
	decide on 99.

Definition: a slutty sister is ass-rideable:
	if it is vagina-rideable, decide yes;
	decide no.
Definition: a slutty sister is vagina-rideable:
	if it is wenchy and it is a penis-wielding-doll, decide yes;
	decide no.

To decide which number is the dominationtype of (M - a futanari-slutty-sister) using (F - a body part):
	if F is a fuckhole, decide on FUCK-RIDE;
	decide on FUCK-PENETRATION.

To decide which number is the dominationtype of (M - a bulging-slutty-sister) using (F - a body part):
	decide on FUCK-PENETRATION.

To compute unique dominance reward of (M - a slutty sister):
	compute default dominance reward of M;
	increase the extra lives of the player by 1;
	SilentlyDifficultyUp M by 4;
	say "Some of your pubic hair has grown back!";
	DelicateDown 1.

To say DominanceFailure of (M - a slutty sister):
	let G be a random worn ballgag;
	say "You grab [NameDesc of M] by the wrists, smirking triumphantly [if G is clothing](around your gag) [end if]as you slowly force [him of M] [if M is bulging-slutty-sister]to [his of M] knees. [otherwise]onto [his of M] ass. [end if][big he of M] smirks back.[line break][speech style of M][']Well, I was GOING to let you win, but looks like you forgot one thing: In here, reality can be whatever we want.['][roman type][line break]A powerful FORCE crashes against your body, and you black out as you are blown across the room.".

To compute failed dominance punishment of (M - a slutty sister):
	teleport to Dungeon12;
	increase the extra lives of the player by 1;[You faint, but you don't expend a life.]
	now delayed fainting is 1;
	now the fainting reason of the player is 25.

To replace (M - a slutty sister) after domination:
	say "Your vision blurs as your body is transported to the [Dungeon12]";
	teleport to Dungeon12;
	bore M.

To say DominanceSuccess of (M - a slutty sister):
	let G be a random worn ballgag;
	say "You [if the player is wrist bound]throw your weight agsint [NameDesc of M][otherwise]grab [NameDesc of M] by the wrists[end if], smirking triumphantly [if G is clothing](around your gag) [end if]as you slowly push [him of M] to the ground. [big he of M] smirks back. A powerful FORCE threatens to take hold of your body and blast it across the room, but an equally powerful force split [the number of worn humility-stone] ways rises up to meet it! The stones spit out sparks as you slowly pin [NameDesc of M] down and [run paragraph on]";
	if player-fuckchoice is FUCK-PENETRATION:
		penetration dominate M;
	otherwise:
		ride dominate M;
	Bore M.

To ride dominate (M - a slutty sister):
	let F be player-fucker;
	let G be a random worn ballgag;
	let H be the number of worn humility-stone;
	let N be bulging-slutty-sister;
	if M is bulging-slutty-sister, now N is futanari-slutty-sister;
	let O be the openness of player-fucker;
	say "[if O > 8]slide[otherwise if O > 3]push[otherwise ]ease[end if] [his of M] [LongDickDesc of M] into your [variable F]. [big he of M] [if O > 3]moans[otherwise]hisses[end if] as you begin to rock your hips, and [his of M] shaft twitches and throbs inside of you as you pick up speed. You throw all your weight against [him of M], allowing all your [if the player is a nympho]appreciation[otherwise]resentment[end if] for the game to fuel you! Sweat beads on your forehead, your breath quickens, and your pelvic floor muscles clench as you close in on-";
	if H < 6:
		say paywall demand of M with N;
		if the player is bimbo consenting:
			if G is clothing:
				say "A cartoon meter with the word 'dominant' at the bottom and the word 'shameful' at the top appears in the corner of your vision. It begins to fill as [NameDesc of N] leans over your shoulder, fondling your [ShortDesc of breasts] as [he of N] locks lips with [NameDesc of M], who *moans* and begins to thrust [his of M] hips. You are forced to watch them from inches away, feeling the warmth of their bodies but none of the pleasure, the meter filling further and further with every exaggerated gasp, giggle, or hum that escapes their lips. Your [if F is asshole and the player is possessing a penis]prostate[otherwise][variable F][end if] clenches the very moment the meter reaches the top, waves of shame rolling through your body as [NameDesc of M] fills you with [his of M] load.";
			otherwise:
				say "A cartoon meter with the word 'dominant' at the bottom and the word 'shameful' at the top appears in the corner of your vision. It begins to fill as [NameDesc of N] parks [his of M] [LongHoleDesc of M] over your mouth, and [NameDesc of M] seizes your hips. It fills further and further as you [if O < 3]reluctantly lick[otherwise if O < 5]obediently eat [him of M] out[otherwise]eagerly kiss and lick [him of M] out[end if], the thrusting [DickDesc of M] in your [variable F] helping things right along. Your [if F is asshole and the player is possessing a penis]prostate clenches[otherwise]mucles clench[end if] the very moment the meter reaches the top, waves of shame rolling through your body as [NameDesc of M] fills you with [his of M] load.";
			orgasm M;
			orgasm N;
			if F is vagina:
				PussyFill the semen load of M;
				vaginally orgasm shamefully;
			otherwise:
				AssFill the semen load of M;
				anally orgasm shamefully;
			now player-fucking is DOMINANT-SHAMEFUL;
			say AfterDominationComment 1 of M;
		otherwise:
			say AfterDominationComment 2 of M;
			obsceneDignify;
	otherwise:
		say "[line break][speech style of N]'We can[']t let you cum like that, [NameBimbo].'[roman type][line break][speech style of M]'The shareholders have ordered us to take you down!'[roman type][line break][BigNameDesc of N] grabs you from behind, snapping [his of M] fingers as your [if F is asshole and the player is possessing a penis]prostate[otherwise][variable F][end if] is literally 'paused' at the moment right before orgasm. Unwilling to let them [if the player is a nympho]win so easily, [otherwise]win, [end if]you focus and tap into the true power of the stones, moaning as you will yourself to cum anyway, clamping down around [NameDesc of M]'s [LongDickDesc of M]!";
		say AfterDominationComment 3 of M;
		ultraDignify;
		orgasm.

To penetration dominate (M - a slutty sister):
	let H be the number of worn humility-stone;
	let G be a random worn ballgag;
	let L be sexual-penis-length;
	let N be bulging-slutty-sister;
	if M is bulging-slutty-sister, now N is futanari-slutty-sister;
	if sexual-penis-length > 8:
		say "push your [SexDesc of penis] into [his of M] [LongHoleDesc of M]! [big he of M] hisses as you begin to thrust, rocking [his of M] hips against you even as [he of M] keeps trying to free [his of M] wrists from your grip. You pick up speed, aiming your tip at [his of M] g-spot as you steadily build yourself towards orgasm. Sweat beads on your forehead as you close in, and you slam your [SexShaft] home as-";
	otherwise if sexual-penis-length > 3:
		say "slide your [SexDesc of penis] into [his of M] [LongHoleDesc of M]! [big he of M] coos as you begin to thrust, rocking [his of M] hips against you even as [he of M] keeps trying to free [his of M] wrists from your grip. You pick up speed, pounding every ounce [if the player is a nympho]gratitude[otherwise]resentment[end if] over this [if the player is a nympho]fun[otherwise]stupid[end if] game into [his of M] hole! Sweat beads on your forehead as you close in on a climax, and you clench your buttcheeks as-";
	otherwise:
		say "slip your [SexDesc of penis] into [his of M] [LongHoleDesc of M]! [big he of M] moans theatrically as you begin to thrust, rocking [his of M] hips against you even as [he of M] keeps trying to free [his of M] wrists from your grip. You pick up speed, desperately biting your lip to hold your orgasm as long as you can. In the end, you can't win against your sensitive little [sissy-penis], and you clench your buttcheeks as-";
	if H < 6:
		say paywall demand of M with N;
		if the player is bimbo consenting:
			let O be the oral sex addiction of the player;
			if G is clothing:
				say "A cartoon meter with the word 'dominant' at the bottom and the word 'shameful' at the top appears in the corner of your vision. It begins to fill as [NameDesc of N] leans over your shoulder, fondling your [ShortDesc of breasts] as [he of N] locks lips with [NameDesc of M], who *moans* and begins to gyrate [his of M] hips. You are forced to watch them from inches away, feeling the warmth of their bodies but none of the pleasure, the meter filling further and further with every exaggerated gasp, giggle, or hum that escapes their lips. Your [SexShaft] spasms the very moment the meter reaches the top, waves of shame rolling through your body as you fill [NameDesc of M] with your load.";
				orgasm M;
				orgasm N;
				penis orgasm shamefully;
			otherwise if N is a penis-wielding-doll:
				say "A cartoon meter with the word 'dominant' at the bottom and the word 'shameful' at the top appears in the corner of your vision.  It begins to fill as [NameDesc of N] slaps [his of M] [LongDickDesc of N] on your cheek, and [NameDesc of M] begins to gyrate [his of M] hips. It fills further and further as you [if O < 3]reluctantly start[otherwise if O < 5]start[otherwise]eagerly start[end if] sucking [him of M] off, and the thighs grinding against your waist help things right along. Your [SexShaft] spasms the very moment the meter reaches the top, waves of shame rolling through your body as you fill [NameDesc of M] with your load and [NameDesc of N] ejaculates down your throat!";
				StomachSemenUp the semen load of N;
				orgasm M;
				orgasm N;
				penis orgasm shamefully;
			otherwise:
				say "A cartoon meter with the word 'dominant' at the bottom and the word 'shameful' at the top appears in the corner of your vision.  It begins to fill as [NameDesc of N] parks [his of M] [LongHoleDesc of M] over your mouth, and [NameDesc of M] begins to gyrate [his of M] hips. It fills further and further as you [if O < 3]reluctantly lick[otherwise if O < 5]obediently eat[otherwise]eagerly lick[end if] [him of M] out, and the thighs grinding against your waist help things right along. Your [SexShaft] spasms the very moment the meter reaches the top, waves of shame rolling through your body as you fill [NameDesc of M] with your load.";
				orgasm M;
				orgasm N;
				penis orgasm shamefully;
			say AfterDominationComment 1 of M;
			now player-fucking is DOMINANT-SHAMEFUL;
		otherwise:
			say AfterDominationComment 2 of M;
			obsceneDignify;
	otherwise:
		say "[line break][speech style of N]'We can[']t let you cum like that, [NameBimbo].'[roman type][line break][speech style of M]'The shareholders have ordered us to take you down!'[roman type][line break][BigNameDesc of N] grabs you from behind, snapping [his of M] fingers as your [SexShaft] is literally 'paused' at the moment right before orgasm. Unwilling to let them [if the player is a nympho]win so easily, [otherwise]win, [end if]you focus and tap into the true power of the stones, [if L > 3]groaning[otherwise]moaning[end if] as you will yourself to cum anyway, blasting your load straight into [NameDesc of M]'s [LongHoleDesc of M]!";
		say AfterDominationComment 3 of M;
		ultraDignify;
		orgasm.

To say paywall demand of (M - a slutty sister) with (N - a slutty sister):
	let G be a random worn ballgag;
	say "[line break][speech style of N]'Alright, [NameBimbo]. That[']s about as far as [the number of worn humility-stone] humility stones gets you.'[roman type][line break][BigNameDesc of N] grabs you from behind, snapping [his of M] fingers as your [SexShaft] is literally 'paused' at the moment right before orgasm. You try to tap into the stones, but they're spent, leaving you at [NameDesc of M]'s mercy as [he of M] sits up and [if player-fuckchoice is FUCK-PENETRATION]squeezes your hips with [his of M] thighs.[otherwise]places [his of M] hands on your waist.[end if][line break][speech style of M][if the dominated-count of the player > 0]You probably know the deal by now. [otherwise]This is your first time, so allow us to explain. [end if]You won't get to cum unless you let us embarass you.[roman type][line break][speech style of N]'In this case, we expect you to [if G is clothing]watch us make out[otherwise if N is futanari-slutty-sister]suck my [DickDesc of N][otherwise]eat me out[end if] like a good slut.'[roman type][line break]Do you allow them to embarass you in exchange for a chance to cum? ".

To say AfterDominationComment (N - a number) of (M - a slutty sister):
	if N is 1:[agreed to lick]
		say "[speech style of M]'[one of]Mmm, just what I need to see, [NameBimbo].'[or]It feels good to cum like a proper bottom, doesn't it?'[or]Didn't it feel way better once we took over? Heehee, see you.'[at random][roman type][line break]";
	otherwise if N is 2:[refused to lick]
		if the number of worn ballgag > 0, say "[speech style of M]'I bet you were hoping we'd get rid of that pesky gag, huh?'[roman type][line break]";
		otherwise say "[speech style of M]'[one of]Tsk, you should have agreed to the head.'[or]Perhaps we bullied you too harshly...'[at random][roman type][line break]";
	otherwise if N is 3:[gathered all 6 stones]
		say "[speech style of M]'[one of]What?!'[or]It was inevitable?!'[at random][roman type][line break]".

Part 4 - Conversation

Section 1 - Greeting

To say FirstGreeting to (M - a slutty sister):
	say "[if the bimbo of the player < 10][first custom style][end if]";
	if the bimbo of the player < 5 and the player is gendered female:
		say "'Get out of my way you harpies, I'm getting the hell out of this game!'";
	otherwise if the bimbo of the player < 5:
		say "'Haha sweet! I KNEW I'd eventually get a chance to fuck one of you! [if M is futanari-slutty-sister]What's with that dick though?[otherwise]You're a lot fatter than I remember though.[end if]'";
	otherwise if the bimbo of the player < 10 and the player is gendered female:
		say "'Don't come any closer. I just want to press that button. [if M is futanari-slutty-sister]I-if I touch you on the way by, it's an accident.[otherwise]This game isn't fun at all. Honest.[end if]'";
	otherwise if the bimbo of the player < 10:
		say "'I am a guy and that means I can't let you fuck me! [if M is futanari-slutty-sister]It doesn't matter how your... uh... I'm going to push that button.[otherwise]I'm not going to rest until you're ready to let me push your buttons! Wait...[end if]'";
	otherwise if the bimbo of the player < 15:
		say "[variable custom style]'Really? All I have to do to leave this game is have a little sex? I guess that's fair, since I had so much fun playing.'";
	otherwise:
		say "[speech style of M]'Who cares about stopping! Let's have some fun!'";
	say "[roman type][line break]".

To say RepeatGreeting to (M - a slutty sister):
	if the bimbo of the player < 10:
		say "[first custom style]";
	if the bimbo of the player < 5 and the player is gendered female:
		say "'[one of]I'm back, and this time I'm going to kick both your asses.'[or]You're dreaming if you think you can turn me into some perverted weirdo.'[or]I'm gonna fight you for women everywhere, you won't turn me into a slut![at random]";
	otherwise if the bimbo of the player < 5:
		say "'[one of]Get out of my way. I don't want to fuck gross bitches.'[or]Get out of my way, I'm not really in the mood to get treated like a chick.'[or]Unless you're planning to get on your knees and [']apologise['] for trying to make me into some kind of [sissy slut], get out of my way.'[at random]";
	otherwise if the bimbo of the player < 10 and the player is gendered female:
		say "'[one of]Ugh, haven't we been through this already? You had your fun, now let me out!'[or]You're not going to turn me into a slut. Not if I can beat you first.'[or]I really don't want to keep fighting you. I just want to leave!'[or]This isn't fair! If you're going to turn me into a slut at least play by your own rules!'[at random]";
	otherwise if the bimbo of the player < 10:
		say "'[one of]OK, you proved I'm not much of a man anymore, but instead of rubbing it in, you could let me out of here instead.'[or]Listen. I want to fuck sluts, not become one! You put me in the wrong game!'[or]Let me out while I can still think straight!'[at random]";
	otherwise if the bimbo of the player < 15:
		say "[speech style of M]'[one of]This time I'll satisfy you for sure!'[or]I'll make you both cum eventually, then I'll be free!'[or]I'm pretty sure you're gonna get tired of fucking with me soon, then I'll be free to get out of here and suck some... freedom.'[at random]";
	otherwise:
		say "[speech style of M]'I'm ready for another round babe.'";
	say "[roman type][line break]".

To say DominantResponse of (M - a slutty sister):
	say "[speech style of M]'";
	if there is a slutty sister penetrating a fuckhole:
		say "Don't worry honey, you'll get to feel more of that later!'";
	otherwise:
		say "I have a feeling you're going to enjoy what happens next, honey.'";
	say "[roman type][line break]".

To say FirstResponse of (M - futanari-slutty-sister):
	if the bimbo of the player < 10:
		say "[speech style of M]'You're not touching that button until my cock slides out of your [asshole]!'[roman type][line break]";
	otherwise:
		say "[speech style of M]'That's the right idea! Get on your knees so we can get started!'[roman type][line break]".

To say FirstResponse of (M - bulging-slutty-sister):
	if the bimbo of the player < 10:
		say "[speech style of M]'I'm not letting you by until you have a thick, pearly mess all over your face!'[roman type][line break]";
	otherwise:
		say "[speech style of M]'Show me what fun stuff you learned testing our game!'[roman type][line break]".

To say RepeatResponse of (M - futanari-slutty-sister):
	if the bimbo of the player < 10:
		say "[speech style of M]'Push the button as much as you want, but I want another round first!'[roman type][line break]";
	otherwise:
		say "[speech style of M]'Get on your knees and show me what you're made of!'[roman type][line break]".

To say RepeatResponse of (M - bulging-slutty-sister):
	if the bimbo of the player < 10:
		say "[speech style of M]'You actually think you can win this game? Hmm, we'll have to be extra careful if we mess with your intelligence in the future.'[roman type][line break]";[You're really dumb if you think you can win this game]
	otherwise:
		say "[speech style of M]'The best thing about virtual cum is that you don't have to wait around for men to make more! Roll over, I'll demonstrate!'[roman type][line break]".

Part 5 - Trading

To decide which number is the bartering value of (T - a thing) for (M - a slutty sister):
	decide on 0.

To say MonsterOfferRejectFlav of (M - a slutty sister) to (T - a thing):
	say "[speech style of M]'This is a boss fight baby, there's no trading your way out of this one!'[roman type][line break]".

Slutty Sisters ends here.
