Students Nasty by Monster begins here.

A nasty student is a kind of student. Understand "mean" as a nasty student.

To say MediumDesc of (M - a nasty student):
	say "mean [rank-colour of item described] student [student-name of item described]".

To decide which number is the vindictiveness of (M - a nasty student): [We can use this for various calculations to check which students do what]
	decide on a random number between 2 and 4.

Part - Abbi

student-abbi is a tq-only nasty student.

The text-shortcut of student-abbi is "stab".

Figure of abbi is the file "NPCs/School/Student/student11.png".

To decide which figure-name is the monster-image of (M - student-abbi):
	decide on figure of abbi.

To say MonsterDesc of (M - student-abbi):
	say "This larger woman has light brown hair and is wearing a skimpy sexy schoolgirl outfit with matching tartan miniskirt and tie. [big his of M] giant J-cup breasts hang down in front of her like giant udders, her [if the current-rank of M > 2]sheer [end if]black top lewdly exposing 80% of [his of M] titty meat and hardly supporting the rest. [big he of M] doesn't look happy.".

The min-rank of student-abbi is 2.
The max-rank of student-abbi is 3.
The current-rank of student-abbi is 2.

To update name of (M - student-abbi):
	if the current-rank of M is 2:
		now the student-name of M is "Abriana";
		if weight gain fetish is 1, now the student-print of M is "chubby cowgirl";
		otherwise now the student-print of M is "curvy cowgirl";
	otherwise:
		now the student-name of M is "Abbi";
		if weight gain fetish is 1, now the student-print of M is "gluttonous moocow";
		otherwise now the student-print of M is "massive moocow".

To say FirstResponse of (M - student-abbi):
	say "[speech style of M]'Fuck off.'[roman type][line break]".

To say RepeatResponse of (M - student-abbi):
	say "[speech style of M]'What the fuck do you want?'[roman type][line break]".

To say StoryAnswer of (M - student-abbi):
	say "[speech style of M]'I made a bet with my boyfriend and lost, so I had to come here. I think you can tell what fetish he has.'[roman type][line break]".

To say WhereAnswer of (M - student-abbi):
	say "[speech style of M]'[if the rank of the player <= 1]Are you literally braindead?'[otherwise]Someone as stupid as you is going to have to guzzle a LOT of cum to make it anywhere in here.'[end if][roman type][line break]".

Part - Lucy

student-lucy is a nasty student.

The text-shortcut of student-lucy is "stlu".

Figure of lucy is the file "NPCs/School/Student/student12.png".

To decide which figure-name is the monster-image of (M - student-lucy):
	decide on figure of lucy.

To say MonsterDesc of (M - student-lucy):
	say "This tall blonde is wearing a tartan miniskirt and [if the current-rank of M is 3]slightly sheer [end if]crop top. Knee-high white cotton stockings sit snug under [his of M] neat black court shoes. [if the current-rank of M is 3 and diaper quest is 1]You think you can detect that [his of M] skirt is bulging slightly - you reckon [he of M] might be wearing a diaper now!  [end if][big he of M] looks down at you with a [if the current-rank of M is 1]furious[otherwise]mocking[end if] sneer.".

The max-rank of student-lucy is 3.
The current-rank of student-lucy is 2.

To update name of (M - student-lucy):
	if the current-rank of M is 1:
		now the student-name of M is "Lucinda";
		now the student-print of M is "basic bitch";
	otherwise if the current-rank of M is 2:
		now the student-name of M is "Lucy";
		now the student-print of M is "boisterous brat";
	otherwise:
		now the student-name of M is "Lucky";
		now the student-print of M is "feisty fiend".

To say WhoAnswer of (M - student-lucy):
	say "[speech style of M]'[if the current-rank of M is 1]Thanks to YOU, I have to be [student-name of M] again. I'll never forget what you did to me, you [bitch].'[otherwise]You can call me Queen [student-name of M][end if].'[roman type][line break]".

To say StoryAnswer of (M - student-lucy):
	say "[speech style of M]'I came here of my own volition. Someone has to show the rest of you tramps how to act right.'[roman type][line break]".

To say EscapeAnswer of (M - student-lucy):
	say "[speech style of M]'Aww, the wimpy little [bitch] wants to know the school's secrets. You don't deserve to know anything, tramp!'[roman type][line break]".

To say AdviceAnswer of (M - student-lucy):
	say "[speech style of M]'[if the current-rank of M is 1]Yeah. Watch your fucking back[otherwise]Nothing I could say would stop you from being a pathetic little worm[end if]!'[roman type][line break]".


Part - Katya

student-katya is a tq-only nasty student.
[Katya is a real bitch from rank 1 - 3 and then suddenly turns into a submissive doll at rank 4.]
[TODO: her ruby promotion scene can involve her breaking from brat into Stepford wife]

The text-shortcut of student-katya is "stka".

Figure of katherine is the file "NPCs/School/Student/student13a.png".
Figure of kat is the file "NPCs/School/Student/student13b.png".
Figure of katya is the file "NPCs/School/Student/student13c.png".
Figure of kitty is the file "NPCs/School/Student/student13d.png".
Figure of cuntwarmer is the file "NPCs/School/Student/student13e.png".

To decide which figure-name is the monster-image of (M - student-katya):
	if the current-rank of M is 1:
		decide on figure of katherine;
	otherwise if the current-rank of M is 2:
		decide on figure of kat;
	otherwise if the current-rank of M is 3:
		decide on figure of katya;
	otherwise if the current-rank of M is 4:
		decide on figure of kitty;
	otherwise:
		decide on figure of cuntwarmer.

To say MonsterDesc of (M - student-katya):
	say "This platinum blonde woman has the perfect bimbo body shape[if the current-rank of M > 2 and artificial enhancements fetish is 1] including visibly silicone-enhanced fuckballs and a flawless nose job[end if], and [he of M] seems very comfortable in [his of M] own skin. [if the current-rank of M < 4][big his of M] face doesn't match [his of M] fuckdoll body though - [he of M] looks rather rebellious and level-headed, not the vacant sex-addled look you might expect[otherwise][big his of M] face now displays a much more vacant expression - one of submission and humility[end if]. [if the current-rank of M is 1]A white schoolgirl blouse tightly stretches over [his of M] seemingly spherical C-cup tits, and [his of M] pink tartan miniskirt is so short you can see a peek of [his of M] skimpy panties when you're on your knees. [big he of M] stands impeccably balanced on [his of M] tall black stiletto heels as if [he of M] was born in them[otherwise if the current-rank of M is 2][big his of M] long-sleeved white leather jacket is fully unbuttoned, exposing her tartan patterned bra and round C-cup fuckballs. Her tiny white microshorts hug her figure so tightly they almost look like they're painted on[otherwise if the current-rank of M is 3][big he of M][']s wearing nothing except a pair of purple low-rise silk briefs and matching half-cup bra which leaves most of her D-cup titty flesh on display[otherwise if the current-rank of M is 4][big he of M][']s [one of]now [or][stopping]wearing a frilly red and white shouldered front-tie crop top over [his of M] D-cup tits which is so skimpy it might as well be a bra. It matches [his of M] silk microskirt which is so short you think you can spy the bottom of [his of M] pussy even when [he of M][']s standing up. [big he of M] keeps a finger and thumb holding the front of it at all times, as if [he of M] must make sure that [he of M][']s ready to pull it up at a moment's notice[otherwise][big he of M] is completely naked and has a completely vacant expression - it looks like [he of M][']s struggling to think clearly[end if].".

The max-rank of student-katya is 4.

To update name of (M - student-katya):
	if the current-rank of M is 1:
		now the student-name of M is "Katherine";
		now the student-print of M is "defiant diva";
	otherwise if the current-rank of M is 2:
		now the student-name of M is "Kat";
		now the student-print of M is "smug sister";
	otherwise if the current-rank of M is 3:
		now the student-name of M is "Katya";
		now the student-print of M is "contemptuous cunt";
	otherwise if the current-rank of M is 4:
		now the student-name of M is "Kitty";
		now the student-print of M is "domesticated doll";
		now the text-shortcut of M is "stki";
	otherwise:
		now the student-name of M is "Cuntwarmer";
		now the student-print of M is "brainless bimbo";
		now the text-shortcut of M is "stcu";
	if the current-rank of M < 4, now the text-shortcut of M is "stka".

[Once katya is "domesticated," she no longer tries to bully you]
To compute appearance assessment of (M - student-katya):
	if the current-rank of M < 4:
		if diaper quest is 1, compute dq bullying of M;
		otherwise compute tq bullying of M;
	otherwise:
		say "[big he of M] makes a face like [he of M]'s planning to do something to you, but seems to think better of it.";

To say FirstResponse of (M - student-katya):
	say "[if the current-rank of M < 4][big he of M] looks at you with pure disgust in [his of M] eyes.[line break][speech style of M]'Do I look like I want to talk to you?'[roman type][line break][otherwise if the current-rank of M is 4][big he of M] crosses [his of M] legs and curtseys politely.[line break][speech style of M]'Thank you for gracing me with your presence. Would you like me to present my [cunt] for inspection?'[roman type][line break]Before you can reply [he of M] has lifted up [his of M] microskirt and is spreading [his of M] shaved pussy with both hands.[line break][speech style of M]'My job is to keep this hole hot and ready at all times. [big please] watch me as I check its lubrication.'[roman type][line break][big he of M] shoves two fingers inside herself and begins to pump, until it seems like [he of M] might have forgotten you're even there![otherwise][line break][speech style of M]'Ooh, a friend! [big please], do you know where I can find more cock?  I feel so empty and sad when there's no cock inside of me!'[roman type][line break][end if]".

To say WhoAnswer of (M - student-katya):
	say "[speech style of M]'[if the current-rank of M < 4]You are to address me as ['][student-name of M]['], should I allow you to talk to me[otherwise]My name is ['][student-name of M]['] because the only important thing about me is my [cunt][end if].'[roman type][line break]".

To say WhereAnswer of (M - student-katya):
	if the rank of the player is 1, say "[speech style of M]'[if the current-rank of M < 4]We're in a pathetic excuse for an institution that tries to turn people from dominant divas into worthless whimpering worms. But only if you're so weak that you can't resist their techniques[otherwise]It would take a very weird set of events for me to be a domesticated fuckdoll but for you to be rank one. How unusual. I, err, I mean, welcome to my favourite place, Slut School[end if].'[roman type][line break]";
	otherwise say "[speech style of M]'[if the current-rank of M < 4]You've got to make it seem like you're falling for their tricks. But if you're not an idiot, you'll only be pretending[otherwise]Submit to the cock. Worship the cock. Serve the cock. And then if you're lucky, the school will reward you with more cock[end if].'[roman type][line break]".

To say EscapeAnswer of (M - student-katya):
	if the current-rank of M > the rank of the player, say "[speech style of M]'[if the current-rank of M < 4]Why would I discuss such things with a useless twerp like you?'[otherwise]There's loads of great new places where you can serve big yummy [manly-penis]. I can't wait until you can join me!'[end if][roman type][line break]";
	otherwise say "[speech style of M]'[if the current-rank of M < 4]I don't know yet, but I plan to be the first sane person here to find out[otherwise]I'm hoping there's even bigger and juicier [manly-penis]s to serve[end if].'[roman type][line break]".

To say AdviceAnswer of (M - student-katya):
	say "[speech style of M]'[if the current-rank of M < 4]Stay out of my way or you'll live to regret it[otherwise if the current-rank of M is 4]Open your eyes and realise that becoming a living breathing human cock sleeve is so much easier and more fulfilling than trying to think for yourself. And then do what I'm doing, and open your [cunt] as well, so the next thick juicy [manly-penis] can impale you more speedily[otherwise]It's important to stay alive, because otherwise your [cunt] won't be warm any more. And then men wouldn't be able to use it whenever they want. And that would be awful!  Except that it might mean more [manly-penis]s for me, I guess[end if].'[roman type][line break]".

To say StoryAnswer of (M - student-katya):
	say "[speech style of M]'[if the current-rank of M < 4]My pathetic husband thought that just because I'm as hot as a supermodel I would let him walk all over me. Imagine his disappointment when he found out I'd rather just spend his money and socialise at parties than waste all my days at home cooking and cleaning and sucking his tiny dick!  He thinks that by sending me here he can get me to 'learn my place' and become his little housewife and the perfect little subservient fucktoy for him and his friends. But I'm going to use this as an opportunity to crush his spirit further - by proving I can have the body of a Goddess and the sex life of a horny spinster, but still wear the trousers in my marriage and order him around like the worthless dog he is[otherwise if the current-rank of M is 4]My husband sent me here to learn to how to be a proper fuckdoll for anyone who wishes to use me. I'm so lucky to be blessed with the privilege of serving his majestic cock whenever he desires. I must make sure to masturbate every few minutes to keep my pathetic [cunt] hot and wet at all times. Who knows when the next person will want to use me?  A good cock sleeve must be permanently available for instant use[otherwise]My husband is the best!  He must be coming to collect me soon. I can't wait until I can fill myself with his glorious [manly-penis], it's been so long!  I'm hoping he'll bring his best friends so they can use me whenever they want, too!  Ooh and maybe he'll take me to the factory he owns so I can serve the hundreds of cocks there whenever they go on break!  It'll all be okay again once I'm stuffed to the brim with [manly-penis][end if].'[roman type][line break]".

To compute teaching of (M - student-katya):
	say "[speech style of M]'[if the current-rank of M < 4]I could, if I chose to associate with people this far beneath me[otherwise if the current-rank of M is 4]No, sorry. You have to learn who's in charge the hard way to truly understand your place[otherwise]Let me teach you how to be a perfect [cunt]-warmer. Step one: Have a [cunt]. Step two: Keep it full of [manly-penis] as much as possible. That's it, I've taught you all I know[end if].'[roman type][line break]".

To compute friendly drink of (M - student-katya):
	say "[speech style of M]'[if the current-rank of M < 4]Do I look like a fucking vending machine to you?'[otherwise]I'm sorry, but the only [tasty] thing I drink nowadays is dick juice. And if you want your own, you'll have to use those lips of yours to earn it yourself!'[end if][roman type][line break]".


Part - Darla

student-darla is a tq-only nasty student.

The text-shortcut of student-darla is "stda".

Figure of darla is the file "NPCs/School/Student/student14.png".

To decide which figure-name is the monster-image of (M - student-darla):
	decide on figure of darla.

To say MonsterDesc of (M - student-darla):
	say "This tall babe looks like the pinnacle of traditional western beauty. [big his of M] perfect skinny body is covered only by a lovely pink negligee with criss-crossing straps down the front which leave most of [his of M] toned belly and C-cup breasts on show. [big he of M] is holding up [his of M] thick flowing locks of golden hair and looking at you with meanness in [his of M] eyes.".

The min-rank of student-darla is 2.
The max-rank of student-darla is 3.
The current-rank of student-darla is 2.

To update name of (M - student-darla):
	if the current-rank of M is 2:
		now the student-name of M is "Darla";
		now the student-print of M is "glamorous goddess";
	otherwise:
		now the student-name of M is "Darling";
		now the student-print of M is "dazzling diva".

To say StoryAnswer of (M - student-darla):
	say "[speech style of M]'I've come here to prove once and for all I am the perfect woman. I shall pass every test with flying colours and rise in the ranks faster than anyone ever has before[if the rank of the player < 4]. Whereas I imagine someone as pathetic as you will take quite some time - assuming you ever manage to rise the ranks at all[otherwise if the rank of the player > the current-rank of M]. Don't think I'll let you rub your rank in my face for long, you slutty bitch[end if]!'[roman type][line break]".


Part - Belinda

student-belinda is a tq-only nasty student.
student-belinda is in School14. [TODO: remove]

The text-shortcut of student-belinda is "stbe".

Figure of belinda is the file "NPCs/School/Student/student15a.png".
Figure of belle is the file "NPCs/School/Student/student15b.png".

To decide which figure-name is the monster-image of (M - student-belinda):
	if the current-rank of M is 1, decide on figure of belinda;
	otherwise decide on figure of belle.

To say MonsterDesc of (M - student-belinda):
	say "This skinny woman has blonde pigtails and an unfriendly frown. [big he of M] is wearing a tight purple belly-exposing latex top with a cleavage window and purple latex pants[if the current-rank of M > 1]. [big he of M] has a tattoo that reads 'Daddy's Girl' on her left arm, and you could swear her top is a little more translucent than before[end if].".

The max-rank of student-belinda is 2.

To update name of (M - student-belinda):
	if the current-rank of M is 1:
		now the student-name of M is "Belinda";
		now the student-print of M is "rubber rebel";
	otherwise:
		now the student-name of M is "Belle";
		now the student-print of M is "lil monster".

To say StoryAnswer of (M - student-belinda):
	say "[speech style of M]'My boyfriend wants me to call him 'Daddy' [if the current-rank of M is 1]but I'm not too sure. Apparently this place is going to convince me it's fun to act like a bratty girl. We'll see...'[otherwise]and I'm training to be his bratty babygirl. I think I've got the attitude for this role already, hah!'[end if][roman type][line break]".


Part - Hiroko

student-hiroko is a tq-only nasty student.

The text-shortcut of student-hiroko is "sthi".

Figure of hiroko is the file "NPCs/School/Student/student25.png".

To decide which figure-name is the monster-image of (M - student-hiroko):
	decide on figure of hiroko.

To say MonsterDesc of (M - student-hiroko):
	say "This beautiful Asian woman is wearing nothing but an outfit made out of thin black straps that cover absolutely nothing but [his of M] pussy - [his of M] breasts are on full display. [big he of M] looks at you with unconcealed disgust.".

The current-rank of student-hiroko is 3.
The max-rank of student-hiroko is 5.

To update name of (M - student-hiroko):
	if the current-rank of M is 3:
		now the student-name of M is "Hiroko";
		now the student-print of M is "heavenly hostess";
	otherwise:
		now the student-name of M is "Hostess-sama";
		now the student-print of M is "heavenly harlot".

To say WhoAnswer of (M - student-hiroko):
	say "[speech style of M]'I'm the Queen Bee of these parts, bitch. Ugly worms like you aren't going to get very far while there are people like me around.'[roman type][line break]".

To say WhereAnswer of (M - student-hiroko):
	say "[speech style of M]'[if the rank of the player <= 1]A place where ugly bitches like you get turned into cute girls like me.'[otherwise]It's simple, you get promoted by being the hottest, most attractive woman here. Which means that you have no chance, haha.'[end if][roman type][line break]".

To say EscapeAnswer of (M - student-hiroko):
	say "[speech style of M]'[if the current-rank of M > the rank of the player]There's a photo of you underneath the words [']NEVER GONNA MAKE IT HERE['] that we like to laugh at as we walk past!'[otherwise]I've heard there's a photo of me on the wall that people like to look at for inspiration.'[end if][roman type][line break]".

To say StoryAnswer of (M - student-hiroko):
	say "[speech style of M]'There's nobody out there who can look as perfect as me. I've come here to prove that [if the current-rank of M > 3]nobody can worship a [manly-penis] like I can[otherwise]compared to me you are all disgusting sluts with no class[end if].'[roman type][line break]".

To say AdviceAnswer of (M - student-hiroko):
	say "[speech style of M]'Give up while you still have a shred of dignity remaining. It won't last long.'[roman type][line break]".

To compute teaching of (M - student-hiroko):
	say "[speech style of M]'You can't teach looks. You're always going to be ugly, too bad.'[roman type][line break]".


Part - Default Conversation

To compute nonstudent perception of (M - a nasty student):
	say "[speech style of M]'Your days are numbered if you keep walking around here with no armband.'[roman type][line break][Big he of M] walks away!";
	now the scared of M is 50.

[The nasty student has the protection function of a normal monster.]
To compute (M - a nasty student) protecting against (X - a monster):
	compute default protecting of M.


[If the player looks easy to mess with, nasty students will try to bully you.]
To compute student perception of (M - a nasty student):
	if the delicateness of the player <= (10 + the charisma of the player) or diaper quest is 1:[there's no dq bullying implemented yet, so it doesn't happen in dq]
		say "[one of]It doesn't look like [he of M] is going to engage you in conversation unless you start it.[or][stopping]";
	otherwise:
		compute appearance assessment of M.[calls the bullying rule]

[Appearance assessment triggers the "bullying rule," which is also the nasty student's punishment rule]
To compute appearance assessment of (M - a nasty student):
	follow the bullying rule.


To say FirstTimeBullyDemandFlav of (M - a nasty student):
	say "[speech style of M]'[one of]It's not your lucky day today. Get on your knees, [bitch].'[or]Guess what? I'll go easy on you if you get on your knees right now.'[or]You look pretty fun to mess with. Get on your knees.'[at random][roman type][line break]".

To say FirstTimeBullyFlav of (M - a nasty student):
	say "[speech style of M]'[one of]It's not your lucky day, [bitch].'[or]You look pretty fun to mess with. I wonder if you'll even fight back.'[at random][roman type][line break]".

To say RepeatBullyDemandFlav of (M - a nasty student):
	say "[speech style of M]'[one of]Well, well, well, look who it is. Get on your knees, [bitch].'[or]How dare you STAND in my presence? Get on your knees, worm!'[or]I'm sorry, did I give you permission to be on your feet in my presence? Get on the ground, now!'[at random][roman type][line break]".

To say RepeatBullyFlav of (M - a nasty student):
	say "[speech style of M]'[one of]Well, well, well, look who it is. My favourite footrest.'[or]Oops! I bet you weren't hoping to run into me today, huh?'[or]Oh, what perfect timing!'[at random][roman type][line break]".

To say FirstResponse of (M - a nasty student):
	say "[big he of M] narrows [his of M] eyes.[line break][speech style of M]'What the fuck do you want?'[roman type][line break]".

To say RepeatResponse of (M - a nasty student):
	say FirstResponse of M.

To say WhoAnswer of (M - a nasty student):
	say "[speech style of M]'Can't you fucking read my armband?  The name's [student-name of M]. For now.'[roman type][line break]".

To say WhereAnswer of (M - a nasty student):
	say "[speech style of M]'[if the rank of the player <= 1]A place where ugly bitches like you get turned into cute girls like me.'[otherwise]Are you asking for ways to cheat?  You're a real piece of work, aren't you?'[end if][roman type][line break]".

To say EscapeAnswer of (M - a nasty student):
	say "[speech style of M]'[if the current-rank of M > the rank of the player]Hah, if you want to know you have to earn the privilege!'[otherwise]Even if I knew, I wouldn't tell you.'[end if][roman type][line break]".

To say AdviceAnswer of (M - a nasty student):
	say "[speech style of M]'Quit now before you end up in the School Dungeon.'[roman type][line break]".

To compute teaching of (M - a nasty student):
	say "[speech style of M]'Why would I? I don't owe you anything.'[roman type][line break]".

To compute friendly drink of (M - a nasty student):
	say "[speech style of M]'Do I look like I'm in the mood to help you out?!'[roman type][line break]".

To say detention chair tease of (M - a nasty student):
	say "[speech style of M]'[one of]Bahahah, you really are the worst, aren't you?'[or]You should just give up, you know. Someone like you is never going to make it in a place like this.'[or]Nyer nyer, look at the loser on her punishment chair. Enjoying yourself, [bitch]?'[in random order][roman type][line break]".

Students Nasty ends here.

