Supporters by Monster begins here.

Part - Ai

supporter-ai is a supporter. supporter-ai is female. The leftover-type of supporter-ai is 202.

The supporter-name of supporter-ai is "Ai".

To say MonsterDesc of (M - supporter-ai):
	say "This [man of M] looks like the epitome of a blonde bimbo. [big he of M]'s completely naked, [if lady fetish is 2]aside from a neon-pink chastity cage around [his of M] [sissy-penis][otherwise][his of M] giant M-cup tits somehow not sagging as much as they should, either thanks to implants or magic[end if]. [big his of M] huge, visibly enhanced cock-suckling lips are coloured a deep shade of pink and two hoops with hears in the centre hang from [his of M] earlobes. [big his of M] medium length blonde hair is kept in a ponytail by a tight pink scrunchie.".

Figure of Ai is the file "NPCs/MultiFloor/Supporter/aika1.png".

To decide which figure-name is the monster-image of (M - supporter-ai):
	decide on figure of Ai.

To say ChestDesc of (M - supporter-ai):
	if lady fetish is 2, say "pecs";
	otherwise say "boobs".

To say LeftoverDesc (N - 202):
	say "The bloated, cumfilled and unconscious body of Ai is on the ground here.[line break]".

To say BoringPerception of (M - supporter-ai):
	say "[speech style of M]'[one of]Another player, huh? Sorry but I have no interest in banging someone who looks so basic[or]You again. Sorry, but I'm not looking for people who aren't at least half as hot as me[stopping].'[roman type][line break]".

To say DisapprovalFlav of (M - supporter-ai):
	say "[BigNameDesc of M] [one of]shivers with arousal.[or]moves a hand down to delicately touch [his of M] [if lady fetish is 2]caged [sissy-penis][otherwise]clit[end if].[or]licks [his of M] lips seductively[in random order][line break][speech style of M]'Keep that up, and [one of]you might like what happens next[or]I might decide that you're worth my time[at random].'[roman type][line break]".

To say UnidentifiablePosterReactionFlav of (M - supporter-ai):
	say "[speech style of M]'Not bad, not bad at all! This babe is almost as hot as me.'[roman type][line break]".

To say MonsterTripAnnounceFlav of (M - supporter-ai):
	say "[BigNameDesc of M] pushes [his of M] giant [ChestDesc of M] together and moves them towards your face as if to let you motorboat them, but it was just a distraction! At the last moment [he of M] lets fly with an attempted kick at your [feet]!".

To say DamageReactHealthy of (M - supporter-ai):
	say "[BigNameDesc of M] giggles condescendingly.[line break][speech style of M]'[one of]Aww, how cute[or]That was adorable[or]You should probably quit while you're ahead[in random order].'[roman type][line break]".

To say DamageReactDamaged of (M - supporter-ai):
	if lady fetish is 2, say "[BigNameDesc of M][']s body takes the blow!";
	otherwise say "[BigNameDesc of M][']s [one of]giant boobs bounce wildly from the impact, with inhuman physics[or]body takes the blow, [his of M] big breasts acting like airbags[or]giant tits cushion the vast majority of the hit[in random order]!".

To say DamageReactTired of (M - supporter-ai):
	say "[BigNameDesc of M] [one of]takes the hit to the belly, causing [him of M] to bend over in pain[or]tries to twirl to dodge but ends up taking a painful hit to the buttocks[or]blocks with [his of M] arms but still recoils with pain[in random order].".

To say DamageReactWeak of (M - supporter-ai):
	say "[BigNameDesc of M] [one of]squeaks as [his of M] [ChestDesc of M] take another hit and become even more sore[or]shakes at the knees as they threaten to give out from under [his of M][or]is knocked off balance and very nearly falls over[in random order].".

To say BanishFleeFlav of (M - supporter-ai):
	say "[speech style of M]'Nooo, my perfect body, how could it lose?!'[roman type][line break][BigNameDesc of M] asks out loud as [his of M] body begins to disintegrate into blue pixels. Moments later [he of M] has completely disappeared.".

To say SelectionFrustrated of (M - supporter-ai):
	say "[BigNameDesc of M] looks at [his of M] wrist as if [he of M] was wearing a watch, yawns loudly and visibly loses interest.";
	bore M.

To say PresentFriendlyAcceptanceFlav of (M - supporter-ai):
	say "[speech style of M]'It's your lucky day. Since you asked so nicely, I'll allow it, this time.'[roman type][line break]".

To compute the default taunting of (M - supporter-ai):
	say "[BigNameDesc of M] watches, [one of]gently touching [himself of M] downstairs as [he of M] does[or]moving one hand to [his of M] breast as the other circles [his of M] [if lady fetish is 2]cage[otherwise]clit[end if][or]pushing two fingers inside [himself of M] and tweaking one nipple[or][if lady fetish is 2]teasing [himself of M] through [his of M] cage[otherwise]fingering [himself of M] rapidly[end if] as [he of M] moves [his of M] other hand to play with the entrance to [his of M] asshole[or]pushing three fingers each into [his of M] [if lady fetish is 2]asshole[otherwise]pussy and asshole[end if] before bringing them up to [his of M] mouth to lick them all clean[then at random].".

Part - Aika

supporter-aika is a supporter. The leftover-type of supporter-aika is 203.

Definition: supporter-aika is presenting as male if lady fetish is 2.

Definition: supporter-aika is father material: decide yes.

To say MonsterDesc of (M - supporter-aika):
	say "A terrifying blonde [man of M] stands before you. [big he of M]'s wearing medieval metal bracers on [his of M] arms and legs, and wields a barbaric-looking shortsword[if lady fetish < 2]. [big his of M] huge H-cup breasts are completely bare and sit heavily on [his of M] chest, hanging away from each other in a way that lets you know they're almost certainly natural[end if]. [big his of M] tiny grey loincloth does nothing to hide the [LongDickDesc of M] and balls hanging from [his of M] crotch, swaying gently as [he of M] moves. A metal warlord's mask covers [his of M] face, preventing you from seeing [his of M] features or expression.".

Figure of Aika is the file "NPCs/MultiFloor/Supporter/aika2.png".

The supporter-name of supporter-aika is "Aika".

To decide which figure-name is the monster-image of (M - supporter-aika):
	decide on figure of Aika.

To say LeftoverDesc (N - 203):
	say "The bloated, cumfilled and unconscious body of Aika is on the ground here, cum still leaking out of [his of supporter-aika] mouth, asshole, and [LongDickDesc of supporter-aika].[line break]".

To set up (M - supporter-aika):
	reset M;
	now the monstersetup of M is 1;
	now the raw difficulty of M is 12;
	now the health of M is the maxhealth of M.

To decide which number is the girth of (M - supporter-aika):
	decide on 8.

To set up sex length of (M - supporter-aika) in (B - face):
	set up sex length 4 of M in B.

To set up sex length of (M - supporter-aika) in (B - breasts):
	set up sex length 4 of M in B.

To set up sex length of (M - supporter-aika) in (B - a body part):
	set up sex length 4 of M in B.

To compute post climax effect of (M - supporter-aika) in (F - a fuckhole):
	compute M sleeping 400 after sex;
	bore M.

To say DisapprovalFlav of (M - supporter-aika):
	say "[BigNameDesc of M][']s [LongDickDesc of M] [one of]begins to stiffen.[or]visibly twitches.[or]visibly shudders as it slightly hardens.[or]drools a worryingly huge amount of precum onto the floor.[in random order]".

To say CurtseyReactionFlav of (M - supporter-aika):
	let K be a random worn currently visible knickers;
	say "[BigNameDesc of M] folds [his of M] arms in satisfaction.[line break][speech style of M]'[if K is nothing]I guess that means you've met Bianca[otherwise]Nice [ShortDesc of K][end if].'[roman type][line break]".

To say BecomesAggressive of (M - supporter-aika):
	say "[speech style of M]'You know I wasn't planning on doing anything but watching, but I forgot how hot it is to watch a silly [if the player is male]boy[otherwise]girl[end if] like you become more and more of a desperate whore. I don't think I could forgive myself if I didn't sample you at least once myself!'[roman type][line break][big he of M] twirls [his of M] shortsword in [his of M] hand and begins stroking [his of M] [DickDesc of M] with the other!".

To say AlreadyUnfriendlyPerception of (M - supporter-aika):
	say "[speech style of M]'[one of]You still haven't finished playing? Well then, I guess that means you want more from me too!'[or]I'm surprised you're still going, [NameBimbo]! Not that I'm complaining that I can get another fuck out of you first.'[or]You're back for more are you? I guess I didn't leave enough of an impression last time, then!'[in random order][roman type][line break]".

to say FriendlySluttyPerception of (M - supporter-aika):
	say "[speech style of M]'[one of]Oh my, don't you look tragic. Why do I find that so hot?'[or]Dammit you look so fuckable right now! I have to keep reminding myself, don't fuck the customers... don't fuck the customers...'[or]You look like the perfect submissive fuckpuppet right now. I wonder if I'll get in trouble with the shareholders if I decide to give you a ride on this bad boy down here...'[in random order][roman type][line break]".

To say UnfriendlySluttyPerception of (M - supporter-aika):
	say "[speech style of M]'[one of]Okay sorry, I've seen that ass waltzing in front of me one too many times. Nobody can blame me for this.'[or]Argh, this is too much! I don't care what company policy says, there's no way I can stand watching you like this without getting in on the action myself. I'm going for it!'[in random order][roman type][line break]".

To say BoringPerception of (M - supporter-aika):
	say "[speech style of M]'[one of]How are you enjoying the game, challenger? [big please]d to meet you, I'm the original creator. I drop in here every now and then to check up on how things are looking, and to enjoy the sights. I'm going to stay out of your way though, it's not my place to interrupt your play-through[or]Hey. Sorry, but really we shouldn't talk, it would be unfair for me to have an impact upon your game experience[stopping].'[roman type][line break]".

To say IdentifiablePosterReactionFlav of (M - supporter-aika):
	say "[BigNameDesc of M] takes a good long look at the poster.[line break][speech style of M]'This one is you, right? Outstanding. I hope you like it - I put a lot of work into designing these camera traps.'[roman type][line break]".

To say UnidentifiablePosterReactionFlav of (M - supporter-aika):
	say "[speech style of M]'Oh ho ho, I wonder if this might be you? Don't worry, I can keep a secret!'[roman type][line break]".

To say PresentFriendlyAcceptanceFlav of (M - supporter-aika):
	say "[speech style of M]'I really shouldn't... but now can I say no when you put it like that?'[roman type][line break]".

To compute delay of (M - supporter-aika):
	say "[BigNameDesc of M] folds [his of M] arms.[line break][speech style of M]'Any requests, or are you going to leave it completely up to me where I put this thing?'[roman type][line break]".

To say PresentRejectionFlav of (M - supporter-aika):
	say "[BigNameDesc of M] taps [his of M] mask as if thinking hard.[line break][speech style of M]'Haha, as if I actually care about what you want. I'm just thinking, what do I want myself?'[roman type][line break]".

To compute the default taunting of (M - supporter-aika):
	say "[BigNameDesc of M] watches while gently stroking [his of M] long shaft.".

To say SelectionFrustrated of (M - supporter-aika):
	say "[speech style of M]'Actually, I think your situation is hilariously awful enough without me needing to join in right now.'[roman type][line break][BigNameDesc of M] gives up waiting and leaves you alone.";
	bore M.

To compute the dildo stuck taunting of (M - supporter-aika):
	if a random number between 1 and 3 is 1, say "[BigNameDesc of M] puts [his of M] hand to [his of M] chin as if admiring an art exhibit.[line break][speech style of M]'[one of]This was the first trap I ever designed, but it still works so elegantly[or]A spring-loaded dildo trap. Whatever will I think of next[or]These traps were really hard to balance, but I think they're in a good place right now in the meta[in random order].'[roman type][line break]".

To say angry punishment insult of (M - supporter-aika):
	say "[speech style of M]'Really? You're going to be like that? You do realise I'm just going to make your life even more difficult now, right?'[roman type][line break]".

To say MonsterTripAnnounceFlav of (M - supporter-aika):
	say "With a flick of [his of M] hips, [NameDesc of M] shoots a thick string of cum at your [feet] with incredible speed! It wraps around your ankles like a rope and threatens to take you off balance before it drips to the ground.";
	let H be a random worn shoes;
	if H is clothing, CumSoak 3 on H;
	otherwise SemenPuddleUp 3.

To say StrikingSuccessFlav of (M - supporter-aika) on (B - a body part):
	say "[BigNameDesc of M] points [his of M] sword at you and a bolt of lightning hits you [TargetName of B]! The shock shoots through your whole body!".

To say StrikingSuccessFlav of (M - supporter-aika) on (B - face):
	say "[BigNameDesc of M] suddenly disappears.[line break][speech style of M]'Behind you[one of][or] again[stopping].'[roman type][line break]You turn around just in time to see [him of M] coming flying through the air towards you from above, and as [he of M] reaches you [he of M] swings [his of M] hips so [his of M] massive, heavy [DickDesc of M] clubs you right in the face! That's going to leave a lasting bruise on both your cheek and your dignity.".

To say StrikingFailureFlav of (M - supporter-aika) on (B - a body part): [TargetName of B outputs something beginning with "on the", e.g. "on the ass"]
	say "[BigNameDesc of M] points [his of M] sword at you and a bolt of lightning whizzes past your [B] as you try to make sure you stay a moving target!".

To say MindingOwnBusinessCombatFlav of (M - supporter-aika):
	say "[big he of M] turns to face you properly and brushes the dust of each shoulder.[line break][speech style of M]'I wonder, do you really think you can beat me, or are you just that eager to find out what it's like to have this bad boy inside of you?'[roman type][line break][BigNameDesc of M] gestures to [his of M] [LongDickDesc of M].".

To say RudeAwakeningFlav of (M - supporter-aika):
	say "[big he of M] wakes up, yawns and gets to [his of M] feet, toying with [his of M] shortsword (and [his of M] longer [']sword[']) as [he of M] speaks.[line break][speech style of M]'I was having the most excellent dream. But if you really want me to break you in even more, who am I to refuse?'[roman type][line break]".

To say DamageReactHealthy of (M - supporter-aika):
	say "[BigNameDesc of M] hums merrily to [himself of M] as [he of M] fights.".

To say DamageReactDamaged of (M - supporter-aika):
	say "[BigNameDesc of M] doesn't react at all, giving away absolutely nothing about how much [he of M] felt that.".

To say DamageReactTired of (M - supporter-aika):
	say "[BigNameDesc of M] [one of]makes an encouraging sound, as if [he of M]'s impressed with your moves[or]takes a step back and rubs the spot [he of M] got hit with [his of M] off hand[at random].".

To say DamageReactWeak of (M - supporter-aika):
	say "[BigNameDesc of M] [one of]makes a confused, almost frustrated sound[or]makes a surprised sound, and it almost sounds like [he of M]'s actually in pain[or]wipes some sweat away from [his of M] forehead behind [his of M] mask[in random order].".

To say MovementBlock of (M - supporter-aika):
	say "With a flick of [his of M] shortsword, [NameDesc of M] creates a momentary wall of electricity in front of you[one of], forcing you to stop moving for a moment and lose your momentum[or][or][or][cycling]!".

To say StandingBlock of (M - supporter-aika):
	say "[BigNameDesc of M] places a boot on top of your head and stops you from standing up!".

To say BanishFleeFlav of (M - supporter-aika):
	say "[speech style of M]'Interesting, I didn't realise we had such a skilled player in the game right now. I clearly should have chosen to spawn with even higher stats...'[roman type][line break]Those are [NameDesc of M][']s final words before [he of M] slowly disappears as if teleported away.".

To compute (M - a monster) stomping (N - supporter-aika): [For when the minotaur, xavier etc. encounters our NPC]
	if N is in the location of the player, say "[BigNameDesc of M] picks [NameDesc of N] off of the ground with two mighty hands. [BigNameDesc of N] laughs with what sounds like vindictive sadism.[line break][speech style of N]'You're going to get to see my secret special move now. Watch this.'[roman type][line break][big he of N] kicks [his of N] legs out wide, but nothing seems to happen. [big he of N] tries again, and again nothing happens. [big he of N] speaks again, this time sounding much more panicked.[line break][speech style of N]'Oh SHIT I forgot, [NameDesc of M] [speech style of N]is using the instant-win routine reserved for when another player is in the same room. Fuck fuck shit fuck-'[roman type][line break][BigNameDesc of N][']s swearing quickly turns to incomprehensible gargling as [he of N] is impaled on [NameDesc of M][']s giant [DickDesc of M]. [BigNameDesc of N] is flailing all of [his of N] limbs in a wild erratic manner but there's absolutely nothing either of you can do before [NameDesc of M] is already climaxing, pumping gallons of [semen] into [NameDesc of N][']s rapidly swelling belly. Before [he of M] has finished, [NameDesc of N] appears to experience a body-rocking orgasm of [his of N] own, [his of M] [LongDickDesc of N] erupting in a fountain of [semen] which jets straight into [his of N] own face, blinding and threatening to suffocate [him of N]. As [NameDesc of N] inevitably passes out from the experience, [NameDesc of M] peels [NameDesc of N][']s body off of [his of M] [LongDickDesc of M] like a used condom and discards it on the ground, before turning to you, with a still-burning sexual hunger in [his of M] eyes.";
	otherwise say "You hear[line break][speech style of N]'Admin override! Admin override! Passcode 2-Sierra-Lima-Oscar-WAAAAAH! FUCK!'[roman type][line break]coming from [if N is nearby]nearby![otherwise]somewhere in the region![end if]";
	destroy N;
	let L be a random off-stage leftover;
	now L is in the location of M;
	now the leftover-type of L is the leftover-type of N.

To say MonsterOfferRejectFlav of (M - supporter-aika) to (T - a thing):
	say "[BigNameDesc of M] refuses.[line break][speech style of M]'If I want any particular item, I just use debug commands.'[roman type][line break]".

To compute sudden objectification of (M - supporter-aika):
	say "Something seems to change in the way [NameDesc of M] is looking at you.[line break][speech style of M]'[if M is penetrating a body part]I'm saving a screenshot of this image for my wank bank later...'[otherwise if the player is monster fucked]You're clearly not going to win anyway... So as long as I act just like another NPC, it shouldn't matter if I join in more actively, should it...?'[otherwise]Oh, look at this, you must be one of the wenches from the Dungeon, right? There's no way this is the player I saw earlier. So it'll be totally fine if I just bang you now, right? Hehehe...'[end if][roman type][line break]".

To say EnemaFloorReactionFlav of (M - supporter-aika):
	say "[BigNameDesc of M] tilts [his of M] head to the side.[line break][speech style of M]'Was that on purpose? Are you trying to tell me something?'[roman type][line break][if the humiliation of the player < HUMILIATION-DISGRACED + 1000][one of]You turn a bright shade of red[or]You blush brightly with shame[or]You shiver with self-consciousness[or]You turn red-faced with shame[in random order].[end if]".

To say EnemaReactionFlav of (M - supporter-aika) into (C - a clothing):
	say "[BigNameDesc of M] snickers to [himself of M] from behind [his of M] mask.[line break][speech style of M]'How does that feel? Nice and warm and sticky, I hope? Well in fact I know, because I coded it that way.'[roman type][line break][if the humiliation of the player < HUMILIATION-DISGRACED + 1000][one of]You turn a bright shade of red[or]You blush brightly with shame[or]You shiver with self-consciousness[or]You turn red-faced with shame[in random order].[end if]".

To say SexDollPerception of (M - supporter-aika):
	say "[speech style of M]'If you knew how many hours I've spent making sure that the sex doll curse worked properly and that NPCs treat you consistently, I think you'd appreciate me a whole lot more. And you'd probably understand why I'm going to take this opportunity to take a live one for a ride!'[roman type][line break]".

To say SwallowDemand of (M - supporter-aika):
	say "[speech style of M]'Don't disrespect the dev by refusing to swallow [his of M] cum, now.'[roman type][line break]".

To say CleavageClimaxFlav of (M - supporter-aika):
	say "[BigNameDesc of M] grunts triumphantly as [he of M] ejaculates, coating your [ShortDesc of breasts] in [his of M] [semen]!".

To compute the flying player taunting of (M - supporter-aika):
	if a random number from 1 to 6 is 1:
		say "[BigNameDesc of M] waves to you.[line break][speech style of M]'[one of]Having fun with the inflation mechanics are you?'[or]I know it doesn't make much physical sense, but it sure is fun to get blown up like a balloon, isn't it?'[or]Don't worry, I can wait!'[in random order][roman type][line break]";
		humiliate 20.

To compute labour to (M - supporter-aika):
	if M is regional and M is alive:
		compute pregnancy clothing displacement;
		say "[PregFlav][if the father is in the location of the player][BigNameDesc of M][otherwise][BigNameDesc of M] appears almost as if on cue! [big he of M][end if] kneels down on one knee and delivers the human baby. [big he of M] takes it into [his of M] arms and begins to cradle it. [line break][speech style of M]'A baby [one of]boy[or]girl[purely at random]! [if the father is mating]I do enjoy these moments, don't you? All of the experience of the miracle of childbirth without the whole 18 years of stress and fatigue.'[otherwise]Oopsie, I forgot you might have pregnancy fetish enabled. Maybe we should have used a condom. Then again, this is pretty cool, no? Doesn't it feel kind of awesome to have had a baby with the developer of Trap Quest?'[end if][roman type][line break]Without giving you a chance to react, never mind reply, [he of M] leaves you to recover from your ordeal.";
		if the father is in the location of the player:
			say "For some reason, you are filled with a sense of deep fulfilment. You feel great!";
			StrengthUp 1;
			DexUp 1;
			IntUp 1;
	otherwise if M is alive:
		Delay Labour.

To say ClothesPeeReaction of (M - supporter-aika):
	if M is friendly:
		say "[BigNameDesc of M] scratches [his of M] chin under [his of M] mask.[line break][speech style of M]'So you're into watersports, huh?! I'll have to remember that.'[roman type][line break]";
		FavourDown M by 2;
		if M is unfriendly, say "[big he of M] thinks for a moment before taking an aggressive stance.[line break][speech style of M]'It's not often that such a shameless pervert crosses my path in here. I don't want to miss this chance to play with you. Let's do this!'[roman type][line break]";
	otherwise:
		say "[BigNameDesc of M] laughs.[line break][speech style of M]'[if M is interested]You are an utter disgrace!'[otherwise]Is that your way of getting my attention? Well it worked!'[end if][roman type][line break][if M is uninterested]Uh-oh...[end if]";
		now M is interested.

To say PissDrinkThreat of (M - supporter-aika):
	say "[speech style of M]'[one of]That's it, swallow my virtual piss, you skank! It tastes just like the real thing, doesn't it?'[or]Come on now, you'd better drink what I give you! I promise I coded it to be completely harmless, if perhaps a little addictive...'[in random order][roman type][line break]".

To say RockingReactionSpeech of (M - supporter-aika):
	say "[one of][line break][speech style of M]'Hahahahaha! If you could only see this from my perspective! You look SO pathetic right now! I really do design the best traps, don't I?'[roman type][line break][or][stopping]".

Part - Critchett

supporter-critchett is a supporter. supporter-critchett is female. The leftover-type of supporter-critchett is 204.

The supporter-name of supporter-critchett is "Critchett".

Figure of Critchett is the file "NPCs/MultiFloor/Supporter/critchett1.png".
Figure of Critchett Leaking is the file "NPCs/MultiFloor/Supporter/critchett2.png".

To decide which figure-name is the monster-image of (M - supporter-critchett):
	if lactation fetish is 1, decide on figure of Critchett Leaking;
	decide on figure of Critchett.

To set up (M - supporter-critchett):
	reset M;
	now the monstersetup of M is 1;
	now the raw difficulty of M is 11; [+7 from credit spending]
	now the health of M is the maxhealth of M.

To decide which number is the outrage tolerance of (M - supporter-critchett):
	decide on 5. [-5 from credit spending]

To set up sex length of (M - supporter-critchett) in (B - vagina):
	set up sex length 3 of M in B. [+1 from credit spending]
To set up sex length of (M - supporter-critchett) in (B - asshole):
	set up sex length 3 of M in B. [+1 from credit spending]

Definition: supporter-critchett is fetish appropriate if diaper lover > 0.

To say LeftoverDesc (N - 204):
	say "A massive, swollen diaper that is leaking a large pool of sexual juices of every sort lies discarded here. It squirms and shifts as if something is alive inside of it, and you think you hear a satisfied female moan, but it clearly is just completely filled with cum.".

To say MonsterDesc of (M - supporter-critchett):
	say "Your eyes are drawn to a young [man of M] with sultry eyes that are aflutter from a near-orgasmic state. [big his of M] dark purple hair, which cascades halfway down [his of M] back, does nothing to conceal that [he of M] is completely nude except for a massive plain white disposable diaper. It crinkles distinctly with every motion [he of M] makes and the tapes struggle to not burst as the absorbent monstrosity is at a heavy capacity with what appears, judging by the leaking streaks down [his of M] legs, to be an unholy flood of hot, slimy girlcum! It has swollen until the ultra-thick padding is down to [his of M] knees, forcing them wide apart, and extends a similar distance in front of [him of M] and behind [him of M] to create an enormous gooey pearl encasing [him of M] within the sturdy plastic lining. Above [his of M] diaper you can see [his of M] [if pregnancy fetish is 0]full[otherwise]heavily pregnant[end if] belly and watermelon-sized tits[if lactation fetish is 1] which are randomly squirting out anywhere from a few drops to a small spurt of warm breast milk with each frantic breath [he of M] takes[end if]. As [his of M] gaze slowly makes you out, you see [him of M] blush from [his of M] humiliating state which only serves to turn [him of M] on more! [big he of M] bites [his of M] lip as [he of M] rides [his of M] Tantric ecstasy, giving softly into a long climax[unless (M is interested and M is dangerous) or M is asleep]. As [he of M] does so, [he of M] grabs the front of [his of M] diaper and slowly grinds [his of M] crotch into the slimy pulp within to keep [his of M] lust at near [his of M] breaking point until [he of M] tenderly cums again in an endless cycle[end if][if M is interested]. [big he of M] smiles at you kindly, but... hungrily![otherwise].[end if]".

To say DisapprovalFlav of (M - supporter-critchett): [This is when the player is in some way looking suddenly more lewd in front of the NPC, maybe because they pulled out their tits, or maybe because a trap pulled up their skirt, or jizzed on them, or similar.]
	say "[BigNameDesc of M] [one of]squeals in excitement and trembles as [he of M] grabs as much diaper as [he of M] can to press into [his of M] loins with a wet squish! [speech style of M][line break]'You look so much more ready for some fun!'[or]grabs [his of M] tits and squeezes them together. You think [he of M] approves of your new look![or]shyly looks over your embarrassing state. [line break][speech style of M]'I wasn't going to force you to enjoy yourself like... THIS, but... you're making it hard for me to resist, sweetie.'[at random][roman type][line break]".

To say CurtseyReactionFlav of (M - supporter-critchett):
	let K be a random worn currently visible knickers;
	unless K is nothing:
		say "[BigNameDesc of M] chirps appreciatively.[line break][speech style of M]'Very cute [ShortDesc of K]!'[roman type][line break]";
	otherwise:
		say "[BigNameDesc of M] smirks.[line break][speech style of M]'Now there's a slut who knows how to behave properly.'[roman type][line break]".

To say BecomesAggressive of (M - supporter-critchett):
	say "[speech style of M]'[one of]I... ohhhhh! I can't take it anymore! I need you... IN my diaper! Right now!'[or]'That's it! You feel it, don't you? You need to be shown how to just give in and feel right!'[in random order][roman type][line break][big he of M] crouches down, using [his of M] large curves to stabilize [himself of M] as [he of M] gets ready to pounce you!".

To say AlreadyUnfriendlyPerception of (M - supporter-critchett): [The NPC has just spotted the player, and has already decided they're best used as a cumdump]
	say "[speech style of M]'[one of]Oh, good, there you are! I need... more! And you're just the right taste!'[or][NameBimbo]! Perfect timing, I'm about to cum again! Now hold still...'[or]Mmmfff!'[roman type][line break] [BigNameDesc of M] edges close to orgasm upon seeing you. [big he of M] wordlessly pulls the front of [his of M] diaper open, points at you, then points into the hot slimepit that engulfs [his of M] gushing, overworked cooch.[or]Can't you just do me a favour and kneel down? I'll take good care of you.'[roman type][line break][BigNameDesc of M] squeezes [his of M] legs together, squishing [his of M] diaper much harder into [his of M] loins than [he of M] was prepared for, making [his of M] scream in sexual frenzy and launch [himself of M] at you![in random order][roman type][line break]".

To say SexDollPerception of (M - supporter-critchett): [The NPC has just spotted the player, and the player is currently a sex doll. The NPC is going to turn immediately unfriendly and demand sex.]
	say "[speech style of M]'[one of]You're just a toy to add to my pleasure now. A toy with a soul still perhaps? You still belong between my legs!'[or]Oh, how exciting! A sex doll like you really won't be able to plead for mercy as I do unspeakable things to you!'[or]A big, beautiful sex dolly! It's time for your diapering!'[in random order][roman type][line break]".

to say FriendlySluttyPerception of (M - supporter-critchett): [The NPC has just spotted the player while the player looks slutty, but hasn't witnessed enough to decide to fuck them.]
	say "[speech style of M]'[one of]You know, you get cuter and CUTER every time I see you! It[']s really... hot. And makes me hotter in my...'[roman type][line break] [big he of M] sits on the ground, [his of M] gigantic diaper acting like a big bean bag. [big he of M] quivers quietly to [himself of M] as [he of M] creams into it yet again.[or]You're starting to get the hang of this! Tits out, missy! <if player is undiapered> Get yourself diapered, too! Then you'll be ready to learn Tantric desire...'[or]Oh dear, I thought *I* was in a shameful state. Just look at you go, girl! I'll be watching you!'[roman type][line break][BigNameDesc of M] winks, turns [his of M] diapered butt to you, and spanks [himself of M] sharply once, causing a squish of slimy sexhoney to erupt from [his of M] strained-tight elastic legbands.[in random order][roman type][line break]".

to say UnfriendlySluttyPerception of (M - supporter-critchett): [The NPC has just spotted the player while the player looks slutty, but hasn't had much of a chance to start disapproving of them yet.]
	say "[speech style of M]'[one of]Aaaahhh!'[roman type][line break][BigNameDesc of M] can't maintain [his of M] orgasmic edging composure upon seeing you and doubles over as [he of M] cums into [his of M] diaper hard![line break][speech style of M]'You look like a walking sex shop and made me cum too hard, you little slut! It'll take too long for me to build up that level of sexual energy again. But you're going to do it for me right now!'[or]Oh, perfect! A bimbo slutwhore to put in [his of M] place!'[roman type][line break][big he of M] poke-points to [his of M] vagina, deep inside [his of M] engorged diaper, for emphasis on where that place should be![or]You look ready enough! Lie down on your back, feet together, legs up! I need to decide how to take you and a slut like you had best be ready to lick, get licked, get diapered, or more!'[in random order][roman type][line break]".

To say BoringPerception of (M - supporter-critchett): [The NPC has spotted the player who doesn't look slutty enough to decrease their friendliness]
	say "[speech style of M]'[one of]Hi there, sweetie! You're really cute! I hope you're having as great a time here as I am!'[roman type][line break][BigNameDesc of M] takes hold of the sides of [his of M] diaper[']s waistband and twists down into it, pulling [himself of M] deeper inside until it engulfs [his of M] entire [if pregnancy fetish > 0]pregnant [end if]belly, bringing a sigh of fluttering contentment as [he of M] ekes out another mini-orgasm.[or]Ohmigosh, I... I...'[roman type] [he of M] stutters as [he of M] blushes in absolute shame. [speech style of M]'You look very respectable. I'm just a big, [if lactation fetish is 1]milky[otherwise]slimy[end if] ball of sex trapped in a... a... DIAPER!... ahhhHHH??? AAAHHH!'[roman type][line break] [big his of M] words rise from utter shame over [his of M] infantile garment to a screaming orgasm as [he of M] collapses onto [his of M] face, trembling and swelling the object of [his of M] desire visibly further with [his of M] juices.[speech style of M][line break] '[big please], don't look at me. Unless you strip down and join me. [big please] say you'll join me?'[roman type][line break][then at random]".

To say IdentifiablePosterReactionFlav of (M - supporter-critchett):
	say "[BigNameDesc of M] takes notice of your incriminating poster. [big he of M] looks at you with wide eyes that momentarily roll up into [his of M] eyelids as [he of M] rubs [his of M] crotch with wet squelches into [his of M] diaper.[line break][speech style of M]'Wasn't it so wonderful?! Mmm, I bet you felt amazing! Like a totally degraded slut fit only for disposal!'[roman type][line break]".

To say UnidentifiablePosterReactionFlav of (M - supporter-critchett):
	say "[speech style of M]'Ohhh, would you look at that! That really looks... hot! Would you like to play that out with me? We could do our own photo shoot! You[']d look good like that!'[roman type][line break]";

To say PresentFriendlyAcceptanceFlav of (M - supporter-critchett): [This is when the player offers a body part up to them and the NPC is still friendly, and accepts]
	say "[speech style of M]'Ooo, good choice! You'd be amazed at what can bring you to the very brink of cumming. And how easy it is to lose control!'[roman type][line break]".

To say PresentFriendlyRejectionFlav of (M - supporter-critchett): [This is when the player offers a body part up to them and the NPC is still friendly, and refuses]
	say "[speech style of M]'[if presented-orifice is a potential target]I promised myself I wouldn't jump you right away. Be careful, I can't be held responsible for what I'll do to you if you keep begging me.'[otherwise]Ahhh... umm...'[roman type][line break][BigNameDesc of M] rolls [his of M] eyes back, ignoring you and grinding [himself of M] gently into [his of M] diaper to get [himself of M] off again. [big his of M] cream expands [his of M] diaper some more.[end if][roman type][line break]".

To say FriendlySexReleaseRefusalSpeech of (M - supporter-critchett): [The player has changed their mind and wants to end the friendly sex early. The NPC has decided to dominate the player and not let go so easily.]
	if the player is not able to speak, say "[speech style of M]'[one of]Shh-shh-shh-shh! Mommy's got you, sweetie!'[or]I... I can't stop! I have to... YOU have to!'[or]Oh no, you promised me! Your pretty little mouth is mine!'[in random order][roman type][line break]";
	otherwise say "[speech style of M]'[one of]You're about to get a throatful of titty. Keep doing what you're doing'[or]We are enjoying a moment here, darling. [big please] don[']t spoil it.'[at random][roman type][line break]".

To compute kneeling reaction of (M - supporter-critchett): [The player has got on their knees voluntarily while the NPC is aggressive.]
	say "[BigNameDesc of M] straddles you, [his of M] hot, wet, diaper squishing heavily onto your submissive head. [big he of M] wiggles [his of M] hips from side to side really driving home the fact that you're less than a shameless, [if lactation fetish is 1]milky[otherwise]slimy[end if] girl wearing only an oversized diaper![line break][speech style of M]'[one of]Good slut.'[or]What a good girl.'[or]My pussy is as hungry as it is giving. Are you as ready?'[in random order][roman type][line break]";
	humiliate 75.

To say SubmissionFlav of (M - supporter-critchett): [The player has done something submissive like remove an item of clothing while the NPC is aggressive.]
	say "[BigNameDesc of M] touches [himself of M] as [he of M] watches.[line break][speech style of M]'That's it, keep going. All the way down, I want you to bare your shame to me!'[roman type][line break]".

To compute delay of (M - supporter-critchett): [NPCs, when they're confident that the player can't escape, will sometimes get the player a chance to request a certain type of sex.]
	say "[BigNameDesc of M] grabs hold of [his of M] waistband and gets [himself of M] really warmed up![line break][speech style of M]'Would you like being shoved into my crinkly honey sack? Or could you take what my tongue is capable of? WHAT to do with you...'[roman type][line break]".

To say PresentAcceptanceFlav of (M - supporter-critchett): [Your (aggressive) NPC has decided to do what the player suggested.]
	say "[BigNameDesc of M] grabs you desperately.[line break][speech style of M]'You finally understand now! Get ready to melt, love!'[roman type][line break]".

To say PresentRejectionFlav of (M - supporter-critchett): [Your (aggressive) NPC has decided to ignore the player's suggestion. NB that they may independently make the decision to do that thing anyway themselves, so it would be inaccurate to say that your NPC 'decides against doing that' or something.]
	say "[BigNameDesc of M] shudders as [he of M] has another micro-orgasm. You don't think [he of M] heard you at all, but suddenly [his of M] eyes snap to you as if [he of M] knows what [he of M]'ll do next.[line break][speech style of M]'There[']s only one use for you right now. You[']ll be lucky if there[']s anything left of you to still dispose of...'[roman type][line break]".

To compute the busy waiting of (M - supporter-critchett): [The NPC isn't able to do their thing right now because the player is busy with something boring, like resting in a hammock.]
	if a random number between 1 and 6 is 1, say "[BigNameDesc of M] plops down wetly and continues masturbating [himself of M] endlessly, enjoying [himself of M] until you're free to pay attention to [his of M] again.".

To compute the default taunting of (M - supporter-critchett): [The NPC isn't able to do their thing right now because the player is busy with a trap or another NPC, but they expect the player will be free soon.]
	say "[BigNameDesc of M] licks [his of M] lips, waiting for [his of M] opportunity to snatch you up for [himself of M].".

To say SelectionFrustrated of (M - supporter-critchett): [The NPC has got tired of waiting!]
	say "[BigNameDesc of M][']s eyes widen vastly. [big he of M] heaves a lengthy, spent moan as [his of M] diaper brings [his of M] to cum way too hard this time.[line break][speech style of M]'Ugh, well. Maybe I'll find you later on when I've warmed back up...'[roman type][line break]";
	bore M.

To compute the dildo stuck taunting of (M - supporter-critchett):
	if a random number between 1 and 3 is 1, say "[BigNameDesc of M] catches sight of you through [his of M] sex-crazed haze and coos delightedly as [he of M] slides up against you, pressing [his of M] hot curves against you.[line break][speech style of M]'[one of]Ooo, that's in DEEP, isn't it, sweetie? Is it cumming inside you? Will you get filled with hot cream? You'd love that, wouldn't you? I know I would.'[or]I bet you'd like help getting off of that. I really would just rather watch this, though. Wiggle a little for me?'[or]You're lucky I'm in control of myself right now. I could use a good dildo deep in my [vagina] even if you're currently part of it!'[or]You never saw this coming, did you? I mean, you did know this place was trapped, right?'[in random order][roman type][line break]".

To say angry punishment insult of (M - supporter-critchett): [The NPC is angry because the player wronged them (e.g. didn't swallow). They will now get their revenge, probably by stealing an item of clothing / jewellery.]
	say "[speech style of M]'Why are you being such a BRAT?! I'm just trying to sex you until you're nothing but a disposable pool of cum, I'm not your enemy!'[roman type][line break]".

To say MonsterTripAnnounceFlav of (M - supporter-critchett):
	say "[BigNameDesc of M] turns away from you and launches [his of M] diapered rear at you, trying to knock you to the ground!".

To say MonsterFailedTripFlav of (M - supporter-critchett):
	say "You avoid [his of M] charge and [he of M] nearly falls to the ground instead.".

To say StrikingSuccessFlav of (M - supporter-critchett) on (B - a body part): [TargetName of B outputs something beginning with "on the", e.g. "on the ass"]
	say "[BigNameDesc of M] swings [his of M] enormous tits into you and slams you [TargetName of B]! Squishy!! But owwwww.".

To say StrikingFailureFlav of (M - supporter-critchett) on (B - a body part): [TargetName of B outputs something beginning with "on the", e.g. "on the ass"]
	say "[BigNameDesc of M] swings [his of M] enormous tits into you and tries to slam you [TargetName of B] but you manage to swiftly dodge the blow!".

To say MindingOwnBusinessCombatFlav of (M - supporter-critchett): [Your NPC was minding their own business and not even looking at the player when they attacked]
	say "[big he of M] snaps out of [his of M] Tantric diaper masturbation daze as you assault [his of M].[line break][speech style of M]'Ohhh, [please]... strike me in my soaked padding, that feels heavenly! Better yet... I'll take you down and make you my living diaper filling!'[roman type][line break]".

To say RudeAwakeningFlav of (M - supporter-critchett): [Your NPC was sleeping when the player attacked]
	say "[big he of M] wakes up, struggling against a diaper heavier than [he of M] is to stand back awkwardly on [his of M] feet and see who wants to play!".

To say DamageReactHealthy of (M - supporter-critchett):
	say "[BigNameDesc of M] [one of]coos softly, liking that[or]shakes [his of M] tits at you, daring you for more abuse[at random].".

To say DamageReactDamaged of (M - supporter-critchett):
	say "[BigNameDesc of M] [one of]gasps slightly as [he of M] licks [his of M] lips[or]jiggles wildly from your attacks, but [he of M] doesn't mind[at random].".

To say DamageReactTired of (M - supporter-critchett):
	say "[BigNameDesc of M] [one of]yelps in surprise, [his of M] eyes widening and [his of M] toes curling[or]squeezes [his of M] eyes shut, trying to endure[at random].".

To say DamageReactWeak of (M - supporter-critchett):
	say "[BigNameDesc of M] [one of]is mushing [his of M] [vagina] desperately into [his of M] diaper to cover the pain with [his of M] pleasure[or]looks like [his of M] legs are about to buckle as [he of M] wraps [his of M] arms around [his of M] middle to steady [himself of M][at random].".

To say DamageReactSubmissive of (M - supporter-critchett): [Hinting that the player might be able to turn the tables and fuck your NPC]
	say "[BigNameDesc of M] [one of]drops [his of M] defences and takes hold of [his of M] tits, [if lactation fetish is 1]milking[otherwise]squeezing[end if] them softly as though you're not about to completely take advantage of this[or]lies on [his of M] back with [his of M] legs in the air, ready for a spanking, a diaper change, or even a good fucking[at random]!".

To say MovementBlock of (M - supporter-critchett):
	say "[BigNameDesc of M] eclipses the way through with [his of M] swollen diapered silhouette, stopping you in your tracks![line break][speech style of M]'Wait just a moment there, cutie! Aren't you forgetting something?'[roman type][line break][BigNameDesc of M] leans forward, pulling open the front of [his of M] diaper and beckoning you to get into that hot, wet sack!".

To say StandingBlock of (M - supporter-critchett):
	say "[BigNameDesc of M] grabs handfulls of your [ShortDesc of hair] and stuffs it down [his of M] diaper, purring as the silky strands mix in [his of M] cum pool and caress [his of M] vulva! [big he of M] clamps [his of M] legs together and you can't get off of your knees".

To say BanishFleeFlav of (M - supporter-critchett):
	say "[speech style of M]'AAAAAHHHHHHHH!!!'[roman type] [BigNameDesc of M] cries out as your final blow strikes [his of M] square in between [his of M] legs and [he of M] comes to [his of M] final greatest orgasm![line break][one of][big his of M] body softens and then bursts entirely into slimy sex honey! You blink in disbelief as [his of M] diaper falls to the ground, swiftly absorbing [his of M] now-liquid body of girlcum fully into itself![or][big he of M] falls back onto [his of M] deeply padded butt and actually sinks into the diaper until the waistband comes up to just under [his of M] large breasts. As [he of M] finishes [his of M] soul-breaking climax, [he of M] looks confused for a second as [his of M] whole body tugs downwards a few times. [BigNameDesc of M] eyes go wide in shock and pleasure as [he of M]'s suddenly swallowed by [his of M] diaper, [his of M] tits popping inside as [his of M] legs are slurped up through [his of M] legbands! Very quickly you see the last of [his of M] sucked fully into [his of M] own absorbent paradise[at random]. [line break]A fairy swoops in and examines the quivering mess on the floor.[line break][speech style of M]'Wow, you really finished [him of M] off good! I told [him of M] there was a price to pay for that diaper! [big he of M][']s completely used up. A slut this disgraced deserves only one thing at this point: I[']m going to go flush [him of M] down the toilet! [big he of M][']s such worthless slop now that this whole diaper full of [his of M] just needs to be sucked spiralling down a drain. It[']s what [he of M] really wants.[roman type][line break]The fairy effortlessly scoops up the gigantic, soggy diaper and flies off to go make good on that plan. You think you hear a crinkly burble of excitement coming from the disposable cargo...".

To say SexResistSlapFlav of (M - supporter-critchett):
	say "[BigNameDesc of M] [one of]giggles[or]tut-tuts[or]furrows [his of M] brow[or]laughs with exhilaration[at random] at your [one of]inability to pry yourself away from [his of M][or]vain efforts to resist [his of M] insistent grip[or]pointless attempts to disentangle yourself from [his of M] entwining limbs[or]futile struggles to not be pressed so hard into [his of M] hot, wet diaper[at random] before [if M is male and M is penetrating face]slapping you harshly on the cheek[otherwise if M is male and M is penetrating breasts]painfully slapping your [BreastDesc][otherwise]roughly spanking your [buttcheeks][end if] [one of]to get you to behave[or]in order to keep you under control[or]as punishment[or]to discourage further disobedience[at random].".

To compute (M - a monster) stomping (N - supporter-critchett): [For when the minotaur, xavier etc. encounters our NPC]
	if N is in the location of the player, say "[NameDesc of N] freezes in mid-squip to regard [BigNameDesc of M]. [big he of N] bites [his of N] lip as [he of N] sizes up [his of M] [LongDickDesc of M] with intense curiosity![speech style of N][line break]'Ohhhhh, my goddess... you look like you need a nice hot pouch to bury that in! Why don[']t you come over here and let m-EEEP!'[roman type][line break] [BigNameDesc of M] has already made up [his of M] mind and isn[']t even listening to [him of N], having grabbed hold of [him of N] with both hands and lifted [him of N] effortlessly to dangle over [his of M] enormous, pulsing rod. [BigNameDesc of N][']s eyes betray a moment of terror as [he of N] has lost all control of this situation! After a mere moment to allow trepidation to settle into [his of M] prey, [BigNameDesc of M] slams [him of N] down on [his of M] shaft, [his of M] [DickDesc of M] impaling the base of [NameDesc of N]'s gigantic diaper in between [his of N] knees, and sliding up through the slimy, spongey pulp. [big he of N] slides down [his of M] length and comes to a stop momentarily when [he of M] reaches [his of N] comparatively tiny vulva. [BigNameDesc of N][']s eyes cross from the feeling of [his of M] hot precum mixing with [his of N] own ever-flowing juices, spreading [his of N] flower to engulf only the very tip of the destructive piston. There is only a second of pregnant silence as [he of M] shifts [his of N] hands to be on top of both of [his of N] shoulders and [BigNameDesc of N] shudders in dreadful, but rapt anticipation. [BigNameDesc of M] violently shoves [he of N] down, [his of N] belly expanding further to the sound of [his of N] scream of painful pleasure! [big he of M] quickly begins to jack [NameDesc of N] up and down [his of M] throbbing trunk as [he of N] struggles to remain conscious through a last forced orgasm. [speech style of N][line break]'Use... me... up. Dispose of me... like filthy trash. Like a sodden... overused... diaper...'[roman type][line break]With a howl, [he of M] cums powerfully, bringing one last breathless, silent scream from [him of N] as [his of N] belly balloons with seed to flood whatever [he of N] was carrying in there! [big he of M] huffs and pulls [NameDesc of N] off with a long [']shllllllluck['] sound before tossing [him of N] like garbage behind [him of M]. [BigNameDesc of M] looms suddenly over you, having given you a front row seat as to what happens next!";
	otherwise say "You hear an echoing sharp 'EEP!' and then a few moments later, a shriek like you'd hear from a [man of N] if [he of N] was suddenly impaled on a giant [ShortDesc of M] penis, coming from [if N is nearby]nearby![otherwise]somewhere in the region![end if]";
	destroy N;
	let L be a random off-stage leftover;
	now L is in the location of M;
	now the leftover-type of L is the leftover-type of N.

To say MonsterOfferRejectFlav of (M - supporter-critchett) to (T - a thing):
	say "[BigNameDesc of M] doesn't seem to hear you as [his of M] eyes are rolled up as [he of M] cruises another wave of sexual climax.[line break]You are surprised when you hear [him of M] mutter through [his of M] laboured breathing, [speech style of M]'What would I do with that? You can drop it in my crinkly prison here if you really want, but I'll never find it in there again.'[roman type][line break]".

To compute sudden objectification of (M - supporter-critchett):
	say "[NameDesc of M] mmm's deeply and suddenly stares straight at you like [he of M]'s eyeing the tastiest morsel![line break][speech style of M]'[if M is penetrating a body part]You're so incredibly fuckable, do you know that? When I'm done with you, I'll be sure to dispose of you properly!'[otherwise if the player is monster fucked]The only thing more shameful would be to let a whole group of us show you your rightful place. Give me some of that delicious sugar!'[otherwise]You're... really not a person anymore. My hands are tired of keeping my diaper filling with girlcum, I need you as a sex toy! Come here, [whore]!'[end if][roman type][line break]".

To compute MasturbationReaction of (M - supporter-critchett):
	if M is awake:
		if M is penetrating a body part:
			if M is friendly-fucking:
				say "[BigNameDesc of M] purrs with delight as you pleasure yourself.[speech style of M][line break]'That[']s it, darling, give in! Bathe me with your juice! Soak my diaper! Mmmmm...'[roman type][line break]";
			otherwise:
				say "[BigNameDesc of M] kisses you fiercely as you tend to your own sexual need, then breaks off and backhands you fiercely![line break][speech style of M]'You[']re a dirty whore! Filthy, and shameful. You should be diapered in front of everyone. So they can see your shame. O-... our shame. Together. They can humiliate us, use us up, then flush us away...'[roman type][line break]";
				PainUp 1;
				now wanking is 0;
		otherwise:
			say "[BigNameDesc of M] watches you with unrestrained lust, [his of M] continual masturbation motions currently mimicking your own.[line break][speech style of M]'[if M is friendly]If you[']re going to cum, [please] do it over me. Or into my diaper. It's super good at soaking cum!'[otherwise]You big tease! There[']s no way you[']re going to waste perfectly good sexjuice when you could be using it to put me in my place as your diaper!'[end if][roman type][line break][big he of M] pulls open the front of [his of M] diaper and points into it for emphasis, approaching you as if to engulf you!";
			now M is interested;
			anger M.

To say EnemaFloorReactionFlav of (M - supporter-critchett): [When the player squirts an anal creampie / enema onto the ground in front of the NPC]
	say "[BigNameDesc of M] [if M is interested]looks down at the floor in disbelief.[speech style of M][line break]'That[']s such a waste! You could have really added a few quarts of hot slime to me, or started a diaperpot of your own!'[otherwise]turns to look at you with an betrayed look[end if].[line break][speech style of M]'You know what would keep the mess off of the floor? Keeping it in your diaper! If you keep it hot, you[']ll always feel it caressing you comfortingly.'[roman type][line break][if the humiliation of the player < HUMILIATION-DISGRACED + 1000][one of]You turn a bright shade of red[or]You blush brightly with shame[or]You shiver with self-consciousness[or]You turn red-faced with shame[in random order].[end if]".

To say EnemaReactionFlav of (M - supporter-critchett) into (C - a clothing): [When the player squirts an anal creampie / enema into worn clothing in front of the NPC]
	say "[BigNameDesc of M] [if M is interested]cheers in delight![speech style of M][line break]'You did it! I'm so proud of you! Soak, soak, soak!'[roman type][otherwise]notices you flood yourself and rushes over excitedly![end if].[line break][speech style of M]'I simply must get you a diaper like mine! We could be diaperslut sisters together!'[roman type][line break][if the humiliation of the player < HUMILIATION-DISGRACED + 1000][one of]You turn a bright shade of red at having been caught expelling your bowels[or]You blush brightly with shame at having been compared to [BigNameDesc of M][or]You shiver with self-consciousness at the thought of wearing one of [his of M] diapers[or]You turn red-faced with shame at the notion of being a 'diaperslut sister!'[in random order].[end if]".

[Oral]

To say CommencingFacesitFlav of (M - supporter-critchett): [The NPC sits on the player's face.]
	say "[BigNameDesc of M] takes hold of you and kisses you breathily. You can literally taste the sexual frenzy on [his of M] lips![speech style of M][line break]'I got you at last! You know where you[']re going!'[roman type][line break]You swallow hard as you realize [he of M] is pulling open the front of [his of M] diaper, letting you see the slimy pool of unabsorbed girlcum within form thick strands between [his of M] bare legs and crotch and the overtaxed pulp of [his of M] lining.[speech style of M][line break]'In you go! I want your tongue in my slit deep, now!'[roman type][line break][BigNameDesc of M] seizes you and you find yourself flipping and being pressed against [he of M], suspended in a 69 position with your face against [his of M] [if pregnancy fetish > 0]pregnant [end if]belly and your feet up above [his of M] head. You look below you to see the diaper being pulled gaping open like a big toothless mouth. [big he of M] giggles as you are let to slip down inside, the hot moisture coating your upper body as you slide into the slut's sack down to your elbows, your tits pressing against [his of M] pubic crease and your face slipped under [he of M] to align your tongue to the incredibly engorged labia of your captor. [BigNameDesc of M][']s hands let the waistband tighten you to [he of M], securing you, before [he of M] takes your hips and begins using you to get [himself of M] off with.[speech style of M][line break]'Eat me out! Be my living diaper and absorb my lovejuice!'[roman type][line break]".

To say FacesitResistingResponse of (M - supporter-critchett): [The player is refusing to play ball and perform cunnilingus / anilingus. How does the NPC act?]
	say "[one of][BigNameDesc of M] makes use of your struggling motions and sighs, though you can't tell if it's from frustration or if [he of M]'s pleased at the sensations you are making as you slide wetly back and forth between [his of M] legs inside [his of M] dark, crinkly diaper.[or][BigNameDesc of M] presses a hand tightly against [his of M] diapered crotch which you feel against the back of your head, pushing your nose into [his of M] gaping cunt and your lips around [his of M] large, pulsating clit! [big he of M] squeals in delight and massages your head against [his of M] body.[or][BigNameDesc of M] squeezes [his of M] thighs to either side of your head and you are trapped, forced to use some of what little air came in with you as you smell the intense flood of undying female arousal as well as feel it soak into your hair and face. You feel utterly degraded.[or][BigNameDesc of M] crouches down to the floor, the bottom of [his of M] ultra-expanded diaper resting comfortably there. The weight of [his of M] sitting down on you presses your face deep into [his of M] pussy.[speech style of M][line break]'I[']ve been spending all this time getting myself off on my own. [big please] do it for me. [big please]? I[']m... I[']m not going to let you out until you do! Oh... I probably won[']t let you out if I do cum, too. PLEEEEASE!'[roman type][line break][in random order]".

To say FacesitSubmissionResponse of (M - supporter-critchett): [Normal facesitting oral sex. Explain what's happening!]
	say "[one of][BigNameDesc of M] coos in delight as you obediently begin lapping at [his of M] quivering pussylips and savouring the cream coating on [his of M] greatly swollen clit. [big he of M] rocks [his of M] hips back and forth, making you slide wetly through [his of M] sexdiaper and your tongue travels the length of [his of M] entire slit.[or][BigNameDesc of M] kisses you just below your navel, the odd sensation causing your body to stiffen in surprise inside [his of M] diaper. [big he of M] uses your reaction to drive your head downwards towards [his of M] knees, sinking into the deep, absorbent fluff like a sucking pool of quicksand. You feel almost the sense of the diaper undulating around you as if it was tasting you or considering absorbing you somehow! You feel a hug of love from [BigNameDesc of M] as you fulfil [his of M] fantasy and [he of M] grinds [himself of M] into [his of M] diaper until you find your face returned to [his of M] waiting pussy.[or][BigNameDesc of M] happily carries on with inaudibly telling a story of some sort and absent-mindedly rocks [himself of M] back and forth in [his of M] diaper as you eat [him of M] out.[or][BigNameDesc of M] grabs hold of [his of M] waistband's sides and pulls up as much as [he of M] can, cinching it up over [his of M] rounded belly and just below [his of M] voluptuous tits! You are duly pressed very tightly against [his of M] body, the warm, soaking embrace against [his of M] sex now a forceful push to hold you very still in place. You get the hint as your mouth is practically crushed against [his of M] netherlips and you slide your tongue deep within [him of M]. [BigNameDesc of M][']s constant Tantric state has ensured that even now, [his of M] cunt is releasing a deluge of femcum to fill your mouth and overflow into the diaper around you.[in random order]".

To say NearingClimaxFacesit of (M - supporter-critchett): [Next turn your NPC is going to cum! Give a hint to the player by changing up the flavour. Also this allows the climax to make more sense (rather than [his of M] sitting still and the player refusing to tongue, and then suddenly there's an orgasm!)]
	say "[BigNameDesc of M] cries out in rising ecstasy![speech style of M][line break]'Oh... goddess! Oh, goddess, give it to me! I need you! I need you to... mmmm!!!'[roman type][line break][big he of M] spreads [his of M] stance very wide and you suddenly feel a very strange sucking on the diaper-engulfed portion of your body. You slide down deep into [his of M] diaper, feeling your abdomen and then even your hips pass [his of M] waistband and enter the hot gooey mess. Sinking into the giving, gushing pulp, you are drawn down between [his of M] legs into the deepest recesses, and your own legs slide in with you. You feel [BigNameDesc of M] grab hold of [his of M] hugely bulging diaper and adjust your position to curl up under [his of M] trembling nearly-orgasmic legs and before you know it, your feet pop inside! You are entirely within the diaperslut's precious sexsack! [one of] [BigNameDesc of M] deeply moans, longly and loudly as [he of M] feels you slip inside. [big he of M] struggles to take a few steps to see what a diaper full of You feels like. [big he of M] swings you slowly like a pendulum under [him of M] as [he of M] pulls you up to wrap around [him of M] like a large living diaper. You feel the wet, hot press of the actual diaper making it impossible to do otherwise! [BigNameDesc of M] grinds you on [his of M] shuddering pussy until [he of M] stiffens and falls roughly onto [his of M] back, with [his of M] legs in the air as if [he of M] were waiting for a diaper change and vigorously masturbates [himself of M] with you![or][BigNameDesc of M] falls onto [his of M] back from the weight bringing [him of M] down at last and you find yourself between [his of M] legs, with your head and shoulders under [his of M] ass as [he of M] lays on top of you and the rest of you tucked under [him of M] and lost in the giant, stretched crinkly prison. You absolutely cannot believe what you've been reduced to! Just as you wonder how it could get any more degrading, [he of M] bucks and rocks [his of M] hips, desperately using your body to try to get [himself of M] to not just come to orgasm, but to push far past it for a much higher climax![at random]".

To say FacesitClimaxFlav of (M - supporter-critchett):
	say "[BigNameDesc of M] screams in ecstasy as [he of M] creams [himself of M] hard, [his of M] body tensing up and [his of M] diaper tightening very suddenly. You first feel the pressure push you back the way you came, your feet bursting wetly out of the stretchy front waistband, followed by half of your body. Your face slides across [his of M] pussy just as [his of M] hot torrent of [if the oral sex addiction of the player < 4]gross and sticky [otherwise if the oral sex addiction of the player > 6]delicious [end if]girlcum floods out and re-bathes your face! [BigNameDesc of M][']s legs clamp together and your feel yourself pushed in a burst back out of [his of M] diaper and across [his of M] torso in a large shower of honey that leaves you both in a puddle as [he of M] catches [his of M] breath .[line break][speech style of M]'Oh, goddess...[NameBimbo], that made me so happy. But you truly are a disposable sex object. Get yourself in a diaper and take your place as a slut until someone has the energy after an orgasm like this to dispose of you properly.'[roman type][line break]";
	CumFaceUp 8.

[Vaginal & Anal]

To compute (M - supporter-critchett) attacking (C - a clothing): [Critchett always destroys clothing to make way for diapers.]
	say "[PullAttempt of M at C]";
	let R be a random number between the difficulty of M and 6 + a random number between the difficulty of M and 6;
	if debuginfo > 0, say ClothingAttackDebug of M on C with R;
	if R > the defence of the player:
		compute M destroying C;
	otherwise:
		say "[WeakenFlav of M on C]";
		damage C.

To say VaginaSpecialPenetrationFlav of (M - supporter-critchett): [This can be whatever you want as long as the purpose is masturbating the vagina and it's not thick enough for us to need to handle calculations about soreness and stretching. So it could be a vibrating wand, or your NPC's tongue, etc. Just make sure that the flavour in the following turns matches]
	say "[BigNameDesc of M] smiles seductively as [he of M] flips you onto your back, pins your ankles together, and raises your feet high into the air holding them there, cool air blowing across your exposed butt and crotch. With a sudden shock, you recognize the very nature of the position you've been forced to assume: you are prepped for a diaper change! [BigNameDesc of M] [one of]towers over you, [his of M] diaper and massive frontal curves forcing [him of M] to lean over to leer at your properly. You feel suddenly very helpless.[or]spreads your legs apart as [he of M] reaches down to caress your sex and test its potential wetness. You feel utterly on display.[or]wiggles [his of M] hips left and right, emphasizing the gigantic padded cladding above you as if to show you your future. You gulp...[at random][line break][speech style of M][one of]'It's time to put you in a fresh, soft diaper!'[or]'Your face says it all. It says [']Please, sexy lady, diaper me like a helpless little girl!['] How can I deny such longing?'[or]'I'll make sure you're so wet that you'll grow your diaper to look like mine!'[or]'You can't escape this. You're trapped. You know what happens to you now, right? Mm-HMM! That's riiiiight!'[at random][roman type][line break][BigNameDesc of M] kneels down, still holding your feet aloft while a fairy flutters by and drops some supplies next to [he of M]. You hear a crinkly [']FWIP['] sound as [NameDesc of M] uses [his of M] free hand to open something just out of your sight. [big he of M] raises your butt and the intense softness of a disposable diaper is slid underneath you, the rear waistband settling into place just below the small of your back. The way you are being held helpless as a baby makes you flush with shame. The fairy points and laughs at you, multiplying the humiliation! [NameDesc of M] grins wickedly and seizes hold of the fairy, ignoring [his of a random fairy] protests. [big he of M] releases your legs which instinctively spread apart, and [NameDesc of M] uses [his of M] fingers to open your [vagina] and shove the struggling fairy deep inside until [he of a random fairy]'s out of sight! You feel [him of a random fairy] wiggling around in your tunnel, filling it, and [he of a random fairy] sends sparks of pleasure through you. Moisture quickly begins to leak from your fairy-stuffed hole and soak into the diaper beneath you. [BigNameDesc of M] already has one hand down [his of M] own diaper and is pushing through [his of M] creamed padding to finger [himself of M] at the sight before [him of M].".

To say AssholeSpecialPenetrationFlav of (M - supporter-critchett): [This can be whatever you want as long as the purpose is masturbating the asshole and it's not thick enough for us to need to handle calculations about soreness and stretching. So it could be a vibrating anal probe, or your NPC's tongue, etc. Just make sure that the flavour in the following turns matches]
	say "[BigNameDesc of M] smiles seductively as [he of M] flips you onto your back, pins your ankles together, and raises your feet high into the air holding them there, cool air blowing across your exposed butt and crotch. With a sudden shock, you recognize the very nature of the position you've been forced to assume: you are prepped for a diaper change! [BigNameDesc of M] [one of]towers over you, [his of M] diaper and massive frontal curves forcing [him of M] to lean over to leer at your properly. You feel suddenly very helpless.[or]spreads your legs apart as [he of M] reaches down to caress your sex and test its potential wetness. You feel utterly on display.[or]wiggles [his of M] hips left and right, emphasizing the gigantic padded cladding above you as if to show you your future. You gulp...[at random][line break][speech style of M][one of]'It's time to put you in a fresh, soft diaper!'[or]'Your face says it all. It says [']Please, sexy lady, diaper me like a helpless little girl!['] How can I deny such longing?'[or]'I'll make sure you're so wet that you'll grow your diaper to look like mine!'[or]'You can't escape this. You're trapped. You know what happens to you now, right? Mm-HMM! That's riiiiight!'[at random][roman type][line break][BigNameDesc of M] kneels down, still holding your feet aloft while a fairy flutters by and drops some supplies next to [he of M]. You hear a crinkly [']FWIP['] sound as [NameDesc of M] uses [his of M] free hand to open something just out of your sight. [big he of M] raises your butt and the intense softness of a disposable diaper is slid underneath you, the rear waistband settling into place just below the small of your back. The way you are being held helpless as a baby makes you flush with shame. The fairy points and laughs at you, multiplying the humiliation! [NameDesc of M] furrows [his of M] brow and seizes hold of the fairy, ignoring [his of a random fairy] protests. [big he of M] folds your legs back, exposing your [asshole], and in a surprising move, pushes the fairy into [his of M] huge diaper, pulls [him of a random fairy] out coated from head to toe in various cumfluids, and slides [him of a random fairy] easily up inside you! You feel [him of a random fairy] squirming not unhappily as [he of a random fairy] stimulates you wildly! [BigNameDesc of M] already has one hand back down [his of M] diaper again and is pushing through [his of M] creamed padding to finger [himself of M] at the sight before [him of M].".

To say SexSubmitFlav of (M - supporter-critchett) in (F - a fuckhole): [The player has submitted to your acts. How does that make your NPC act?]
	say "While the fairy continues twisting about in your [variable F], [BigNameDesc of M] [one of]spreads out widely the diaper back underneath you, smoothing it out and letting it cup around your sides slightly. It feels like it's trying to embrace you, and [NameDesc of M] preps the tape tabs with [his of M] free hand for easy access to some extra-secure-looking tape. [or]runs [his of M] free finger under your buttcheek and along the legband lining, tracing lightly from your hip to the back of your thigh so that you feel the elastic being smoothed into place. [or]takes hold of the front fold of the diaper currently between your knees and lifts up from the floor on it, letting you feel the soft padding start to cup between your legs, but not bringing it up into place yet. [big he of M] teases you, tugging it against you, then lays it out flat again.[at random] [big his of M] motions let you experience the promise of the diaper's feel on your body.[line break][speech style of M][one of]'Good girls get diapered! You're such a good little girl, my absolute favourite!'[or]'That's it, feel it caress your most sensitive parts. Feel it hugging you intimately.'[or]'Something to soak up all that juice you're making, and anything else you have to just let go. Relax and let [NameDesc of M] treat you to this.'[or]'Wiggle on down into this. Get intimate with it, because it's going to be wrapping you gently down there for a long time!'[at random][roman type][line break][one of]You lie there in quiet awe as [he of M] is slowly wrapping the diaper into place around you while [or]You obediently keep your legs raised in the air, being treated like a baby girl as [or]Shame rushes over you as you let this diaperslut toy with you during your diaper change, even as [at random] the fairy deep inside your [variable F][one of] thrusts and thrashes about wildly, making you squirm in pleasure! [or] wiggles seductively, pressing at very key places in you, igniting sparks in you![or] masturbates herself furiously inside of you, [his of a random fairy] pleasure spreading out through the passage of your [variable F]! [at random][BigNameDesc of M] continues pleasuring [himself of M] with one hand and diapering you with the other!".

To say SexResistFlav of (M - supporter-critchett) in (F - a fuckhole): [The player is resisting against your acts. How does that make your NPC act?]
	say "Even as the fairy continues pleasuring herself deep up your [variable F], [BigNameDesc of M] struggles gleefully to keep you pinned and pops [his of M] occupied hand back out of [his of M] diaper wetly. [big he of M] [one of]takes your pinned-together ankles and pushes them far upwards until they're almost past your head, folding you in half in the process and completely exposing your entire undercarriage. [big he of M] gives a long, sexual lick from your [asshole], up across your [vagina] and flicking across your clit! [or]spreads your legs apart and hooks [his of M] leg under you, scissoring you oddly with [his of M] massive, bloated diaper pressing into your crotch and squishing wetly. [big he of M] grinds [himself of M] on you powerfully, smushing you down into your own yet-unfastened diaper as if to drive you into your place! [or]takes the diaperfront between your legs and pulls it all the way up over you! It's almost in place! You struggle to escape, but [he of M] clamps your legs together around it, pinning it in place there, then pulls open the front of [his of M] own diaper, takes your feet, and slips them down inside! You feel the enormous squishy padding of hot, slimy girlcum trapping you there, while the diaper between your own legs just needs two simple tapes to seal you in one of your own![at random][speech style of M][line break][one of]'Bad girls get diapered! You're such a bad little girl! You have no choice, you're going in a diaper!'[or]'You're already assuming the position, [NameBimbo], and there's a diaper under you. There's only one way this ends!'[or]'Be a good girl, lie still, and get diapered, otherwise I'm going to diaper you again and again and again! Struggle if you want me to do that over and over to you!'[at random][roman type][line break][one of]You twist and flail, but it's useless: you're about to be diapered. [or][BigNameDesc of M] cannot be convinced to let you go. [big he of M] is intent on wrapping you up and making you to be like [him of M]! [or]You look down to see your embarrassing state. You lean back and sigh, unable to stop the aroused feelings coursing through you! [at random][one of]the fairy deep inside your [variable F] thrusts and thrashes about wildly, making you squirm in pleasure! [or] wiggles seductively, pressing at very key places in you, igniting sparks in you![or] masturbates herself furiously inside of you, [his of a random fairy] pleasure spreading out through the passage of your [variable F]! [at random][BigNameDesc of M] draws back from you, pulling up your feet to keep pinned in the air again as [he of M] thrusts [his of M] hand down [his of M] diaper again in trust that you'll be a good girl now and let [him of M] finish you off.".

To say ClimaxFlav of (M - supporter-critchett) in (F - a fuckhole):
	say "[BigNameDesc of M][']s eyes cross suddenly as [he of M] nears bringing [himself of M] to orgasm! [big he of M] casually grabs some baby powder and dusts it all over your crotch, giving you a baby soft scent and absolutely humiliating you. Then [he of M] [one of]grabs hold of the front of your diaper and pulls up between your legs as high as it will go, stretching well over your navel, squishing the super soft padding tightly to your crotch! [or]spreads your legs wide apart, resting your feet on the floor as [he of M] uses exaggerated motions to fold the diaper up between them and spread it out nice and flat across your lower abdomen. [or] convulses in a spasm, quivering as [he of M][']s about to cum. [big he of M] can barely control [his of M] hands as [he of M] crudely takes the front of the diaper and brings it up, twisted between your legs, and mashes it up against the front of your waist as [he of M] pants. Not wanting the discomfort of that, you untwist it and spread it out flat before you realize that you're helping [him of M]! [at random][BigNameDesc of M] pulls [his of M] slick hand back out and uses both to [one of]pull open the tape on one side, before bringing it into place to fasten. [big he of M] pulls open the other tape and pauses for just a moment as you hold your breath. [big he of M] dramatically brings it down solidly into place! [or]open the tapes on the back of your diaper. You're in trouble now! [big he of M] lets the front of your diaper fall back down between your legs and for a moment, it looks as if [he of M] is about to let you go, but you see orgasmic madness in [his of M] eyes and [he of M] quickly brings it back up and thrusts the tapes into place! [or]open the fastening tapes, kissing your right hip and bringing a tape to fasten that side, then kissing your left hip and taping that side, too, ever so gently and lovingly. [at random]You are now fully diapered!";
	say "[line break]The fairy inside of you seems to sense this and is going wild inside you! [BigNameDesc of M] and the fairy reach full orgasm at the same time, and the diaperslut [one of]drives [his of M] face into your freshly padded crotch and grinds [his of M] face into you[or]pulls up and presses [his of M] majestic diaper to your own, letting you feel it swell[or]swivels awkwardly into a 69 position over you, smothering your face with [his of M] hot, cum-swelling diaper and squeezing [his of M] hands into your crotch[at random] as [he of M] creams himself wildly, flooding [himself of M] with a [cascade] of girlhoney! The fairy inside of you erupts into an equally powerful orgasm and you feel [his of a random fairy] tiny body break down entirely into hot slime inside your [variable F] and [one of]leak back out of you to be the first filling of your fresh diaper! [or]moisturise your [variable F], coating it until you eventually absorb [him of a random fairy]... [or]oozes up further into your body to fill your middle! [at random]You reel from the strange, degrading experience.";
	let C be a random massive diaper;
	summon C cursed with quest.

[###INFLATION STUFF###]

To compute the flying player taunting of (M - supporter-critchett):
	if a random number from 1 to 6 is 1:
		say "[BigNameDesc of M] grins as [he of M] holds a hand to [his of M] various curves while appraising your new inflated ones.[line break][speech style of M]'[one of]Oh, you seem to be enjoying growing your assets more than I am! You look like twice the slut!'[or]Silly bean, you can[']t hide from me on the ceiling. Come on down here so we can get together more.'[or]You look like a big inflatable dolly! So cute, I just need to keep you and diaper you!'[roman type][line break][big he of M] pats [his of M] own enormous diaper with a distinct squishing sound for certain emphasis.[in random order][roman type][line break][if the humiliation of the player < 17500]You [one of]wince[or]shudder[or]cringe[purely at random] with shame.";
		humiliate 20.

To say LandingTaunt of (M - supporter-critchett):
	say "[BigNameDesc of M] giggles, amused.[line break][speech style of M]'[one of]What goes up, must go down... on me! Right? Standing offer[or]Aww, I was hoping to catch you in my honeypouch! Can you get back up and we'll try again? You won't regret it[in random order]!'[roman type][line break]";
	humiliate 50.

[###WATERSPORTS STUFF###]

To say ClothesPeeReaction of (M - supporter-critchett):
	if M is friendly:
		say "[BigNameDesc of M] looks pleasantly curious.[line break][speech style of M]'Sweetie, I think you're going to need a diaper. I'm not going to give you a choice if you don't do it yourself.'[roman type][line break]";
		FavourDown M by 2;
		if M is unfriendly, say "[big he of M] sizes you up before coming to a decision.[line break][speech style of M]'It's too late for you to be a big girl anymore. I'm going to have to show you what a diaper is for, missy!'[roman type][line break]";
	otherwise:
		say "[BigNameDesc of M] giggles.[line break][speech style of M]'[if M is interested]Too late, you wet yourself! Beg me to diaper you!'[otherwise]Well, look at you, such a mess! You're going in a diaper now! Will you go in mine? Or do you want one of your own?'[end if][roman type][line break][if M is uninterested]Uh-oh...[end if]";
		now M is interested.

To say GroundPeeReaction of (M - supporter-critchett):
	say "[ClothesPeeReaction of M]".

[###DIAPER STUFF###]

To say DiaperReaction of (M - supporter-critchett):
	if there is a currently visible diaper or the player is shameless:
		if M is unfriendly:
			say "[BigNameDesc of M] beams with pure joy as you wet your diaper in utter shame![line break][speech style of M]'[if M is interested]Wet, wet, wet! Grow, swell, bulge[otherwise]You're doing wonderful, sweetie! Wetter, bigger, more! I want you primed for some fun[end if]!'[roman type][line break]";
		otherwise:
			say "[speech style of M]'You look like a natural at this! I can't wait to have some diaper play with you!'[roman type][line break][BigNameDesc of M] rubs [his of M] enormously swollen diaper, promising you something that makes you gulp with trepidation.";
			FavourDown M;
			say "[speech style of M]'[if M is unfriendly]Ahhhn... I'm too horny and you're too hot and in need of a diaper. Lie down on the floor and raise those feet up in the air[otherwise]Oh, goddess, if you keep doing that, I'll... ohhh, I'll make it so worth your while. Do that again[end if]!'[roman type][line break]";
			if M is unfriendly, now M is interested;
		if the player is modest, say "[one of]You are so ashamed you wish your diaper would just open up and swallow you whole! [or][stopping]You turn bright red and refuse to look at [NameDesc of M] in the eye, dying of shame.";
		otherwise say "You turn bright red in embarrassment.";
	otherwise:
		say "It seems that [NameDesc of M] is unaware of what you've just done.".

To say RockingReactionSpeech of (M - supporter-critchett): [When your NPC sees them rocking on the rocking horse trap in the woods]
	say "[one of][line break][speech style of M]'Ohhh, aren't you a cute, precious darling!! Just like a good girl, rocking on horsey. Good girls get diapered!'[roman type][line break][or][BigNameDesc of M] pirouettes gracefully for a ponderously curved girl in nearly a meter-diameter squishy, massively leaking, crinkly capsule![line break][speech style of M]'Yay, you're on the Diaper Ride! Tell me all about what kind of soft wonderful padding is wrapping you when you get off finally, then I'll show you ways you can start soaking it with love!'[stopping]".

Part - Taegan

supporter-teagan is a supporter. supporter-teagan is female. The leftover-type of supporter-teagan is 204.

The supporter-name of supporter-teagan is "Teagan".

Figure of teagan is the file "NPCs/MultiFloor/Supporter/teagan1.png".
Figure of teagan interact 1 is the file "NPCs/MultiFloor/Supporter/teagan2.png".
Figure of teagan interact 2 is the file "NPCs/MultiFloor/Supporter/teagan3.png".
Figure of teagan cutscene 1 is the file "NPCs/MultiFloor/Supporter/teagan4.png".
Figure of teagan cutscene 2 is the file "NPCs/MultiFloor/Supporter/teagan5.png".
Figure of teagan cutscene 3 is the file "NPCs/MultiFloor/Supporter/teagan6.png".

To decide which figure-name is the friendly-monster-image of (M - supporter-teagan):
	decide on figure of teagan interact 2.

To decide which figure-name is the unfriendly-monster-image of (M - supporter-teagan):
	decide on figure of teagan interact 1.

To decide which figure-name is the monster-image of (M - supporter-teagan):
	decide on figure of teagan.

To say MonsterDesc of (M - supporter-teagan):
	say "You see a pair of immense caramel-coloured breasts, supported by a curvaceous elfin [man of M] with pale, platinum blonde hair. [big his of M] glacial blue eyes dart about in a predatory, lust-drunk fashion; a trait exemplified further by [his of M] maw of pearly-white fangs. [big he of M] wears almost nothing, save for the tattered remnants of what may have once been a dress, and some well-worn socks.".

To set up (M - supporter-teagan):
	reset M;
	now the monstersetup of M is 1;
	now the raw difficulty of M is 10; [+6 from credit spending]
	now the health of M is the maxhealth of M.

To decide which number is the outrage tolerance of (M - supporter-teagan):
	decide on 5. [-5 from credit spending]

To set up sex length of (M - supporter-teagan) in (B - face):
	set up sex length 5 of M in B. [+3 from credit spending]

Definition: supporter-teagan (called M) is willing to do vaginal:
	if face is actually occupied, decide yes;
	decide no.

Definition: supporter-teagan (called M) is willing to do anal:
	if face is actually occupied, decide yes;
	decide no.

Definition: supporter-teagan is able to remove cursed plugs: decide yes. [spent 2 credits]

Definition: supporter-teagan is butt slut immune: decide yes. [spent 2 credits]

Definition: supporter-teagan (called M) is fetish appropriate:
	if lactation fetish is 2, decide no;
	decide yes.

To say LeftoverDesc (N - 205):
	say "Teagan is lying here unconscious in a pool of [semen].".

To say DisapprovalFlav of (M - supporter-teagan): [This is when the player is in some way looking suddenly more lewd in front of the NPC, maybe because they pulled out their tits, or maybe because a trap pulled up their skirt, or jizzed on them, or similar.]
	say "[BigNameDesc of M] [one of]licks [his of M] lips and fondles [his of M] huge boobies as [he of M] watches you.[or]longingly stares at you, rolling [his of M] nipples in [his of M] fingers. [or]cradles [his of M] funbags in [his of M] arms as [he of M] watches you, giggling.[or]hefts [his of M] breast up, licking a drop of cream from [his of M] nipple while making eye contact with you.[in random order]".

To say CurtseyReactionFlav of (M - supporter-teagan):
	let K be a random worn currently visible knickers;
	unless K is nothing:
		say "[BigNameDesc of M] points and giggles.[line break][speech style of M]'Nice [ShortDesc of K]!'[roman type][line break]";
	otherwise:
		say "[BigNameDesc of M] grins and blows a kiss your way.[line break][speech style of M]'You thirsty, sweetheart?'[roman type][line break]".

To say BecomesAggressive of (M - supporter-teagan):
	say "[speech style of M]'[one of]Yeah! You better drink it, slut!'[or]Gawd, my tits are, like, so full! I can't take it anymore!'[in random order][roman type][line break][big he of M] assumes an aggressive stance!";
	alwayscutshow figure of teagan interact 1 for M.

To say AlreadyUnfriendlyPerception of (M - supporter-teagan): [The NPC has just spotted the player, and has already decided they're best used as a cumdump]
	say "[speech style of M]'[one of]Aren't you just, like, the cutest little thing? Open wide!'[or]Ohmigawd, just in time! I thought I was gonna have to waste, like, a bunch of milk!'[or]! Nnh, so full Lemme borrow your mouth for a minute!'[or]These udders aren't gonna drain themselves, sweetheart.'[in random order][roman type][line break]";
	alwayscutshow figure of teagan interact 1 for M.

to say FriendlySluttyPerception of (M - supporter-teagan): [The NPC has just spotted the player while the player looks slutty, but hasn't witnessed enough to decide to fuck them.]
	say "[speech style of M]'[one of]If you need something to drink besides cum, let me know, okay?.'[or]There's too many thirsty sluts around here, I can't decide...'[or]You look like you could use a drink... maybe next time, hmm?'[in random order][roman type][line break]";
	alwayscutshow figure of teagan interact 1 for M.

to say UnfriendlySluttyPerception of (M - supporter-teagan): [The NPC has just spotted the player while the player looks slutty, but hasn't had much of a chance to start disapproving of them yet.]
	say "[speech style of M]'[one of]The milking machine is too rough! But you you look like you're good with your tongue.'[or]Unnh, you're so slutty! Can't hold back. You, uh, better, like, leave!.'[or]Ohmigawsh, seeing you that way, it makes my nipples so hard!'[in random order][roman type][line break]";
	alwayscutshow figure of teagan interact 1 for M.

To say BoringPerception of (M - supporter-teagan): [The NPC has spotted the player who doesn't look slutty enough to decrease their friendliness]
	say "[speech style of M]'[one of]Have you seen any, like, thirsty bitches around here[or]Are you a guard or something? Where did all the sluts go[stopping]?'[roman type][line break]";
	alwayscutshow figure of teagan interact 2 for M.

To say IdentifiablePosterReactionFlav of (M - supporter-teagan):
	say "[BigNameDesc of M] stares at the poster with [his of M] hands covering [his of M] mouth.[line break][speech style of M]'I can't believe you're such a whore! I'd never let them take that kinda picture of me.'[roman type][line break]".

To say UnidentifiablePosterReactionFlav of (M - supporter-teagan):
	say "[speech style of M]'Oh wow, there's some next-level sluts strutting around here!'[roman type][line break]".

To say PresentFriendlyAcceptanceFlav of (M - supporter-teagan): [This is when the player offers a body part up to them and the NPC is still friendly, and accepts]
	say "[speech style of M]'Aww, you want some milk? C'mere.'[roman type][line break]".

To say PresentFriendlyRejectionFlav of (M - supporter-teagan): [This is when the player offers a body part up to them and the NPC is still friendly, and refuses because a) they orgasmed recently or b) Can't fuck that particular body part]
	say "[speech style of M]'[if presented-orifice is a potential target]Ugh, nope! My nipples are still tender!'[otherwise]Nuh-uh, no way!'[end if][roman type][line break]".

To say FriendlySexReleaseRefusalSpeech of (M - supporter-teagan): [The player has changed their mind and wants to end the friendly sex early. The NPC has decided to dominate the player and not let go so easily.]
	if the player is not able to speak, say "[speech style of M]'[one of]Quiet down! I'm enjoying this![or]Hold still or it's gonna squirt in your eye!'[or]Uh, what? We can talk when I'm finished.'[in random order][roman type][line break]";
	otherwise say "[speech style of M]'[one of]What? You can't stop now, or I'll squirt everywhere, silly!'[or]You're joking right? You can't just sip, you gotta drink at least a glass!'[at random][roman type][line break]".

To compute kneeling reaction of (M - supporter-teagan): [The player has got on their knees voluntarily while the NPC is aggressive.]
	say "[BigNameDesc of M] grins.[line break][speech style of M]'[one of]Good slut.'[or]What a good girl.'[or]Aw, thanks! Open wide.'[in random order][roman type][line break]";
	humiliate 75.

To say SubmissionFlav of (M - supporter-teagan): [The player has done something submissive like remove an item of clothing while the NPC is aggressive.]
	say "[BigNameDesc of M] massages [his of M] tits as [he of M] watches.[line break][speech style of M]'Can you, like, hurry it up? I'm about to spring a leak over here.'[roman type][line break]".

To compute delay of (M - supporter-teagan): [NPCs, when they're confident that the player can't escape, will sometimes get the player a chance to request a certain type of sex.]
	say "[BigNameDesc of M] cradles [his of M] huge, milky boobs.[line break][speech style of M]'I bet you can guess what I want, sugar.'[roman type][line break]".

To say PresentAcceptanceFlav of (M - supporter-teagan): [Your (aggressive) NPC has decided to do what the player suggested.]
	say "[BigNameDesc of M] grins.[line break][speech style of M]'Oh, cute! You're not as dumb as those other slags.'[roman type][line break]".

To say PresentRejectionFlav of (M - supporter-teagan): [Your (aggressive) NPC has decided to ignore the player's suggestion. NB that they may independently make the decision to do that thing anyway themselves, so it would be inaccurate to say that your NPC 'decides against doing that' or something.]
	say "[BigNameDesc of M] lets out a frustrated sigh.[line break][speech style of M]'Like, can't you see these big, swollen milkbags?'[roman type][line break]".

To compute the busy waiting of (M - supporter-teagan): [The NPC isn't able to do their thing right now because the player is busy with something boring, like resting in a hammock.]
	if a random number between 1 and 6 is 1, say "[BigNameDesc of M] paces anxiously as [he of M] continues to wait.".

To compute the default taunting of (M - supporter-teagan): [The NPC isn't able to do their thing right now because the player is busy with a trap or another NPC, but they expect the player will be free soon.]
	say "[BigNameDesc of M] watches, making no attempt to hide [his of M] excitement.".

To say SelectionFrustrated of (M - supporter-teagan): [The NPC has got tired of waiting!]
	say "[BigNameDesc of M] seems to look very frustrated, and then gives up.";
	bore M.

To compute the dildo stuck taunting of (M - supporter-teagan):
	if a random number between 1 and 3 is 1, say "[BigNameDesc of M] pinches and tugs [his of M] nipples, trickling milk down [his of M] front. [line break][speech style of M]'[one of]Gawd, how are you supposed to suck on my tits when you're stuck like that?[or]Have you tried, like, avoiding traps? Or, ew, you like getting caught in them?! [or]Ugh, stop goofing around! My titties need draining![or]Ohmigawd, I can't believe how dumb these players are...[in random order]!'[roman type][line break]".

To say angry punishment insult of (M - supporter-teagan): [The NPC is angry because the player wronged them (e.g. didn't swallow). They will now get their revenge, probably by stealing an item of clothing / jewellery.]
	say "[speech style of M]'Seriously? I can't believe you're so wasteful, you skank!.'[roman type][line break]".

To say MonsterTripAnnounceFlav of (M - supporter-teagan):
	say "[BigNameDesc of M] holds [his of M] breasts as [he of M] tries to trip you up!".

To say MonsterFailedTripFlav of (M - supporter-teagan):
	say "You manage to keep your balance.".

To say StrikingSuccessFlav of (M - supporter-teagan) on (B - a body part): [TargetName of B outputs something beginning with "on the", e.g. "on the ass"]
	say "[BigNameDesc of M] smacks you [TargetName of B]! Ouch!!".

To say StrikingFailureFlav of (M - supporter-teagan) on (B - a body part): [TargetName of B outputs something beginning with "on the", e.g. "on the ass"]
	say "[BigNameDesc of M] tries to smack you [TargetName of B] but you manage to swiftly dodge the blow!".

To say MindingOwnBusinessCombatFlav of (M - supporter-teagan): [Your NPC was minding their own business and not even looking at the player when they attacked]
	say "[big he of M] looks at you blankly with shock.[line break][speech style of M]'Wait what? You think you can take me?! Prepare yourself, [bitch]!'[roman type][line break]".

To say RudeAwakeningFlav of (M - supporter-teagan): [Your NPC was sleeping when the player attacked]
	say "[big he of M] wakes up, and angrily looks around for the cause of this rude awakening! ".

To say DamageReactHealthy of (M - supporter-teagan):
	say "[BigNameDesc of M] [one of]laughs condescendingly[or]smirks at you mockingly[at random].".

To say DamageReactDamaged of (M - supporter-teagan):
	say "[BigNameDesc of M] [one of]shrugs off the hit[or]takes the blow without staggering[at random].".

To say DamageReactTired of (M - supporter-teagan):
	say "[BigNameDesc of M] [one of]growls in anger[or]snarls with frustration[at random].".

To say DamageReactWeak of (M - supporter-teagan):
	say "[BigNameDesc of M] [one of]is struggling for breath[or]puts [his of M] hand on [his of M] belly as if [he of M] has a stitch[at random].".

To say DamageReactSubmissive of (M - supporter-teagan): [Hinting that the player might be able to turn the tables and fuck your NPC]
	say "[BigNameDesc of M] [one of]whimpers with pain[or]looks at you meekly as [he of M] catches [his of M] breath[at random].".

To say MovementBlock of (M - supporter-teagan):
	say "[BigNameDesc of M] manages to get in front of you and block your path, slowing down your movement!".

To say StandingBlock of (M - supporter-teagan):
	say "[BigNameDesc of M] grabs onto your [ShortDesc of hair] and stops you from standing up!".

To say BanishFleeFlav of (M - supporter-teagan):
	say "[speech style of M]'Gah! When's my... next... respawn...?!'[roman type][line break]Those are [NameDesc of M][']s final words before [he of M] drops to the ground, dead. After a couple of seconds, [his of M] body disappears like something out of TRON.".

To say SexResistSlapFlav of (M - supporter-teagan):
	say "[BigNameDesc of M] [one of]cackles[or]laughs deeply[or]chuckles[or]snorts[at random] at your [one of]fruitless display[or]vain efforts[or]pointless attempts[or]futile resistance[at random] before [if M is male and M is penetrating face]slapping you harshly on the cheek[otherwise if M is male and M is penetrating breasts]painfully slapping your [BreastDesc][otherwise]roughly spanking your [buttcheeks][end if] [one of]to get you to behave[or]in order to keep you under control[or]as punishment[or]to discourage further disobedience[at random].".

To say MonsterOfferRejectFlav of (M - supporter-teagan) to (T - a thing):
	say "[BigNameDesc of M] refuses.[line break][speech style of M]'Huh? Like, why would I want that?.'[roman type][line break]".

To compute sudden objectification of (M - supporter-teagan): [The player's appearance just jumped to completely unacceptable standards right in front of your NPC, and your NPC has noticed, and now wants to bang.]
	say "Something seems to change in the way [NameDesc of M] is looking at you. [line break][speech style of M]'[if M is penetrating a body part]Yes, that's right I'm the boss, and you're my little [whore]...'[otherwise if the player is monster fucked]So hot, it's making me all milky...'[otherwise]You know what? You look like you need a drink.'[end if][roman type][line break]".

To compute MasturbationReaction of (M - supporter-teagan):
	if M is awake:
		if M is penetrating a body part:
			if M is friendly-fucking:
				say "[BigNameDesc of M] grins, and starts thrusting even faster.";
			otherwise:
				say "[BigNameDesc of M] [if M is penetrating a fuckhole]spanks[otherwise]slaps[end if] you angrily. [line break][first custom style]'Did I give you permission to do that? This is supposed to be a punishment!'[roman type][line break]";
				PainUp 1;
				now wanking is 0;
		otherwise:
			say "[BigNameDesc of M] stares, wide-eyed.[line break][speech style of M]'[if M is friendly]Just can't help yourself, huh?'[otherwise]Okay okay, I know you're excited for more!'[end if][roman type][line break][big he of M] cups [his of M] overfilled titties in anticipation.";
			now M is interested;
			anger M.

To say EnemaFloorReactionFlav of (M - supporter-teagan): [When the player squirts an anal creampie / enema onto the ground in front of the NPC]
	say "[BigNameDesc of M] [if M is interested]looks disgusted[otherwise]turns to look at you with an expression of disgust[end if].[line break][speech style of M]'Ew, there's so much of it! You almost got some on me, stupid!'[roman type][line break][if the humiliation of the player < HUMILIATION-DISGRACED + 1000][one of]You turn a bright shade of red[or]You blush brightly with shame[or]You shiver with self-consciousness[or]You turn red-faced with shame[in random order].[end if]".

To say EnemaReactionFlav of (M - supporter-teagan) into (C - a clothing): [When the player squirts an anal creampie / enema into worn clothing in front of the NPC]
	say "[BigNameDesc of M] [if M is interested]looks disgusted[otherwise]turns to look at you with an expression of disgust[end if].[line break][speech style of M]'Wha ew! What's all that coming out of your butt?!'[roman type][line break][if the humiliation of the player < HUMILIATION-DISGRACED + 1000][one of]You turn a bright shade of red[or]You blush brightly with shame[or]You shiver with self-consciousness[or]You turn red-faced with shame[in random order].[end if]".

To compute facial sex of (M - supporter-teagan):
	compute facesit sex of M;
	StomachUp 2.

To compute facial climax of (M - supporter-teagan):
	compute facesit climax of M;
	StomachUp 2;
	if rectum > 0 or hunger mechanics is 1, StomachFoodUp 1;
	MilkTasteAddictUp 1.

To compute unique facesit climax effect of (M - supporter-teagan): [2 credits, doesn't sleep]
	say "[BigNameDesc of M] gets off of your face and lovingly wipes your mouth with one hand.";
	orgasm satisfy M.

[Oral]

To say CommencingFacesitFlav of (M - supporter-teagan): [The NPC forces her tits into the player's mouth]
	say "[BigNameDesc of M] gets you into a headlock and pulls your face into [his of M] tits! [big he of M] guides one of [his of M] fat, leaking nipples into your mouth and holds you there, forcing you to drink [his of M] breast milk!";
	cutshow figure of teagan cutscene 1 for M.

To say FacesitResisting of (M - supporter-teagan):
	say "[one of]You try as hard as you can to pull away, but [his of M] arm is firmly gripping your head![or]You try to pull up, but [he of M] is much too strong for your neck muscles to do anything![or]You flail with your legs but it doesn't make any difference![in random order]".

To say FacesitResistingResponse of (M - supporter-teagan): [The player is refusing to drink her milk. How does the NPC act?]
	say "[one of][BigNameDesc of M] doesn't seem to care about your futile protests as [his of M] milk splashes over your tongue and spills from the corners of your mouth.[or][BigNameDesc of M] sighs with relief and clutches your head tightly into [his of M] cleavage, squirting hot dairy against the back of your throat despite your feeble attempts to get away![or][BigNameDesc of M] grins as [he of M] kneads [his of M] engorged breast with the hand that isn't holding your head in place, forcing way too much milk into your mouth for you to handle! You cough and [he of M] laughs when breast milk squirts out of your nose! [or][BigNameDesc of M]clutches your hair with one hand and jerks [his of M] shoulders from side to side, slapping you across the face with [his of M] enormous, firm tits! [line break][speech style of M]'Ugh, just drink some already! They feel like they're gonna explode![in random order]".

To say FacesitSubmissionResponse of (M - supporter-teagan): [Normal breastfeeding. Explain what's happening!]
	say "[one of][BigNameDesc of M] watches with a bemused smirk as you willingly suckle the milkbags wobbling in your face.[or][BigNameDesc of M] gently guides your head to [his of M] other leaky breast, making sure you pay equal attention to both.[or][BigNameDesc of M] lets out a deep, content sigh and smiles down at you as you drink from [his of M] overfilled, quivering jugs. [or][BigNameDesc of M] delicately caresses the back of your head as you alternate sucking the sweet cream out of each of [his of M] throbbing nipples.[in random order]".

To say NearingClimaxFacesit of (M - supporter-teagan): [Next turn your NPC is going to cum! Give a hint to the player by changing up the flavour. Also this allows the climax to make more sense (rather than her sitting still and the player refusing to tongue, and then suddenly there's an orgasm!)]
	say "[one of][BigNameDesc of M] gasps loudly and tightens [his of M] grip on your head. The nipple in your mouth is almost as swollen and stiff as a tiny cock! [or][BigNameDesc of M] leans back so [he of M] clutches you tightly and emits a throaty moan as [he of M] mashes [his of M] titanic, squirting melons against your face![in random order]";
	cutshow figure of teagan cutscene 2 for M.

To say FacesitClimaxFlav of (M - supporter-teagan):
	say "[BigNameDesc of M] starts to squirm and pant with an animalistic fervour in [his of M] eyes as [he of M] orgasms from [his of M] breasts alone! Your face gets sprayed with [if the milk taste addiction of the player < 4]gross, [otherwise if the milk taste addiction of the player > 6]delicious, [end if]hot tit milk.[line break][speech style of M]'Yes, yes, oh fuck yes this is what I needed! Your face makes a damn good sex toy'[roman type][line break]";
	cutshow figure of teagan cutscene 3 for M.

[###INFLATION STUFF###]

To compute the flying player taunting of (M - supporter-teagan):
	if a random number from 1 to 6 is 1:
		say "[BigNameDesc of M] grins.[line break][speech style of M]'[one of]Ohmigosh, you look so pathetic up there...'[or]Hah, you fell for the Aeromancer's scheme! What a dumb whore!'[or]Fuck, you got pumped full of helium?! I got milk, not fair!'[in random order][roman type][line break][if the humiliation of the player < 17500]You [one of]wince[or]shudder[or]cringe[purely at random] with shame.";
		humiliate 20.

To say LandingTaunt of (M - supporter-teagan):
	say "[BigNameDesc of M] laughs at you.[line break][speech style of M]'[one of]Wow, so graceful[or]It's raining whores[in random order]!'[roman type][line break]";
	humiliate 50.

Part - Reiko

supporter-reiko is a supporter. supporter-reiko is female. The leftover-type of supporter-reiko is 205.

The supporter-name of supporter-reiko is "Reiko".

[Figure of reiko is the file "NPCs/MultiFloor/Supporter/reiko1.png".

To decide which figure-name is the monster-image of (M - supporter-reiko):
	decide on figure of reiko.]

To say MonsterDesc of (M - supporter-reiko):
	say "This [man of M] is naked apart from a chastity belt. It doesn't appear to have a visible lock. Could it be permanent?".

To set up (M - supporter-reiko):
	reset M;
	now the monstersetup of M is 1;
	now the raw difficulty of M is 4; [+0 from credit spending]
	now the health of M is the maxhealth of M.

To decide which number is the outrage tolerance of (M - supporter-reiko):
	decide on 10. [-0 from credit spending]

To set up sex length of (M - supporter-reiko) in (B - face):
	set up sex length 2 of M in B. [+0 from credit spending]

To say LeftoverDesc (N - 205):
	say "Reiko is lying here, hardly conscious, mindlessly pawing at the chastity cage blocking [his of supporter-reiko] crotch.".

Definition: supporter-reiko is fetish appropriate: decide no. [Incomplete]

Part - Jim

supporter-jim is a supporter. supporter-jim is male. The leftover-type of supporter-jim is 206.

The supporter-name of supporter-jim is "Jim the Invoker".

Figure of jim is the file "NPCs/MultiFloor/Supporter/jim1.jpg".

To decide which figure-name is the monster-image of (M - supporter-jim):
	decide on figure of jim.

To say MonsterDesc of (M - supporter-jim):
	say "This [man of M][']s robe, hat and the electricity crackling in the palm of [his of M] hand give [him of M] the air of a wizened wizard. [big his of M] full bushy facial hair, wiggling fingers and a robe that looks like a dressing gown give [him of M] the air of a lecherous pervert[if M is presenting as female]. Also, [he of M] has a penis[end if].".

To set up (M - supporter-jim):
	reset M;
	now the monstersetup of M is 1;
	now the raw difficulty of M is 4; [+0 from credit spending]
	now the health of M is the maxhealth of M.

To decide which number is the outrage tolerance of (M - supporter-jim):
	decide on 10. [-0 from credit spending]

To say LeftoverDesc (N - 206):
	say "Jim is lying here, unconscious.".

To say CurtseyReactionFlav of (M - supporter-jim):
	say "[BigNameDesc of M] smirks.[line break][speech style of M]'You're not the messiah - you're just a very naughty [boy of the player]!'[roman type][line break]".

To say BecomesAggressive of (M - supporter-jim):
	say "[speech style of M]'[one of]Right, I'll do you for that! Come here!'[or]I have you surrounded. I'm afraid I must not ask anyone to leave the room. No, I must ask nobody... no, I must ask everybody to... I must not ask anyone to leave the room. No one must be asked by me to leave the room. No, no one must ask the room to leave. I... I... ask the room shall by someone be left. Not. Ask nobody the room somebody leave shall I. Shall I leave the room? Everyone must leave the room... as it is... with them in it. Phew. Understand?'[or]Good evening. Tonight on [']Is There['] we examine the question, [']Is there anyone around these parts who can take my entire cock balls-deep?['] And here to discuss it is [NameBimbo].'[in random order][roman type][line break][big he of M] takes an offensive stance!".

To say AlreadyUnfriendlyPerception of (M - supporter-jim): [The NPC has just spotted the player, and has already decided they're best used as a cumdump]
	say "[speech style of M]'[if the class of the player is princess]None shall pass! I move for no [man of the player].'[otherwise if the player is gendered male and a random number between 1 and 2 is 1]I cut down trees, I skip and jump, I like to press wild-flowers. I put sissies in women's clothing, and ankle spreader bars!'[otherwise][one of]This morning, shortly after 11am, comedy struck this little whore on Bimbo Road. Sudden, violent comedy.'[or]I cut down trees, I eat my lunch, I go to the lavatory. On Wednesdays I find a hot slut, and give [him of the player] my [manly-penis] for [his of the player] tea!'[or]Have I got anything to feed you without cum? Well, cum, egg, sausage, and cum  thats not got much cum in it.'[or]Drop your panties, Sir William, I cannot wait [']till lunchtime!'[in random order][end if][roman type][line break]".

To say FriendlySluttyPerception of (M - supporter-jim): [The NPC has just spotted the player while the player looks slutty, but hasn't witnessed enough to decide to fuck them.]
	say "[speech style of M]'[one of]Uh, you have beautiful thighs.'[or]Do you-- do you want...do you want to come back to my place? Bouncy, bouncy!'[or]If I said you had a beautiful body, would you hold it against me? I am no longer infected.'[in random order][roman type][line break]".

To say UnfriendlySluttyPerception of (M - supporter-jim): [The NPC has just spotted the player while the player looks slutty, but hasn't had much of a chance to start disapproving of them yet.]
	say "[speech style of M]'[one of]And the beast shall be huge and black, and the eyes thereof red with the blood of living creatures, and the whore of Babylon shall ride forth on a three-headed serpent, and throughout the lands, there'll be a great rubbing of parts. Yeeah...'[or]I think it's time for me to join in with your [']training['].'[or]If I could walk that way I wouldn't need aftershave.'[in random order][roman type][line break]".

To say BoringPerception of (M - supporter-jim): [The NPC has spotted the player who doesn't look slutty enough to decrease their friendliness]
	say "[speech style of M]'[if the class of the player is princess]Oh, princess eh? Very nice. And how'd you get that, eh? By exploiting the workers. By hanging on to outdated imperialist dogma which perpetuates the economic and social differences in our society. We're living in a dictatorship! A self-perpetuating autocracy. Listen. Strange magic thrones distributing tiaras is no basis for a system of government. Supreme executive power derives from a mandate from the masses, not from some farcical chair-based ceremony. I mean, if I went around saying I was an emperor just because some moistened wench had lobbed a vibrating wand at me, they'd put me away!'[otherwise if the times-met of M is 0]What is the name of your... ravishing grace? Wait. Don't tell me. It's - it's something to do with moonlight. It's soft and gentle, warm and yielding... deeply lyrical and yet... tender and frightened like a tiny, white rabbit.[line break]'[NameBimbo]? What a beautiful name. What a beautiful... beautiful name.'[otherwise][one of]Apart from virtual reality, high-tech body transformation, extraordinarily attractive women, sex positivity, public nudity, underground sex-based game shows, a secret sex slave black market, funding for Icarus's art, and LGBT+ awareness, what has Nintendolls ever done for us?'[or]I object to all this sex on the computer. I mean, I keep falling off.'[in random order][end if][roman type][line break]".

To say IdentifiablePosterReactionFlav of (M - supporter-jim):
	say "[BigNameDesc of M] grins at you.[line break][speech style of M]'Well, you're a [man of the player] of the world, squire... you've been there, you've been around. Eh? know what I mean? Know what I mean? Nudge, nudge! Know what I mean? Say no more! A nod's as good as a wink to a blind bat, say no more, say no more!'[roman type][line break]".

To say UnidentifiablePosterReactionFlav of (M - supporter-jim):
	say "[speech style of M]'What Nintendolls blatantly fails to appreciate is that it's the sluts who are the problem.'[roman type][line break]".

To say PresentFriendlyAcceptanceFlav of (M - supporter-jim): [This is when the player offers a body part up to them and the NPC is still friendly, and accepts]
	say "[speech style of M]'[if the player is male and presented-orifice is asshole and pregnancy fetish is 1]You want to have babies?! But... you can't HAVE babies! I'm not oppressing you, [NameBimbo]. You haven't got a womb! Where's the foetus gonna gestate? You gonna keep it in a box?'[otherwise if presented-orifice is breasts]Well, ladies and gentlemen, I don't think any of our contestants tonight succeeded in encapsulating the intricacies of Proust's master-work. So, I'm going to give the award to the [boy of the player] with the biggest tits.'[otherwise]Sure, why not? There's nobody hotter around right now so I'll give you a run-over.'[end if][roman type][line break]".

To compute kneeling reaction of (M - supporter-jim): [The player has got on their knees voluntarily while the NPC is aggressive.]
	say "[BigNameDesc of M] grins.[line break][speech style of M]'[one of]This [man of the player] is [NameBimbo], lover of dicks. In a few moments, [he of the player] will have experienced the best [manly-penis] in the world, and, as a consequence, [he of the player] will die orgasming.'[in random order][roman type][line break]";
	humiliate 75.

To say SubmissionFlav of (M - supporter-jim): [The player has done something submissive like remove an item of clothing while the NPC is aggressive.]
	say "[BigNameDesc of M] looks judgingly at you.[line break][speech style of M]'You're a loony.'[roman type][line break]".

To compute delay of (M - supporter-jim): [NPCs, when they're confident that the player can't escape, will sometimes get the player a chance to request a certain type of sex.]
	say "[BigNameDesc of M] folds [his of M] arms.[line break][speech style of M]'What... is your quest?'[roman type][line break]".

To say PresentAcceptanceFlav of (M - supporter-jim): [Your (aggressive) NPC has decided to do what the player suggested.]
	say "[BigNameDesc of M] grins.[line break][speech style of M]'[if the player is male and presented-orifice is asshole]Yes, I'll try to examine this man! It's all right, I'm a doctor... actually I'm a gynaecologist, but this is my lunch hour.'[otherwise]A wise choice, monsieur. And now, how would you like it served? All mixed up together in a bucket? I can assure you, just because it is mixed up with all the other things, we would not dream of giving you less than the full amount.'[end if][roman type][line break]".

To say PresentRejectionFlav of (M - supporter-jim): [Your (aggressive) NPC has decided to ignore the player's suggestion. NB that they may independently make the decision to do that thing anyway themselves, so it would be inaccurate to say that your NPC 'decides against doing that' or something.]
	say "[BigNameDesc of M] thinks for a moment.[line break][speech style of M]'On second thought, let's not do that. It is a silly [if presented-orifice is orifice]hole[otherwise]body part[end if].'[roman type][line break]".

To compute the busy waiting of (M - supporter-jim): [The NPC isn't able to do their thing right now because the player is busy with something boring, like resting in a hammock.]
	say "[one of][if there is a live thing penetrating face][BigNameDesc of M] chatters to you as [he of M] watches.[line break][speech style of M]'You think you have it rough? Oh, what I wouldn't give to be fucked in the face. I sometimes hang awake at night dreaming of being fucked in the face.'[roman type][line break][otherwise][BigNameDesc of M] continues to wait.[end if][or][or][or][or][or][cycling]".

To compute the default taunting of (M - supporter-jim): [The NPC isn't able to do their thing right now because the player is busy with a trap or another NPC, but they expect the player will be free soon.]
	say "[BigNameDesc of M] watches, making a poor attempt to hide [his of M] glee.[one of][line break][speech style of M]'I think what's happened is terribly, terribly funny... er, tragic!'[roman type][line break][or][stopping]".

To say SelectionFrustrated of (M - supporter-jim): [The NPC has got tired of waiting!]
	say "[BigNameDesc of M] speaks to [himself of M].[line break][speech style of M]'THIS IS IT, JIM THE INVOKER! THIS IS YOUR MOMENT, JIM THE INVOKER! AT LAST, YOU'RE A MAN!'[line break][if the player is able to speak][roman type]You reply.[line break][variable custom style]'Go away!'[line break][speech style of M]'Righto.'[roman type][line break][BigNameDesc of M] [otherwise]But then [he of M] finds the pressure too much and turns to leave you alone.";
	bore M.

To compute the dildo stuck taunting of (M - supporter-jim):
	say "[one of]Seeing you suspended on a pole, [NameDesc of M] can't help but begin to recite [his of M] favourite song.[line break][speech style of M]'Cheer up, Brian. You know what they say:
Some things in life are bad.
They can really make you mad.
Other things just make you swear and curse.
When you're chewing on life's gristle,
Don't grumble. Give a whistle.
And this'll help things turn out for the best. And...
Always look on the bright side of life!'[roman type][line break][or][stopping]".

To say angry punishment insult of (M - supporter-jim): [The NPC is angry because the player wronged them (e.g. didn't swallow). They will now get their revenge, probably by stealing an item of clothing / jewellery.]
	say "[speech style of M]'Hello I wish to register a complaint.'[roman type][line break]".

To say MindingOwnBusinessCombatFlav of (M - supporter-jim): [Your NPC was minding their own business and not even looking at the player when they attacked]
	say "[big he of M] looks at you with an outraged expression.[line break][speech style of M]'Ah, now we see the violence inherent in the system[if the class of the player is princess]! Oh! Come and see the violence inherent in the system! Help, help, I'm being repressed[end if]!'[roman type][line break]".

To say DamageReactHealthy of (M - supporter-jim):
	say "[BigNameDesc of M] [one of]laughs condescendingly[or]smirks at you mockingly[at random].[line break][speech style of M]'[one of]You don't frighten us, English pig-dog! Go and boil your bottoms, [if the player is presenting as male]son[otherwise]daughter[end if] of a silly person! I blow my nose at you, so-called [NameBimbo], you and all your silly English K-n-n-n-n-n-n-n-niggits! Now get on your knees or I shall taunt you a second time[or]I don't want to talk to you no more, you empty-headed animal food trough wiper! I fart in your general direction! Your mother was a hamster and your father smelt of elderberries[cycling]!'[roman type][line break]".

To say DamageReactDamaged of (M - supporter-jim):
	say "[BigNameDesc of M] [one of]shrugs off the hit[or]takes the blow without staggering[at random].[line break][speech style of M]'[one of][']Tis but a scratch[or]I've had worse[cycling].'[roman type][line break]".

To say DamageReactTired of (M - supporter-jim):
	say "[BigNameDesc of M] keeps fighting.[line break][speech style of M]'[one of]Come on, you pansy!'[or]Come on, then.'[cycling][roman type][line break]".

To say DamageReactWeak of (M - supporter-jim):
	say "[BigNameDesc of M] keeps fighting.[line break][speech style of M]'[one of]It's just a flesh wound.'[or]I'm Invincible!'[cycling][roman type][line break]".

To say BanishFleeFlav of (M - supporter-jim):
	say "[BigNameDesc of M] staggers backwards and then [he of M] begins to speak.[line break][speech style of M]'All right, we'll call it a draw. [one of]Now, here's the meaning of life.'[roman type][line break][big he of M] produces an envelope which [he of M] opens and begins to read the contents out loud.[line break][speech style of M]'Well, it's nothing very special. Try to be nice to people, avoid eating fat, read a good book every now and then, get some walking in, and try and live together in peace and harmony with people of all creeds and nations. And, finally, here are some completely gratuitous flashing images of hardcore sex to annoy the censors and to hopefully spark some sort of controversy, which it seems is the only way these days to get the jaded, video-sated public off their fucking arses and back in the sodding cinema. Family entertainment? Bollocks. What they want is filth: people doing things to each other with dildo chainsaws during Tupperware parties, babysitters being sodomised with knitting needles by gay presidential candidates, vigilante groups strangling chicks, armed bands of video game critics exterminating mutant tentacle monsters. Where's the fun in pictures? Oh, well, there we are. Here's the theme music. Goodnight.'[@ commence animation of OralHypnoAnimation][or]Oh, I see. Running away, eh? You yellow bastard, come back here and take what's coming to you! I'll bite your legs off!'[purely at random][roman type][line break]Jolly music plays from an invisible source[if OralHypnoAnimation is g-animated], while flashing images of porn stars receiving facials from [manly-penis]s appear in the air[end if]. After a couple of seconds, [his of M] body disappears like something out of TRON.".

To say SexResistSlapFlav of (M - supporter-jim):
	say "[one of][speech style of M]'Shut up, you silly bitch. It's only a bit of fun.'[roman type][line break][or][or][cycling][BigNameDesc of M] [if M is male and M is penetrating face]slaps you harshly on the cheek[otherwise if M is male and M is penetrating breasts]painfully slaps your [BreastDesc][otherwise]roughly spanks your [buttcheeks][end if] [one of]to get you to behave[or]in order to keep you under control[or]as punishment[or]to discourage further disobedience[at random].".

To compute (M - a monster) stomping (N - supporter-jim): [For when the minotaur, xavier etc. encounters our NPC]
	if N is in the location of the player, say "[BigNameDesc of M] picks [NameDesc of N] off of the ground with two mighty hands and before you can say [']I'm not sure that's going to fit['] [he of M] has impaled [NameDesc of N] on [his of M] giant [DickDesc of M]. [BigNameDesc of N] shrieks in surprise and pain but there's absolutely nothing either of you can do before [NameDesc of M] is already climaxing, pumping gallons of [semen] into [NameDesc of N][']s rapidly swelling belly. As [NameDesc of N] inevitably passes out from the experience, [NameDesc of M] peels [NameDesc of N][']s body off of [his of M] [LongDickDesc of M] like a used condom and discards it on the ground, before turning to you, with a still-burning sexual hunger in [his of M] eyes.";
	otherwise say "You hear the sort of shriek you'd hear from a [man of N] if [he of N] was suddenly impaled on a giant [ShortDesc of M] penis, coming from [if N is nearby]nearby![otherwise]somewhere in the region![end if]";
	destroy N;
	let L be a random off-stage leftover;
	now L is in the location of M;
	now the leftover-type of L is the leftover-type of N.

To say MonsterOfferRejectFlav of (M - supporter-jim) to (T - a thing):
	say "[BigNameDesc of M] refuses to take the [ShortDesc of T].[line break][speech style of M]'I will not buy this [one of]record[or]TOBACCONIST'S[stopping], it is scratched.'[roman type][line break]".

To compute sudden objectification of (M - supporter-jim): [The player's appearance just jumped to completely unacceptable standards right in front of your NPC, and your NPC has noticed, and now wants to bang.]
	say "[BigNameDesc of M] [if M is penetrating a body part]smiles. [speech style of M]'I think I'm beginning to fall in love with you. It's silly isn't it?'[otherwise]is busy writing a letter.[line break][speech style of M]'Dear Sir, I wish to complain in the strongest possible terms about the song which had just broadcast about the Trap Quest player who wears women's clothes. Many of my best friends play Trap Quest and only a few of them are transvestites. Yours faithfully, Brigadier Sir Jim Arthur Strong (Ms.). PS: I have never kissed the editor of the Radio Times.'[roman type][line break][big he of M] then looks up.[speech style of M]'You've got a nice pair there, haven't you, love?'[end if][roman type][line break]".

To compute MasturbationReaction of (M - supporter-jim):
	if M is awake:
		if M is penetrating a body part:
			if M is friendly-fucking:
				say "[BigNameDesc of M] grins, and starts thrusting even faster.";
			otherwise:
				say "[BigNameDesc of M] [if M is penetrating a fuckhole]spanks[otherwise]slaps[end if] you angrily. [line break][first custom style]'What's wrong with a kiss, [boy of the player]? Hmm? Why not start it off with a nice kiss? ... You don't have to go leaping straight for the [if the player is female]clitoris[otherwise]penis[end if] like a bull at a gate. Suck the nipple. Stroking the thighs. Biting the neck. Nibbling the earlobe, uhh, kneading the buttocks, and so on and so forth. We have all these possibilities before we stampede towards the [if the player is female]clitoris[otherwise]penis[end if], [NameBimbo].'[roman type][line break]";
				PainUp 1;
				now wanking is 0;
		otherwise:
			say "[BigNameDesc of M] turns to an imaginary sex education class.[line break][speech style of M]'The purpose of foreplay is to cause the vagina to lubricate, so that the penis can penetrate more easily. And, of course, to cause the man's penis to erect and har... den!'[roman type][line break][big he of M] prepares to fuck you.[line break][speech style of M]'Uhh, we'll take the foreplay as read, if you don't mind, dear.'[roman type][line break]";
			now M is interested;
			anger M.

To say EnemaFloorReactionFlav of (M - supporter-jim): [When the player squirts an anal creampie / enema onto the ground in front of the NPC]
	say "[BigNameDesc of M] [if M is interested]looks disgusted[otherwise]turns to look at you with an expression of disgust[end if].[line break][speech style of M]'Ms. [NameBimbo], if you don't mind me saying so, you're badly in need of an expensive course of psychiatric treatment. Now, I'm not going to say that a trip to our zoo will cure you, but it will give hundreds of lower-paid workers a good laugh. I'm afraid our regular psychiatrist hasn't come round this morning, and I've got an ego block, which is in turn making my wife over-assertive and getting us both into a state of depressive neurosis.'[roman type][line break]".

To say EnemaReactionFlav of (M - supporter-jim) into (C - a clothing): [When the player squirts an anal creampie / enema into worn clothing in front of the NPC]
	say EnemaFloorReactionFlav of M.

[###SUPPORTERS WITH A PENIS ONLY###]

To say SexDollPerception of (M - supporter-jim): [The NPC has just spotted the player, and the player is currently a sex doll. The NPC is going to turn immediately unfriendly and demand sex.]
	say "[speech style of M]'[one of]This sex doll, it doesn't know when it's getting fucked! It doesn't know when it's about to get fucked, either. It has no sort of sensory apparatus'[or]Miss Sex Doll, there's nothing wrong with you that an expensive operation can't prolong.'[in random order][roman type][line break]".

[Oral]

To say SwallowDemand of (M - supporter-jim):
	say "[speech style of M]'Every sperm is sacred, every sperm is great. If a sperm is wasted, Jim gets quite irate!'[roman type][line break]".

[Titfucks]

To say BreastsPenetrationFlav of (M - supporter-jim):
	say "[BigNameDesc of M] takes [his of M] [DickDesc of M] and moves it towards your chest. [if the largeness of breasts > 8][speech style of M]'O Lord! Ooh, you are so big! So absolutely huge. Gosh, we're all really impressed down here, I can tell you.'[roman type][line break][end if]You watch in silence as [he of M] pushes forward, using the tight gap in between your boobs as a makeshift fuckhole. [if the titfuck addiction of the player < 5]You hold your body still and try to ignore the brutish grunts as [he of M] begins to thrust in and out of your [BreastDesc][otherwise]You instinctively bring your hands to your [BreastDesc], and begin to massage [his of M] [DickDesc of M] by moving them up and down with your hands as fast and powerfully as you can[end if].".

To say CleavageClimaxFlav of (M - supporter-jim):
	say "[BigNameDesc of M] ejaculates, covering your [ShortDesc of breasts] in [his of M] [semen]![line break][speech style of M]'My nipples explode with delight!'[roman type][line break]".

[Vaginal & Anal]

To say PrepTaunt of (M - supporter-jim) in (F - asshole):
	say "[speech style of M]'Listen buster! In Reykjavik it is dark for eight months of the year, and it's cold enough to freeze your wrists off and there's only golly fish to eat. Administrative errors are bound to occur in enormous quantities. Look at this  it's all a mistake. It's a real pain in the sphincter!'[roman type][line break]".

To say PrepTaunt of (M - supporter-jim) in (F - vagina):
	say "[speech style of M]'First shalt thou take out the Holy Cock. Then shalt thou count three holes, no more, no less. Three shall be the number thou shalt count, and the number of the counting shall be three. Four shalt thou not count, neither count thou two, excepting that thou then proceed to three. Five is right out. Once the number three, being the third number, be reached, then thrust thou thy Holy Penis of Antioch towards thy foe, who, being slutty in My sight, shall love it.'[roman type][line break]".

To say VaginalVirginityTaunt of (M - supporter-jim):
	say "[speech style of M]'We, the People's Front of Judea, brackets, official, end brackets, do hereby convey our sincere fraternal and sisterly greetings to you, [NameBimbo], on this, the occasion of your breaking in. Your cherry popping will stand as a landmark in the continuing struggle to liberate the parent land from the hands of the Roman imperialist aggressors, excluding those concerned with drainage, medicine, roads, housing, education, viticulture and any other Romans contributing to the welfare of Jews of both sexes and hermaphrodites...'[roman type][line break]".

To say CondomAcceptFlav of (M - supporter-jim):
	if the condom resistance of M > 0, say "[BigNameDesc of M] frowns, but then takes the condom and sheathes [his of M] [manly-penis].";
	otherwise say "[BigNameDesc of M] [one of]smiles[or]grins wordlessly[or]smirks[at random] and takes a condom. Discarding the wrapper, [he of M] rolls it down the length of [his of M] [manly-penis]. You stare, [one of][if the semen taste addiction of the player > 13]hypnotised, eagerly licking your lips[otherwise if the semen taste addiction of the player > 6]hypnotised, unconsciously licking your lips[otherwise]disgustedly curling your upper lip[end if][or]unable to [if the player is a pervert and the player is not a nympho]bring yourself to [end if]look away[or]your mouth opening unconsciously[or][if the player is not a pervert]without a shred of enthusiasm[otherwise]with envy[end if], as the rubber makes intimate contact with every inch of the massive tool[or]as the gleaming latex makes every bump and vein glisten [if the player is not a pervert]unappealingly[otherwise]temptingly[end if][at random].".

To say CondomRejectFlav of (M - supporter-jim):
	say "[BigNameDesc of M] begins singing in response.[line break][speech style of M]'Every sperm is sacred, every sperm is good. God needs every single sperm in your neighbourhood!'[roman type][line break]Looks like [he of M][']s going in bare...".

To say CondomPieFlav of (M - supporter-jim) in (F - a fuckhole):
	say "[BigNameDesc of M] ejaculates [his of M] entire load into the condom! You can feel the tip bulging and ballooning inside of you. [big he of M] narrates to an imaginary camera behind you.[line break][speech style of M]'But despite the efforts of Protestants to promote the idea of sex for pleasure, children continue to multiply everywhere.'[roman type][line break]".

To say CondomPinFlav of (M - supporter-jim) on (C - a clothing):
	say "[speech style of M]'When Martin Luther nailed his protest up to the church door in 1517, he may not have realised the full significance of what he was doing, but four hundred years later, thanks to him, my dear, I can wear whatever I want on my John Thomas. And Protestantism doesn't stop at the simple condom. Oh, no! I can force you to wear this magical one afterwards if I want. Sheaths that are designed not only to protect but also to enhance the glorification of sexual congress.'[roman type][line break]Before you can stop [him of M], [NameDesc of M] presses the [one of]newly created and now used [or]strongly-smelling [or]wobbling, semen-swollen [or][or][cycling]condom to your [C]. After giving you a final mischievous grin, [he of M] yawns, lies back, and falls asleep.".

To say CreampieFlav of (M - supporter-jim) in (F - a fuckhole):
	say "[BigNameDesc of M] moans with pleasure as [he of M] ejaculates [his of M] [if the girth of M < 5]smallish [otherwise if the girth of M > 8]gargantuan [otherwise if the girth of M > 6]huge [end if]load into your [variable F]! [big he of M] grips your hips tightly as [he of M] keeps his [DickDesc of M] firmly lodged as deep as it can go inside you and you can feel it constantly twitching as [he of M] cums.[line break][speech style of M]'[if F is vagina]Hindu, Taoist, Mormon spill theirs just anywhere, but God loves those who treat their semen with more care[otherwise]Did that hurt? Tough titty if it did, you nasty, spotted prancer[end if]!'[roman type][line break]Having thoroughly drained [his of M] balls inside of you, [his of M] [DickDesc of M] pops out as [he of M] lies backwards and quickly falls into a well-earned sleep.".

To compute labour to (M - supporter-jim): [This can't happen until father material is switched to yes]
	if M is regional and M is alive:
		compute pregnancy clothing displacement;
		say "[PregFlav][if the father is in the location of the player][BigNameDesc of M][otherwise][BigNameDesc of M] appears almost as if on cue! [big he of M][end if] kneels down on one knee and delivers the human baby. [big he of M] takes it into [his of M] arms and begins to cradle it. [if the player is able to speak]You ask[line break][variable custom style]'Is it a boy or a girl?[line break][speech style of M]'Now, [otherwise][speech style of M]'What do you mean [']Is it a boy or a girl?['] [end if]I think it's a little early to start imposing roles on it, don't you? Now, a word of advice. You may find that you suffer for some time a totally irrational feeling of depression. PND is what we doctors call it. So it's lots of happy pills for you, and you can find out all about the birth when you get home. It's available on Betamax, VHS, and Super 8..'[roman type][line break]Without giving you any of the [']happy pills['] [he of M] just promised, [he of M] leaves you to recover from your ordeal.";
		if the father is in the location of the player:
			say "For some reason, you are filled with a sense of deep fulfilment. You feel great!";
			StrengthUp 1;
			DexUp 1;
			IntUp 1;
	otherwise if M is alive:
		Delay Labour.

To say FirstResponse of (M - supporter-jim):
	say "[speech style of M]'I... am an invoker. By what name am I known? There are some who call me... [']Jim[']?'[roman type][line break]".

To say DefaultGreeting to (M - supporter-jim):
	say "[variable custom style]'Greetings, Jim the Invoker.'[roman type][line break]".

[###INFLATION STUFF###]

To compute the flying player taunting of (M - a supporter): [####Selkie: Is this supposed to be supporter-jim?]
	if a random number from 1 to 6 is 1:
		say "[BigNameDesc of M] grins.[line break][speech style of M]'[one of]Oh, [NameBimbo]! All you think about is balloons. All you talk about is balloons. Your beautiful house is full of bits and pieces of balloons. Your books are all about balloons, every time you sing a song, it is in some way obliquely connected with balloons... Everything you eat has to have 'balloon' incorporated in the title. Your dogs are all called Balloono. You tie balloons to your ankles in the evenings!'[or]You duck down and shout, 'Hey! Balloons!' when there are none about. Your whole life is becoming obsessively balloonic, you know... Oh-h-h! Why do I have to hang from this bloody gas bag all day?'[cycling][roman type][line break]";
		humiliate 20.

[###WATERSPORTS STUFF###]

To say ClothesPeeReaction of (M - supporter-jim):
	say "[BigNameDesc of M] turns to an imaginary camera.[line break][speech style of M]'This is the planet Algon, fifth world in the system of Aldebaran, the Red Giant in the constellation of Sagittarius. Here an ordinary cup of drinking chocolate costs four million pounds, an immersion heater for the hot-water tank costs over six billion pounds, and a pair of split-crotch panties would be almost unobtainable.'[roman type][line break]";
	if M is friendly:
		FavourDown M by 2;
		if M is unfriendly, say BecomesAggressive of M;
	otherwise if M is uninterested:
		say "[big he of M] gestures towards you.[line break][speech style of M]'This slut has just pissed [his of the player] pants, in order to get my attention once again.'[roman type][line break]Uh-oh...";
		now M is interested.

To say GroundPeeReaction of (M - supporter-jim):
	say "[BigNameDesc of M] turns to an imaginary camera.[line break][speech style of M]'We would like to apologize for the way in which [men of the player] are represented in this programme. It was never our intention to imply that [men of the player] are crabby, ulcerous, little perverse vermin with furry legs and an excessive addiction to [if alcohol fetish is 1]alcohol[otherwise]degradation[end if] and certain explicit sexual practices which some people might find offensive. We are sorry if this impression has come across.'[roman type][line break]";
	if M is friendly:
		FavourDown M by 2;
		if M is unfriendly, say BecomesAggressive of M;
	otherwise if M is uninterested:
		say "Uh-oh...";
		now M is interested.

To say UrinationFlav of (M - supporter-jim):
	say "[BigNameDesc of M] points [his of M] genitals towards your face. A golden stream of [urine] shoots out, headed straight for you!".

[To say PissDrinkThreat of (M - supporter-jim):
	say "[speech style of M]'[one of]You'd better drink this like a good toilet, or you won't like what comes next.'[or]You'd better make sure every last drop goes down your throat, [bitch].'[in random order][roman type][line break]".]

[###DIAPER STUFF###]

To say DiaperReaction of (M - supporter-jim):
	if there is a currently visible diaper or the player is shameless or M is concealment immune:
		if M is unfriendly:
			say "A mocking grin appears on [NameDesc of M][']s face.[line break][speech style of M]'[if M is interested]Is that how I make you feel[otherwise]Haha, all I have to do is be in the same room as you and you wet yourself in fear[end if]?'[roman type][line break]";
		otherwise:
			say "[speech style of M]'[if there is a worn messed knickers]I told you to lay off the beans, you whore!'[otherwise]Wow, just like a big baby.'[end if][roman type][line break][BigNameDesc of M] can't suppress [his of M] smile.";
			FavourDown M;
			say "[speech style of M]'[if M is unfriendly and there is a worn messed knickers]You are hereby charged where you did wilfully take part in a strange fetish. That is a piss, poop, or voluminous excretion of a sexual nature, with intent to cause grievous mental confusion to the Great Bimbacian public[otherwise if M is unfriendly]You are hereby charged where you did wilfully take part in a strange fetish. That is a piss, whizz, or urination of an sexual nature, with intent to cause grievous mental confusion to the Great Bimbacian public[otherwise]One of these days I'm going to decide to take you into my own [']care['], if you're not careful[end if].'[roman type][line break]";
			if M is unfriendly, now M is interested;
		if the player is modest, say "[one of]You are so ashamed you wish the ground would just open up and swallow you. [or][stopping]You turn bright red and refuse to look at [NameDesc of M] in the eye.";
		otherwise say "You turn bright red.";
	otherwise:
		say "It seems that [NameDesc of M] is unaware of what you've just done.".

To say RockingReactionSpeech of (M - supporter-jim): [When your NPC sees them rocking on the rocking horse trap in the woods]
	say "[one of][line break][speech style of M]'[big he of the player][']s a Knight of the Kid's Table, [he of the player] rocks on [his of the player] horse whenever [he of the player][']s able. [big he of the player] dons booties and cute diapees and crawls when [he of the player][']s unstable, [he of the player] dines well here in Babelot, [he of the player] eats ham and jam and Spam a lot.[paragraph break][big he of the player]'s a Knight of the Kid's Table, [his of the player] [if diaper messing >= 3]poops are[otherwise]padding is[end if] for-mi-dable. But many times [he of the player][']s given rhymes that are quite un-sing-able, [he of the player][']s opera mad in Camelot, [he of the player] sings from the diaphragm a lot. Emotionally [he of the player][']s quite unstable, Quite impossible to disable. Between [his of the player] quests [he of the player] sucks on chests and views cartoons on cable[paragraph break]It's a busy life in Babelot... I have to push the pram a lot.'[roman type][line break][or][stopping]".

Part - Misako

supporter-misako is a supporter. supporter-misako is female. The leftover-type of supporter-misako is 207.

The supporter-name of supporter-misako is "Misako".

Definition: supporter-misako is a groper: decide no.

Figure of misako 1 is the file "NPCs/MultiFloor/Supporter/misako1.jpg".
Figure of misako 2 is the file "NPCs/MultiFloor/Supporter/misako2.jpg".

To decide which figure-name is the monster-image of (M - supporter-misako):
	if the health of M >= (the maxhealth of M * 2) / 3, decide on figure of misako 1;
	decide on figure of misako 2.

To say MonsterDesc of (M - supporter-misako):
	say "This [man of M] is wearing a black latex bra, hood, and thigh high boots. The hood appears to cover [his of M] eyes, but since [he of M] seems to be able to wander around without bumping into walls, it's clear [he of M] has some amount of limited vision.[paragraph break][big he of M] is stuck in a lot of bondage: black bondage straps connect a metal collar to thick wristcuffs which are in turn tightly connected to a leather chastity belt. Both the front and rear of the chastity belt have protrusions with several red LEDs going around the outside, indicating that [he of M] likely has remotely controlled vibrators inserted into both [his of M] pussy and asshole.[paragraph break]A pink ballgag is stuck in [his of M] mouth, which makes all of [his of M] speech rather muffled and at times barely intelligible.";
	if M is defeated, say "The cursed chastity device's vaginal vibrator is repeatedly bringing [him of M] to near climax with powerful vibrations, before switching to the anal vibrator for the last bit, and then making sure to shut off instantly at the moment of climax, to ensure that the anal orgasm is closer to denial torture than true pleasurable release. It looks like this has happened countless times already, and [NameDesc of M] is just a moaning, writhing mess on the floor, unable to string two coherent words together.";
	otherwise say "[big he of M] looks rather displeased about [his of M] predicament. One might even say... desperate.".

To say LeftoverDesc (N - 207):
	say "[BigNameDesc of supporter-misako] is lying here, unconscious, [semen] slowly oozing out of [his of supporter-misako] gaped asshole through the hole torn in [his of supporter-misako] chastity belt. [big his of supporter-misako] cursed chastity belt is still in place.".

To say CurtseyReactionFlav of (M - supporter-misako):
	if there is a worn chastity cage, say "[BigNameDesc of M][']s eyes grow sad.[line break][speech style of M]'Oh, you're locked up too? We're both doomed to go crazy, aren't we...'[roman type][line break]";
	otherwise say "[BigNameDesc of M] wrinkles [his of M] nose.[line break][speech style of M]'Yes, I get it, you can play with yourself whenever you want. Please don't taunt me!'[roman type][line break]".

To set up (M - supporter-misako):
	reset M;
	now the monstersetup of M is 1;
	now the raw difficulty of M is 4; [+0 from credit spending]
	now the health of M is the maxhealth of M.

To decide which number is the outrage tolerance of (M - supporter-misako):
	decide on 10. [-0 from credit spending]

Definition: supporter-misako is willing to do vaginal: decide no.
Definition: supporter-misako is willing to urinate: decide no.

To say DisapprovalFlav of (M - supporter-misako): [This is when the player is in some way looking suddenly more lewd in front of the NPC, maybe because they pulled out their tits, or maybe because a trap pulled up their skirt, or jizzed on them, or similar.]
	say "[BigNameDesc of M][']s mouth quivers.[line break][speech style of M]'Please don't tempt me!'[roman type][line break]".

To say BecomesAggressive of (M - supporter-misako):
	say "[speech style of M]'That's it... I just can't take it any more... maybe if we grind together I can get something... anything!'[roman type][line break][big he of M] takes an offensive stance[one of]! ...Well, at least as offensive as [he of M] is capable of...[or]![stopping]".

To say AlreadyUnfriendlyPerception of (M - supporter-misako): [The NPC has just spotted the player, and has already decided they're best used as a cumdump]
	say "[speech style of M]'You again... maybe this time I'll be able to feel something. Please, don't fight back.'[roman type][line break]".

To say FriendlySluttyPerception of (M - supporter-misako): [The NPC has just spotted the player while the player looks slutty, but hasn't witnessed enough to decide to fuck them.]
	say "[speech style of M]'[one of]Everything here is so sexy... I don't know how long I can go looking at people like you without being able to touch myself. It's just too much!'[or]Please, if I keep seeing you like this, and getting so turned on... I think I'm going to go crazy...'[stopping][roman type][line break]".

To say UnfriendlySluttyPerception of (M - supporter-misako): [The NPC has just spotted the player while the player looks slutty, but hasn't had much of a chance to start disapproving of them yet.]
	say BecomesAggressive of M.

To say BoringPerception of (M - supporter-misako): [The NPC has spotted the player who doesn't look slutty enough to decrease their friendliness]
	say "[speech style of M]'[one of]Ahh, please don't look at me! I don't usually dress like this. This belt is cursed, so I can't take anything off!'[or]You again. No, I don't enjoy this! I just haven't found a way to remove the curse yet.'[or]Yes, I'm still around too, still hunting for a powerful enough magic to remove my belt. I'm starting to think it doesn't exist...'[or]Oh it's you again. I've lost hope of ever escaping this metal prison. My poor wonderful clit, how I long to be able to touch you, to feel you again...'[stopping][roman type][line break]".

To say UnidentifiablePosterReactionFlav of (M - supporter-misako):
	say "[speech style of M]'Wow, what a disgusting, shameless slut. Still, I'd rather be in [his of the player] position than permanently stuck in chastity...'[roman type][line break]".

To say PresentFriendlyAcceptanceFlav of (M - supporter-misako): [This is when the player offers a body part up to them and the NPC is still friendly, and accepts]
	say "[BigNameDesc of M][']s eyes light up.[line break][speech style of M]'Yes... yes, maybe if we grind together, I'll finally be able to feel something!'[roman type][line break]".

To say PresentFriendlyRejectionFlav of (M - supporter-misako): [This is when the player offers a body part up to them and the NPC is still friendly, and refuses because a) they orgasmed recently or b) Can't fuck that particular body part]
	say "[speech style of M]'[if presented-orifice is a potential target]Stop trying to give me hope. Nothing works!'[otherwise]How would that help me? My pussy is locked away!'[end if][roman type][line break]".

To say FriendlySexReleaseRefusalSpeech of (M - supporter-misako): [The player has changed their mind and wants to end the friendly sex early. The NPC has decided to dominate the player and not let go so easily.]
	say "[speech style of M]'[one of]No, no, we have to keep trying!'[or]No, it's close to working! I think I can almost feel something!'[at random][roman type][line break]".

To compute kneeling reaction of (M - supporter-misako): [The player has got on their knees voluntarily while the NPC is aggressive.]
	say "[BigNameDesc of M] smiles happily.[line break][speech style of M]'Thank you, thank you so much!'[roman type][line break]";
	humiliate 75.

To say SubmissionFlav of (M - supporter-misako): [The player has done something submissive like remove an item of clothing while the NPC is aggressive.]
	say "[BigNameDesc of M] tries to rub [himself of M] through [his of M] belt as [he of M] watches.[line break][speech style of M]'That's it, keep going...'[roman type][line break]".

To compute delay of (M - supporter-misako): [NPCs, when they're confident that the player can't escape, will sometimes get the player a chance to request a certain type of sex.]
	say "[BigNameDesc of M] squats over you, eagerly soaking in your entire body.[line break][speech style of M]'So, how should we try this?'[roman type][line break]".

To say PresentRejectionFlav of (M - supporter-misako): [Your (aggressive) NPC has decided to ignore the player's suggestion. NB that they may independently make the decision to do that thing anyway themselves, so it would be inaccurate to say that your NPC 'decides against doing that' or something.]
	say "[BigNameDesc of M] frowns.[line break][speech style of M]'No, I think this will work better...'[roman type][line break]".

To compute the busy waiting of (M - supporter-misako): [The NPC isn't able to do their thing right now because the player is busy with something boring, like resting in a hammock.]
	if a random number between 1 and 6 is 1, say "[BigNameDesc of M] continues to wait, rubbing [himself of M] as close as [he of M] can reach to [his of M] pussy as [he of M] does.".

To compute the dildo stuck taunting of (M - supporter-misako):
	say "[one of][BigNameDesc of M] rubbing [himself of M] as close as [he of M] can reach to [his of M] pussy, trying to feel something[line break][speech style of M]'I wish I could have a dildo impale my pussy. Even the shame of that would be better than no feeling at all...'[roman type][line break][or][stopping]".

To say StrikingSuccessFlav of (M - supporter-misako) on (B - a body part): [TargetName of B outputs something beginning with "on the", e.g. "on the ass"]
	say "[BigNameDesc of M] smacks your [TargetName of B]! Ouch!!".

To say StrikingFailureFlav of (M - supporter-misako) on (B - a body part): [TargetName of B outputs something beginning with "on the", e.g. "on the ass"]
	say "[BigNameDesc of M] tries to smack your [TargetName of B] but you manage to swiftly dodge the blow!".

To say DamageVibeConversion of (M - supporter-misako):
	say "[one of][bold type][BigNameDesc of M][bold type][']s bodysuit seems to somehow absorb the hit! In the next moment, [NameDesc of M][bold type] shrieks in surprise as a powerful vibration can be heard from where [his of M] asshole must be. [roman type]It only lasts a few seconds but is enough to cause [his of M] legs to shake and [his of M] hands to rush to [his of M] backside, scrabbling in vain to find a way to make it stop.[line break][speech style of M]'What the hell?! No, no, not my ass! I don't want to cum from my ass! Now I understand why the witch warned me about what will happen if I cum from my ass. I can't let that happen or my cursed bodysuit will... um... oh god... no... NO!'[roman type][line break][big he of M] turns back to you, a mixture of shame, arousal and fury on [his of M] face.[line break][speech style of M]'You [bitch]! There's no way I'll let you make me cum from my ass!'[roman type][line break][or]Once again [NameDesc of M][']s bodysuit absorbs the blow and converts it into loud, powerful vibrations inside [his of M] asshole. [stopping]";

To say MindingOwnBusinessCombatFlav of (M - supporter-misako): [Your NPC was minding their own business and not even looking at the player when they attacked]
	say "[DamageVibeConversion of M][big he of M] leaps towards you, ready to fight with everything [he of M][']s got!".

To say RudeAwakeningFlav of (M - supporter-misako): [Your NPC was sleeping when the player attacked]
	say MindingOwnBusinessCombatFlav of M.

To say DamageReactHealthy of (M - supporter-misako):
	say "[DamageVibeConversion of M][one of][big he of M] growls with anger[or]howls in frustration[cycling]!".

To say DamageReactDamaged of (M - supporter-misako):
	say "[DamageVibeConversion of M][big his of M] breathing is heavy but regular.".

To say DamageReactTired of (M - supporter-misako):
	say "[DamageVibeConversion of M][BigNameDesc of M] [one of]squeals with shameful pleasure, and then grinds [his of M] teeth together with determination[or]emits a high pitched whine, and does a panicked dance on the spot[at random].".

To say DamageReactWeak of (M - supporter-misako):
	say "[DamageVibeConversion of M][BigNameDesc of M] [one of]whimpers as [his of M] legs shake uncontrollably[or]breathes heavily and irregularly. [big his of M] eyes look glazed over[at random][one of]. [big he of M][']s close[or][stopping].".

To say DamageReactSubmissive of (M - supporter-misako): [Hinting that the player might be able to turn the tables and fuck your NPC]
	say DamageReactWeak of M.

To compute automatic banishment of (M - supporter-misako):
	say "[DamageVibeConversion of M][BigNameDesc of M] drops to [his of M] knees as [he of M] screams[line break][speech style of M]'Oh god, oh god, oh god, I'm cumming, I'm coming from my ass...!'[roman type][line break]And at the instant [he of M] stars to cum the vibrations suddenly shut off, leaving [him of M] flopping on the ground wildly with a frustrating, shameful and unsatisfying ruined orgasm. And then, as soon as it's over, the vibrations start again, this time non-stop instead of in three-second bursts and in [his of M] vagina instead of [his of M] asshole.[line break][speech style of M]'No, no, please, I didn't mean to cum! I'm sorry! Please don't say the curse has activated! Hah... hah... haaaaaah...'[roman type][line break]The cursed belt's vaginal vibrator quickly manages to bring [him of M] close to the edge again, before shutting off. Then the anal vibrator turns on again, bringing [him of M] to [his of M] second anal orgasm.[line break][speech style of M]'Cumming!'[roman type][line break]It shuts off just before [his of M] peak, to ensure that the anal orgasm is closer to denial torture than true pleasurable release. By this point, [NameDesc of M] is just a writhing mess on the floor.[line break][speech style of M]'Noooo, I'm going to go insane, I'm going to go insane!'[roman type][line break][BigNameDesc of M] keeps mumbling that to [himself of M] as the team of vibrators begins to bring [him of M] to [his of M] third ruined anal orgasm in less than a minute, again making sure to bring [him of M] most of the way vaginally, before switching to anal only when [he of M] gets close. There's nothing you can do for [him of M] - it's probably best just to leave [him of M] to it.";
	now M is fucked-silly;
	now the health of M is 1;
	if there are things retained by M:
		say "Your [list of things retained by M] [if the number of things retained by M > 1]are[otherwise]is[end if] also left behind.";
		repeat with K running through things retained by M:
			now K is in the location of the player;
			now M is not retaining K;
			now M is not withholding K;
			compute autotaking K.

To say SexResistSlapFlav of (M - supporter-misako):
	say "[BigNameDesc of M] grunts in frustration at your [one of]fruitless display[or]vain efforts[or]pointless attempts[or]futile resistance[at random] before [if M is penetrating face]painfully slapping your [BreastDesc][otherwise]roughly spanking your [buttcheeks][end if] [one of]to get you to behave[or]in order to keep you under control[or]as punishment[or]to discourage further disobedience[at random].".

To say MonsterOfferRejectFlav of (M - supporter-misako) to (T - a thing):
	say "[BigNameDesc of M] refuses.[line break][speech style of M]'I don't do trades.'[roman type][line break]".

To compute sudden objectification of (M - supporter-misako): [The player's appearance just jumped to completely unacceptable standards right in front of your NPC, and your NPC has noticed, and now wants to bang.]
	say "Something seems to change in the way [NameDesc of M] is looking at you. [line break][speech style of M]'[if M is penetrating a body part]Yes, that's right I'm the boss, and you're my little [whore]...'[otherwise if the player is monster fucked]That does look like a lot of fun! Maybe if I join in, I'll be able to feel something...'[otherwise]It's so wrong... but I'm too horny... I really need to try this, just in case I can get it to work...'[end if][roman type][line break]".

To compute MasturbationReaction of (M - supporter-misako):
	if M is awake:
		if M is penetrating a body part:
			say "[BigNameDesc of M] grins, and starts thrusting even faster.";
		otherwise:
			say "[BigNameDesc of M] stares.[line break][speech style of M]'[if M is friendly]That's... that's so mean! Ugh! That's it, I'm going to use YOU to get me off, if it's the last thing I do!'[otherwise]Haha, I didn't know you wanted me that much!'[end if][roman type][line break][big he of M] flexes [his of M] wrists in anticipation.";
			now M is interested;
			anger M.

[Oral]

To say CommencingFacesitFlav of (M - supporter-misako): [The NPC sits on the player's face.]
	say "[BigNameDesc of M] flips you onto your back and before you know it, your head is between [his of M] latex-clad thighs and the seat of [his of M] chastity belt is being lowered right onto your face! It seems like [he of M] has no intention of letting you go before [he of M][']s tried [his of M] best to make [himself of M] cum.".

To say FacesitResistingResponse of (M - supporter-misako): [The player is refusing to play ball and perform cunnilingus / anilingus. How does the NPC act?]
	say "[one of][BigNameDesc of M] whines in frustration as [he of M] rocks back and forth on your face.[or][BigNameDesc of M] squeezes tight on your head with [his of M] thighs as [he of M] grinds away, practically sobbing with frustration.[or][BigNameDesc of M] rapidly grinds away on your face, panting heavily.[then at random][line break][speech style of M]'[one of]Come on, let me feel something!'[or]Dammit, I can't feel a thing!'[or]Is it really not going to work?'[or]Come on, please work, I need to cum so badly!'[then at random][roman type][line break]".

To say FacesitSubmissionResponse of (M - supporter-misako): [Normal facesitting oral sex. Explain what's happening!]
	say FacesitResistingResponse of M.

To say NearingClimaxFacesit of (M - supporter-misako): [Next turn your NPC is going to cum! Give a hint to the player by changing up the flavour. Also this allows the climax to make more sense (rather than her sitting still and the player refusing to tongue, and then suddenly there's an orgasm!)]
	say FacesitResistingResponse of M.

To say FacesitClimaxFlav of (M - supporter-misako):
	say "[BigNameDesc of M] begins to grind with increasing speed and desperation until all of a sudden [he of M] stops, and stands up, with a face covered in tears.[line break][speech style of M]'It doesn't work. I don't know what to do. Nothing works!'[roman type][line break]".

[Vaginal & Anal]

[We use anal to mean vaginal here, so that it can happen to male players too.]

To compute (M - supporter-misako) entering anally:
	compute M entering vagina;
	dislodge M;
	now M is penetrating asshole.
To compute anal sex of (M - supporter-misako):
	compute vaginal sex of M.
To compute (M - supporter-misako) sexRuin in (F - asshole):
	unless there is a worn chastity cage, compute M sexRuin in vagina.

To say VaginaSpecialPenetrationFlav of (M - supporter-misako): [This can be whatever you want as long as the purpose is masturbating the vagina and it's not thick enough for us to need to handle calculations about soreness and stretching. So it could be a vibrating wand, or your NPC's tongue, etc. Just make sure that the flavour in the following turns matches]
	say "[BigNameDesc of M] adopts a scissoring position and pushes the front of [his of M] belt up against your [genitals].".

To say AssholeSpecialPenetrationFlav of (M - supporter-misako): [This can be whatever you want as long as the purpose is masturbating the asshole and it's not thick enough for us to need to handle calculations about soreness and stretching. So it could be a vibrating anal probe, or your NPC's tongue, etc. Just make sure that the flavour in the following turns matches]
	say VaginaSpecialPenetrationFlav of M.

To say SexSubmitFlav of (M - supporter-misako) in (F - a fuckhole): [The player has submitted to your acts. How does that make your NPC act?]
	say "[one of][BigNameDesc of M] whines in frustration as [he of M] scissors you for all that [he of M][']s worth.[or][BigNameDesc of M] squeezes tight on your torso with [his of M] thighs as [he of M] grinds away, practically sobbing with frustration.[or][BigNameDesc of M] rapidly grinds away on your [genitals], panting heavily.[then at random][line break][speech style of M]'[one of]Come on, let me feel something!'[or]Dammit, I can't feel a thing!'[or]Is it really not going to work?'[or]Come on, please work, I need to cum so badly!'[then at random][roman type][line break]".

To say SexResistFlav of (M - supporter-misako) in (F - a fuckhole): [The player is resisting against your acts. How does that make your NPC act?]
	say SexSubmitFlav of M in F.

To say ClimaxFlav of (M - supporter-misako) in (F - a fuckhole):
	say FacesitClimaxFlav of M.

Supporters ends here.
