Wrestler by Monster begins here.

A wrestler is a kind of monster. A wrestler is usually intelligent. A wrestler has a number called fingers. The favour of a wrestler is usually 7. The leftover-type of a wrestler is usually 120. A wrestler has a number called excitement. The excitement of a wrestler is usually 0. A wrestler has a number called urinal-boredom. A wrestler has a number called patron-chance.

Definition: a wrestler is willing to do vaginal: decide yes.

Definition: a wrestler is willing to do anal: decide yes.

Definition: a wrestler is wenchy: decide yes.

Definition: a wrestler is willing to urinate: decide yes.

Definition: a wrestler is raunchy: decide yes.

Definition: a wrestler is hotel dwelling: decide yes.

To say ShortDesc of (M - a wrestler):
	say "wrestler".

To say MediumDesc of (M - a wrestler):
	say "wrestler".

Figure of wrestler is the file "NPCs/Hotel/wrestler1.png".
Figure of diapered wrestler is the file "NPCs/Hotel/wrestler2.png".

Figure of wrestler interact 1 is the file "Special/Cutscene/cutscene-wrestler-interact1.png".
Figure of wrestler interact 2 is the file "Special/Cutscene/cutscene-wrestler-interact2.png".
Figure of wrestler interact 3 is the file "Special/Cutscene/cutscene-wrestler-interact3.png".
Figure of wrestler interact 4 is the file "Special/Cutscene/cutscene-wrestler-interact4.png".
Figure of wrestler interact 5 is the file "Special/Cutscene/cutscene-wrestler-interact5.png".
Figure of wrestler interact 6 is the file "Special/Cutscene/cutscene-wrestler-interact6.png".
Figure of wrestler interact 7 is the file "Special/Cutscene/cutscene-wrestler-interact7.png".
Figure of wrestler interact 8 is the file "Special/Cutscene/cutscene-wrestler-interact8.png".
Figure of wrestler interact 9 is the file "Special/Cutscene/cutscene-wrestler-interact9.png".
Figure of wrestler interact 10 is the file "Special/Cutscene/cutscene-wrestler-interact10.png".
Figure of wrestler interact 11 is the file "Special/Cutscene/cutscene-wrestler-interact11.png".
Figure of wrestler interact 12 is the file "Special/Cutscene/cutscene-wrestler-interact12.png".
Figure of wrestler interact 13 is the file "Special/Cutscene/cutscene-wrestler-interact13.png".
Figure of wrestler interact 14 is the file "Special/Cutscene/cutscene-wrestler-interact14.png".
Figure of wrestler interact 15 is the file "Special/Cutscene/cutscene-wrestler-interact15.png".
Figure of wrestler interact 16 is the file "Special/Cutscene/cutscene-wrestler-interact16.png".

Figure of Wrestler Cutscene 1 is the file "Special/Cutscene/cutscene-wrestler-relax1.png".
Figure of Wrestler Cutscene 2 is the file "Special/Cutscene/cutscene-wrestler-piss3.png".
Figure of Wrestler Cutscene 3 is the file "Special/Cutscene/cutscene-wrestler-stance1.png".
Figure of Wrestler Cutscene 4 is the file "Special/Cutscene/cutscene-wrestler-carry1.png".
Figure of Wrestler Cutscene 5 is the file "Special/Cutscene/cutscene-wrestler-carry2.png".
Figure of Wrestler Cutscene 6 is the file "Special/Cutscene/cutscene-wrestler-piss1.png".
Figure of Wrestler Cutscene 7 is the file "Special/Cutscene/cutscene-wrestler-piss2.png".
Figure of Wrestler Cutscene 8 is the file "Special/Cutscene/cutscene-wrestler-friendly1.png".
Figure of Wrestler Cutscene 9 is the file "Special/Cutscene/cutscene-wrestler-friendly2.png".
Figure of Wrestler Cutscene 10 is the file "Special/Cutscene/cutscene-wrestler-friendly3.png".
Figure of Wrestler Cutscene 11 is the file "Special/Cutscene/cutscene-wrestler-friendly4.png".
Figure of Wrestler Cutscene 12 is the file "Special/Cutscene/cutscene-wrestler-friendly5.png".

To decide which figure-name is the monster-image of (M - a wrestler):
	if diaper quest is 1, decide on figure of diapered wrestler;
	otherwise decide on figure of wrestler.

To decide which figure-name is the anal-sex-monster-image of (M - a wrestler):
	if the fingers of M is 1, decide on figure of wrestler fingers 1;
	if the player is male:
		if the fingers of M > 2, decide on figure of wrestler fingers 4;
		decide on figure of wrestler fingers 2;
	otherwise:
		if the fingers of M > 5, decide on figure of wrestler fingers 6;
		if the fingers of M > 4, decide on figure of wrestler fingers 5;
		decide on figure of wrestler fingers 3.

To decide which figure-name is the vaginal-sex-monster-image of (M - a wrestler):
	decide on figure of wrestler fingers 1.

latex-clad wrestler is a wrestler. The text-shortcut of latex-clad wrestler is "lwr". Understand "latex", "clad" as latex-clad wrestler.
To say MediumDesc of (M - latex-clad wrestler):
	say "latex clad wrestler".
rubberdoll wrestler is a wrestler. Understand "rubber", "doll" as rubberdoll wrestler. The text-shortcut of rubberdoll wrestler is "rwr".
To say MediumDesc of (M - rubberdoll wrestler):
	say "rubberdoll wrestler".

To say MonsterDesc of (M - a wrestler):
	if M is fucked-silly:
		say "An unconscious latex clad wrestler on the ground here has a bulging belly and still has [semen] slowly flowing out of [if lady fetish is 2][his of M] gaped asshole[otherwise][his of M] gaped cunt[end if].";
	otherwise:
		if diaper quest is 1:
			say "This [man of M] is covered head to toe in a shiny black latex catsuit. It conceals every inch of [his of M] skin except the lower half of [his of M] face and [his of M] eyes. Other than that it completely seals [him of M] in, although a zip at the crotch suggests that may be under [his of M] control. [if lady fetish < 2]And just as well - the figure-hugging rubber outfit does nothing to conceal [his of M] generous curves, including the large diaper bulge around [his of M] crotch. 'Voluptuous' is the word to describe [his of M] body, from [his of M] two perfectly round G-cup breasts down to [his of M] alluringly wide hips and shapely thighs.[otherwise]And just as well - the figure-hugging rubber outfit does nothing to conceal the large diaper bulge around [his of M] crotch. 'Powerful' is the word to describe [his of M] body, from [his of M] rippling pecs, down to [his of M] chiselled abs and bulging biceps[end if]. [big his of M] well-muscled legs are balanced surely on a pair of black platform fetish heels. The outfit sports a pair of cat ears on top of [his of M] head and has purple accents on the inner thighs, armpits and the back of [his of M] head, all of it working together to give the impression of some kind of wrestling outfit.";
		otherwise:[the male wrestler is jacked]
			say "This [man of M] is covered head to toe in a shiny black latex catsuit. It conceals every inch of [his of M] skin except the lower half of [his of M] face and [his of M] eyes. Other than that it completely seals [him of M] in, although a zip at the crotch suggests that may be under [his of M] control. [if lady fetish < 2]The figure-hugging rubber outfit does nothing to conceal [his of M] generous curves. The word 'Voluptuous' perfectly describes [his of M] body, from [his of M] two perfectly round G-cup breasts down to [his of M] alluringly wide hips and shapely thighs.[otherwise]The figure-hugging rubber outfit perfectly accentuates [his of M] muscular body. The word 'Powerful' perfectly describes [him of M], from [his of M] rippling pecs down to [his of M] chiselled abs and huge, bulging biceps[end if]. [big his of M] well-muscled legs are surely balanced on two high black platform fetish heels. The outfit sports a pair of cat ears on top of [his of M] head and has purple accents on the inner thighs, armpits and the back of [his of M] head, all of it working together to give the impression of some kind of wrestling outfit.".

To say MonsterComment of (M - a wrestler):
	if diaper quest is 0, say "[variable custom style][if the bimbo of the player < 5 and the player is male][one of]Man, that's a pretty hot outfit. I wouldn't mind a poster of [him of M] on my wall.[or][big he of M][']s definitely my type.[stopping][otherwise if the bimbo of the player < 5]How can [he of M] look so happy when [he of M]'s wearing something so constricting?[otherwise if the bimbo of the player < 8][one of]I wonder if [he of M] actually knows how to wrestle.[or][big he of M] looks pretty darn strong. I should be careful.[stopping][otherwise if the bimbo of the player < 11][one of][big he of M] looks like [he of M] could teach me a thing or two...[or]I wonder what it feels like in there.[or]I wish I was as happy as [he of M] looks.[in random order][otherwise if watersports fetish is 1][big he of M] seems kinky. I wonder if I'll be able to keep up?[otherwise if the bimbo of the player < 14]Fuck, [he of M] is hot. I wish I was that hot.[otherwise]Pff, I bet I can fuck better than [him of M], no matter how flexible [he of M] looks.[end if][roman type][line break]".

To set up (M - a wrestler):
	reset M;
	now the monstersetup of M is 1;
	now the raw difficulty of M is the difficulty-base of M;
	now the health of M is the maxhealth of M.

To decide which number is the difficulty-base of (M - a wrestler):
	decide on 8.

To decide which number is the girth of (M - a wrestler):
	let F be a random fuckhole penetrated by M;
	if F is fuckhole:
		if the openness of F >= 10:
			decide on 10;
		otherwise:
			decide on the openness of F + 1;
	decide on 0.

[This is the spawn initial wrestler rule:
	if the number of alive wrestlers is 0:
		if debugmode > 0, say "Summoning wrestler in hotel.";
		let M be a random wrestler;
		summon M in the hotel.
The spawn initial wrestler rule is listed in the setting up hotel monsters rules.]

Definition: a wrestler is human: decide yes.

Part 1 - Misc Flavour

To say SummoningFlav of (M - a wrestler):
	if M is in the location of the player:
		say "The teleporter emits a definitive sounding hum, and light fills the room as a [man of M] covered head to toe in shiny latex materialises on the pad.[line break][speech style of M]'I hope my mistress is ready for me.'[roman type][line break]";
	otherwise:
		say "You hear the sound of squeaky rubber clothing coming from another part of the hotel.".

To say ToiletPeeReaction of (M - a wrestler):
	say "[BigNameDesc of M] licks [his of M] lips.[line break][speech style of M]'[if watersports fetish is 1]You know, it's unusual getting to watch someone else pee without me being on my knees underneath them[otherwise]Is the big [boy of the player] trying to prove [he of the player] doesn't need diapers? How adorable[end if]!'[roman type][line break]".

To IdentifiablePosterReaction of (M - a wrestler):
	say "[BigNameDesc of M] looks at you, blinks, then looks back to the banner. Upon realising that it is you, [he of M] grins widely and gives you a sly wink.";
	alwayscutshow figure of wrestler interact 10 for M;
	say "You turn bright red with shame.";
	humiliate the lewdness of a random poster in the location of the player * 2.

To UnidentifiablePosterReaction of (M - a wrestler):
	say "[speech style of M]'I'm jealous of whoever that is. I wish there were banners of me up around the place!'[roman type][line break]";
	alwayscutshow figure of wrestler interact 9 for M;
	say "You turn slightly red but don't say a word.";
	humiliate the lewdness of a random poster in the location of the player / 2.

To compute (M - demon lord) stomping (N - a wrestler):
	if M is in the location of the player, say "With a flick of [his of M] tail, [NameDesc of M] grabs [NameDesc of N] and pulls [him of N] towards [him of M].[line break][speech style of N]'Ooooh, this should be fun!'[roman type][line break][BigNameDesc of N] squeaks with excitement.[line break]Remaining fully standing, [NameDesc of M] lowers [NameDesc of N] onto [his of M] giant erect red [DickDesc of M] and starts fucking [his of N] cunt furiously. [big he of N] screams in both pleasure and pain - [NameDesc of M][']s member is clearly much bigger than expected and almost splits [him of N] in two. Soon the intense stretching and fucking is too much even for this seasoned sex slave slut and [he of N] starts wailing in distress. But it's already too late - [NameDesc of M] is coming inside [him of N] while forcing [him of N] further and further down [his of M] [DickDesc of M]. [BigNameDesc of N][']s belly balloons out, noisily stretching [his of N] latex catsuit. After [NameDesc of M] has finished, [his of M] tail lets go of [NameDesc of N][']s waist and [he of N] falls to the ground, where [he of N] promptly faints.";
	otherwise say "You hear a [man of N] squeak an excited [speech style of N]'Ooooh!'[roman type] which quickly turns into a panicked [speech style of N]'Aaaaaaaah!'[roman type] from [if N is nearby]nearby![otherwise]somewhere in the hotel![end if]";
	now N is fucked-silly.

To say SuddenTransformTrapReactFlav of (M - a wrestler):
	say "[BigNameDesc of M] looks delighted.[line break][speech style of M]'Oh wow, you look so [beautiful] now!'[roman type][line break]".

Part 2 - Perception

To decide which number is the outrage tolerance of (M - a wrestler):
	decide on 5.

To compute perception of (M - a wrestler):
	now M is interested;
	say "[BigNameDesc of M] notices you[if the player is sluttily dressed].[otherwise]![end if]";
	if the latex-transformation of the player > 6 or there is a worn messed knickers:
		say "[big he of M] seems a little intrigued by you but leaves you alone.";
		alwayscutshow figure of wrestler interact 2 for M;
		bore M;
	otherwise if M is unfriendly and the times-met of M > 0:
		say "[speech style of M]'Hey hot stuff, ready for another round?'[roman type][line break]";
		alwayscutshow figure of wrestler interact 11 for M;
	otherwise if the bimbo of the player > 10 and the player-class is succubus:[The succubus is intimidating enough that it takes a bit longer for the wrestler to turn]
		say "[speech style of M]'Heh, you're trying to look scary but you don't have me fooled for a minute!'[roman type][line break]";
		alwayscutshow figure of wrestler interact 10 for M;
		anger M;
	otherwise if M is unfriendly or the class of the player is royal slave or the class of the player is the latex fetish model or the class of the player is maid or the player is a sissy:
		if the player is flying:
			say "[speech style of M]'What are you doing up there, you crazy bitch?!'[roman type][line break]";
			alwayscutshow figure of wrestler interact 8 for M;
		otherwise if the class of the player is royal slave:
			say "[speech style of M]'Ooh, another slave! Can I be your friend? [if watersports fetish is 1]Winner chooses the game we play!'[otherwise]Do you want to meet my mistress?'[end if][roman type][line break]";
			alwayscutshow figure of wrestler interact 7 for M;
		otherwise if the class of the player is latex fetish model:
			say "[speech style of M]'Hey, sister! I didn't know mistress had another rubber slave. Let's fight to see who gets to be on top!'[roman type][line break]";
			alwayscutshow figure of wrestler interact 11 for M;
		otherwise if the class of the player is maid:
			say "[speech style of M]'[if watersports fetish is 1 and the urinal-boredom of M is 0]Oooh, a slutty maid! If you're staff, I guess that kind of makes me your boss? I know a job that's perfect for you. Come with me!'[otherwise]Hey, you're staff, aren't you? That means you have to let me do whatever I want to you, right?'[end if][roman type][line break]";
			alwayscutshow figure of wrestler interact 5 for M;
		otherwise if the player is a sissy:
			say "[speech style of M]'Oooh! A real life sissy! My Mistress has been looking for a good sissy slave for ages.'[roman type][line break]";
			alwayscutshow figure of wrestler interact 5 for M;
		otherwise:
			say "[speech style of M]'Hey, wanna wrestle? Winner gets to be on top!'[roman type][line break]";
			alwayscutshow figure of wrestler interact 11 for M;
		anger M;
	if M is interested and M is friendly:
		compute appearance assessment of M.

To compute appearance assessment of (M - a wrestler):
	say "[BigNameDesc of M] looks you up and down.";
	if the appearance of the player > the outrage tolerance of M:
		FavourDown M;
		if M is unfriendly:
			say "[speech style of M]'Hey, I really wanna wrestle you. Come on, it'll be fun! Winner gets to be on top!'[roman type][line break]";
			alwayscutshow figure of wrestler interact 11 for M;
		otherwise if M is groping:
			compute grope of M;
		otherwise:
			say "[speech style of M]'[one of]Hi there, sexy. Are you enjoying your stay in this fetish hotel? [or]Hey there hot stuff. Having a good time? [stopping]I wonder if I should make it even more fun...'[roman type][line break]";
			alwayscutshow figure of wrestler interact 1 for M;
	otherwise if the player is top-wardrobe-malfunctioning:
		compute default nip slip reaction of M;
	otherwise:
		say "[speech style of M]'[if the times-met of M > 0]Hi again [honey of M], I hope you're not lost?'[otherwise]Oh my, you look new. Be careful around here... people in this fetish hotel will tend to assume you're on the same page as them, and want to do lots of kinky stuff with anyone that moves. And that includes the robots...'[end if][roman type][line break]";
		alwayscutshow figure of wrestler interact 1 for M.

To compute DQ perception of (M - a wrestler):
	now M is interested;
	say "[BigNameDesc of M] notices you[if the player is sluttily dressed].[otherwise]![end if]";
	if M is unfriendly and the times-met of M > 0:
		say "[speech style of M]'Hey hot stuff, ready for another round?'[roman type][line break]";
		alwayscutshow figure of wrestler interact 11 for M;
	otherwise if the class of the player is maid:
		say "[speech style of M]'Hey, you're staff, aren't you? That means you have to let me do whatever I want to you, right?'[roman type][line break]";
		alwayscutshow figure of wrestler interact 5 for M;
		anger M;
	otherwise if the player is a sissy:
		say "[speech style of M]'Oooh! A real life sissy! My Mistress has been looking for a good sissy slave for ages.'[roman type][line break]";
		alwayscutshow figure of wrestler interact 5 for M;
		anger M;
	otherwise if there is worn bondage:
		say "[speech style of M]'Ooh, another slave! Can I be your friend? [if watersports fetish is 1]Winner chooses the game we play!'[otherwise]Do you want to meet my mistress?'[end if][roman type][line break]";
		alwayscutshow figure of wrestler interact 7 for M;
		anger M;
	otherwise if M is unfriendly:
		say "[speech style of M]'Hey, wanna wrestle? Winner gets to be on top!'[roman type][line break]";
		alwayscutshow figure of wrestler interact 11 for M;
	if M is interested and M is friendly:
		say "[speech style of M]'[one of]Hi there, sexy. Are you enjoying your stay in this fetish hotel?'[or]Hey there hot stuff. Having a good time?'[stopping][roman type]";
		alwayscutshow figure of wrestler interact 1 for M.

Part 3 - Combat

Section 1 - Protection

To compute (M - a wrestler) protecting against (X - a monster):
	say "[speech style of M]'Haha, that looks like fun! Can I join in?'[roman type][line break]";
	alwayscutshow figure of wrestler interact 5 for M;
	anger M;
	compute attack of M.

Section 2 - Attack

To compute kneeling reaction of (M - a wrestler):
	say "[one of][BigNameDesc of M] stands over you, a smug grin clearly visible through [his of M] latex hood. [or][BigNameDesc of M] stands over you, [his of M] eyes shining with glee through the holes in [his of M] latex hood. [or]You hear an excited chuckle escape [his of M] lips. [or][BigNameDesc of M] looms over you. [big he of M] leers down at you, grinning. [in random order]";
	say "[speech style of M]'[if the class of the player is royal slave][one of]Slaves will be slaves.'[or]Aww, I was hoping I'd get a bit more fight out of you than that.'[in random order][otherwise if the class of the player is latex fetish model][one of]Subs will be subs.'[or]You look even sexier than me on your knees.'[in random order][otherwise if watersports fetish is 1 and diaper quest is 0][one of]Looks like you get to be the toilet today!'[or]Looks like we know who is going to be the piss bucket tonight.'[cycling][otherwise][one of]To the victor, the spoils!'[or]Pff, that was too easy.'[in random order][end if][roman type][line break]";
	humiliate 75.

To compute flying player taunting of (M - a wrestler):
	if a random number from 1 to 6 is 1:
		say "[BigNameDesc of M] jeers at you. [line break][speech style of M]'[one of]Look at this [if weight gain fetish is 1]fat [end if]bitch stuck on the ceiling! Haha![or]When you get down I'll show you who's boss![or]I can't believe you're still up there![or]I hope you're as disgusted with yourself as I am with you. You can't even move![or]What kind of dumb bitch gets [himself of the player] stuck on the ceiling?[or]You look absolutely disgraceful, you know that, right?[or][if weight gain fetish is 1]Fatty[otherwise]Someone[end if][']s going to get a pounding when [he of the player] gets back down here![in random order]'[roman type][line break][if the humiliation of the player < 17500]You [one of]wince[or]shudder[or]cringe[purely at random] with shame.";
		humiliate 20.

To say LandingTaunt of (M - a wrestler):
	say "[BigNameDesc of M] giggles. [line break][speech style of M]'That's it, come here [if weight gain fetish is 1]fatty[otherwise][bitch][end if]...'[roman type][line break]";
	humiliate 50.

The wrestler unique punish rules is a rulebook.
This is the wrestler unique punishment rule:
	follow the wrestler unique punish rules;
	if the rule succeeded, rule succeeds.
The unique punishment rule of a wrestler is usually the wrestler unique punishment rule.

This is the wrestler lets the matron take over rule:
	if there is a dangerous matron in the location of the player:
		bore current-monster;
		rule succeeds.
The wrestler lets the matron take over rule is listed first in the wrestler unique punish rules.

This is the wrestler puts slaves in the urinal rule:
	let M be current-monster;
	let R be 0;
	if the latex-transformation of the player <= 4 and the number of barriers in the location of the player is 0 and (the class of the player is latex fetish model or the class of the player is maid or the player is a sissy or the class of the player is human toilet or the class of the player is royal slave), now R is 1;
	if the player is in UrinalBlindfolded:
		if a random number between 1 and 9 is 1:
			let P be a random patron;
			if the urinal-boredom of M is 0: [First urination]
				say "Your thoughts are interrupted by the sound of heavy footsteps entering the room. You hear a [man of P]ly sigh and then the sound of a zip.[line break][variable custom style][one of][if the player is broken]I should hold still to make sure [he of P] doesn't miss a drop.[otherwise if the urine taste addiction of the player < 10]Oh no, please no...[otherwise]This is new...[end if][or][if the player is broken]I guess this is my life now.[otherwise if the urine taste addiction of the player < 11]How has this happened to me again...[otherwise]Ooh, it's starting again...[end if][stopping][roman type][line break]Unable to see, you are forced to wait there for a tense few moments until suddenly you feel the warm blast of the [urine] hit you straight on the nose.";
			otherwise:
				say "You again hear [man of P]ly footsteps! [one of]This [man of P] chuckles quietly to [himself of P] before unzipping and touching your [if there is a worn ballgag][random worn ballgag][otherwise]lips[end if] with [if full-lady fetish is 1][his of P] cunt[otherwise]the tip of [his of P] [manly-penis][end if] and releasing [his of P] bladder.[or][line break][first custom style]'Another watersports fetishist. I can't believe you enjoy getting pissed on, how disgusting.'[roman type][line break]That is all you hear before the stream of [urine] hits your face.[or][line break][first custom style]'Open wide, slave.'[roman type][line break]You're not even given a chance to react before a strong, warm stream of [urine] hits your face.[in random order]";
			FacePiss from nothing;
			increase the urinal-boredom of M by 1;
		otherwise if a random number between 2 and 50 < the urinal-boredom of M:
			compute M releasing the player;
		rule succeeds;
	otherwise if watersports fetish is 1 and (the urinal-boredom of M is 0 or the class of the player is human toilet) and R is 1:
		if Hotel31 is the location of the player:
			repeat with N running through monsters:
				dislodge N;
			now M is grabbing the player;
			now the sex-length of M is a random number between 10 and 30;
			say "[BigNameDesc of M] forces your back against the wall in between the two urinals. Before you can move, [he of M] has secured your ankles to two strong metal anklecuffs connected by short chains to the wall. [if the bimbo of the player < 10]As you fruitlessly pull at the chains, [otherwise if the class of the player is human toilet]You hold the chains in silent obedience as[otherwise]You hold the chains in silent bemusement as [end if] [he of M] clamps two more cuffs around your wrists, securing them strictly to your ankles and preventing you from even standing up. Finally [he of M] gives you a passionate kiss on the lips as [he of M] pulls a thick woolly blindfold over your eyes.[line break][speech style of M]'I'll be back for you in a bit, beautiful. Enjoy yourself!'[roman type][line break]";
			now the source-room of UrinalBlindfolded is the location of the player;
			now the player is in UrinalBlindfolded;
			now the urinal-boredom of M is 0;
			display entire map;
		otherwise:
			say "[one of][line break][speech style of M]'I know a place where you'll have some good fun!'[roman type][line break][or][stopping]";
			drag to Hotel31 by M;
		rule succeeds.
The wrestler puts slaves in the urinal rule is listed in the wrestler unique punish rules.

To say DragFlav of (M - a wrestler) to (R - a room):
	say "[BigNameDesc of M] lifts you over [his of M] shoulder into a fireman's hold and waltzes through the hotel [if the distance of R > 1]all the way [end if]to the [R]!";
	if the player is male, cutshow figure of wrestler cutscene 4 for M;
	otherwise cutshow figure of wrestler cutscene 5 for M.

To say DragArrival of (M - a wrestler) to (R - Hotel31):
	say "[speech style of M]'Here we are!'[line break][variable custom style][one of][if the bimbo of the player < 8]Oh god, why is there a gap between those urinals?[otherwise]Why are we here I wonder?[end if][or][if the bimbo of the player < 13]No no no please not again![otherwise]Uh-oh, looks like it's toilet time again![end if][stopping][roman type][line break]".

To UrinalWait:
	let M be a random wrestler grabbing the player;
	let N be the urinal-boredom of M;
	while the urinal-boredom of M is N and the player is in UrinalBlindfolded:
		say "You continue [one of]kneeling[or]waiting[or]waiting for the wrestler to return[or]kneeling between the two urinals[or]impatiently waiting for something to happen[or]waiting, straining with your ears to try and hear anything[as decreasingly likely outcomes].";
		allocate 6 seconds;
		compute extra turn.

To compute (M - a wrestler) releasing the player:
	let U be UrinalBlindFolded;
	bore M for 700 seconds;
	FavourUp M;
	say "Suddenly you hear high heeled footsteps. You feel your [urine]-soaked blindfold removed and you see [NameDesc of M] standing over you, grinning.[line break][speech style of M]'Oooh, looks like you really did have fun! Well, I guess I should let you go recover for now.'[roman type][line break]";
	alwayscutshow figure of wrestler interact 10 for M;
	say "[BigNameDesc of M] releases you from your bondage and then loses interest.";
	increase the urine-puddle of the source-room of U by the urine-puddle of U;
	now the urine-puddle of U is 0;
	now the player is in the source-room of U;
	refresh the map-window.

This is the wrestler feeds you to master rule:
	let M be current-monster;
	let N be a random alive dominatrix;
	if N is not monster and the times-met of M <= 1, now N is a random alive matron; [We don't want to do this if the wrestler has already dragged the player to the dominatrix earlier in the game] [The test is <= 1 because times-met gets set to 1 as soon as the wrestler first perceives the player. This action will come directly after that, hence a times-met of 1 means this is their first interaction, and anything higher than that means it's a future interaction.]
	if N is monster and the times-met of N is 0 and the times-met of M < 2:
		let Q be Hotel22;
		if N is dominatrix, now Q is Hotel37;
		if Q is not the location of M:
			say "[one of][line break][speech style of M]'I'm going to take you to meet my owner!'[roman type][line break][or][stopping]";
			drag to Q by M;
		if N is in Q:
			say "[speech style of M]'[if N is matron]Mommy, look I've brought a friend! [big he of the player] needs your special care.'[otherwise]Mistress, I've made a friend! [big he of the player] wants to learn how to be like me.'[end if][line break]";
			if the player is able to speak, say "[variable custom style]'[if the bimbo of the player < 8]No I don[']t!'[otherwise]Who are you?'[end if]";
			otherwise say "[variable custom style][if the bimbo of the player < 8]If I could speak I could tell [him of N] it's all a big mistake!![otherwise]Who is [he of N]?[end if]";
			say "[roman type][line break]";
			say "[BigNameDesc of M] dumps you in front of the [N] in this room, and then promptly skips away, merrily humming to [himself of M].";
			if N is friendly or N is uninterested:
				now the boredom of N is 0;
				compute correct perception of N;
			bore M;
			compute monstermotion of M;
		otherwise: [Should never happen since the matron / dominatrix shouldn't be wondering around until their times-met is higher than 0. But just in case.]
			say "[speech style of M]'Oh, [he of N][']s not here. That's unusual. Oh well, I guess we can wait for [him of M] here. I've got an idea of something we can do to pass the time...'[roman type][line break]";
			now the times-met of M is 2;
		rule succeeds.
The wrestler feeds you to master rule is listed last in the wrestler unique punish rules.

To say DragArrival of (M - a wrestler) to (R - a room):
	say "[speech style of M]'Here we are!'[roman type][line break]".

wrestler-piss-drunk is a number that varies.

To compute unique piss drink effect of (M - a wrestler):
	now wrestler-piss-drunk is 1.

To compute (M - a wrestler) urinating:
	if lady fetish is 2:
		say "[BigNameDesc of M] reaches down to [his of M] crotch and slowly unzips [his of M] catsuit, revealing a bright purple chastity cage.[one of] A strand of vicious precum slowly drips out of its open end.[or][stopping] [one of][big he of M][or]Once again, [he of M][stopping] starts to casually urinate all over your face and hair. [if the humiliation of the player >= 40000]You feel strangely comforted, once again put in your place as an object to be used and then discarded.[otherwise if the humiliation of the player > 30000]Deep down, you feel you deserve this degradation.[otherwise]You can't tell if most of the warmth is coming from the heat of the [urine] or your cheeks burning red with humiliation.[end if]";
	otherwise:
		say "[BigNameDesc of M] reaches down to [his of M] crotch and slowly unzips [his of M] catsuit, revealing [his of M] rosy, engorged vulva.[one of] [big he of M] is clearly very aroused.[or][stopping] [one of][big he of M][or]Once again [he of M][stopping] casually starts urinating over your hair and face. [if the humiliation of the player >= 40000]You feel strangely comforted, once again in your place as an object to be used and then discarded.[otherwise if the humiliation of the player > 30000]Deep down, you feel that you deserve this degradation.[otherwise]You can't tell if most of the warmth is coming from the heat of the [urine] or your cheeks burning red with humiliation.[end if]";
	now wrestler-piss-drunk is 0;
	FacePiss from M;
	if wrestler-piss-drunk is 1, cutshow figure of wrestler cutscene 6 for M;
	otherwise cutshow figure of wrestler cutscene 7 for M;
	say "[speech style of M]'That was fun. Let's do it again soon.'[roman type][line break][BigNameDesc of M] seems to lose interest in you for now.";
	FavourUp M;
	bore M.

To say PissDrinkThreat of (M - a wrestler):
	say "[speech style of M]'[one of]For this to be fun, you have to drink it, okay? Don't make me mad now!'[or]It tastes really good, I promise! So drink up, or else...'[in random order][roman type][line break]".

This is the wrestler pisses on the player rule:
	let M be current-monster;
	let R be a random number between 1 and 3;
	if the latex-transformation of the player > 4, now R is 3;
	if watersports fetish is 1 and R < 3:
		if the number of monsters penetrating face > 0:
			compute the default taunting of M;
			rule succeeds;
		say "[speech style of M]'[one of]This is how we punish losers in this hotel!'[or]Open wide, loser!'[or]You know the drill by now, bitch!'[stopping][roman type][line break]";
		compute M urinating;
		rule succeeds.
The wrestler pisses on the player rule is listed last in the wrestler unique punish rules.

To compute the default taunting of (M - a wrestler):
	say "[one of][BigNameDesc of M] watches happily with a mixture of excitement and envy.[or][or][cycling]";

To compute the dildo stuck taunting of (M - a wrestler):
	compute the default taunting of M.

This is the wrestler monster fucked taunting rule:
	say "[one of][line break][speech style of current-monster]'I can't wait until it's my turn!'[roman type][line break][BigNameDesc of current-monster] is getting impatient.[or][or][or][or][in random order]";
	rule succeeds.
The monster fucked taunting rule of a wrestler is usually the wrestler monster fucked taunting rule.

To say PresentAcceptanceFlav of (M - a wrestler):
	say "[speech style of M]'Haha, okay, you asked for it, here I come!'[roman type][line break]".

To compute (M - a wrestler) getting fingers into (F - a fuckhole):
	if the openness of F is 10:
		now the fingers of M is 6;
	otherwise:
		now the fingers of M is the (openness of F + 1) / 2;
	if the fingers of M <= 0, now the fingers of M is 1.

To say VaginaPenetrationFlav of (M - a wrestler):
	compute M diving into vagina.
To say FriendlyVaginaPenetrationFlav of (M - a wrestler):
	say VaginaPenetrationFlav of M.

To say AssholePenetrationFlav of (M - a wrestler):
	compute M diving into asshole.
To say FriendlyAssholePenetrationFlav of (M - a wrestler):
	say AssholePenetrationFlav of M.

To set up sex length of (M - a wrestler) in (F - a fuckhole):
	set up sex length (a random number between 2 and 4) of M in F.

To compute (M - a wrestler) diving into (F - a fuckhole):
	say "[speech style of M]'Okay, let's see just how much we can stretch you out!'[roman type][line break]";
	compute M getting fingers into F;
	if the fingers of M is 1:
		say "[BigNameDesc of M] slides a single finger into your extremely tight [variable F].";
		cutshow figure of wrestler fingers 1 for M;
	otherwise if the fingers of M is 2:
		say "[BigNameDesc of M] slides two fingers into your tight [variable F].";
		if the player is male, cutshow figure of wrestler fingers 2 for M;
	otherwise if the fingers of M is 3:
		say "[BigNameDesc of M] slides a full three fingers into your [variable F].";
		if the player is female, cutshow figure of wrestler fingers 3 for M;
	otherwise if the fingers of M is 4:
		say "[BigNameDesc of M] forces all four of [his of M] fingers into your [variable F].";
	otherwise if the fingers of M is 5:
		say "[BigNameDesc of M] slides all four of [his of M] fingers [italic type]and[roman type] [his of M] thumb into your [variable F], all the way up to [his of M] knuckles. [big he of M] can't manage to push it in any further than that!";
		if the player is female, cutshow figure of wrestler fingers 5 for M;
	otherwise:
		say "[BigNameDesc of M] slides all four of [his of M] fingers [italic type]and[roman type] [his of M] thumb into your [variable F], all the way up to [his of M] knuckles. [big he of M] keeps pushing with all [his of M] might, and all of a sudden, [his of M] whole fist slides in!";
		if the player is male, cutshow figure of wrestler fingers 4 for M;
		otherwise cutshow figure of wrestler fingers 6 for M;
	say "[variable custom style][if the relevant sex addiction of M < 9][one of]Oof[or]'That's too much!'[or]I'm being stretched![in random order][otherwise][one of]This is new...![or]Oof, I feel more loose already...[or]Here we go again![stopping][end if][roman type][line break]";
	say "[big he of M] starts moving [his of M] [if the fingers of M is 6]fist[otherwise]fingers[end if] in a thrusting motion.".

To compute anal sex of (M - a wrestler):
	compute M fisting asshole;
	ruin asshole.

To compute vaginal sex of (M - a wrestler):
	unless M is penetrating face:
		compute M fisting vagina;
		ruin vagina.

To compute (M - a wrestler) fisting (F - a fuckhole):
	if the reaction of the player is 0:
		say "You try to get away, but [he of M]'s much too strong for you.";
	let old-fingers be the fingers of M;
	compute M getting fingers into F;
	if the fingers of M > old-fingers:
		if the fingers of M is 6:
			say "[BigNameDesc of M] keeps pushing with all [his of M] might, and all of a sudden, [his of M] whole fist slides in!";
			say "[variable custom style][if the relevant sex addiction of M < 8]'AAAAAAAAAH!'[otherwise if the relevant sex addiction of M < 14]There's no way...?!?! Oh my god, it's really happening, I'm being fisted![otherwise][big he of M] got the whole fist in, I'm so proud! Fist fuck me, baby![end if][roman type][line break]";
			if the player is male, cutshow figure of wrestler fingers 4 for M;
			otherwise cutshow figure of wrestler fingers 6 for M;
		otherwise:
			say "[BigNameDesc of M], having loosened you up, finds room for another finger! [big he of M] now has [fingers of M] fingers inside your [variable F]. [big he of M] continues [his of M] furious thrusting!";
			if the fingers of M is 5 and the player is female, cutshow figure of wrestler fingers 5 for M;
			if the fingers of M is 3 and the player is female, cutshow figure of wrestler fingers 3 for M;
			if the fingers of M is 2 and the player is male, cutshow figure of wrestler fingers 2 for M;
	otherwise:
		say "[BigNameDesc of M] keeps thrusting away, [one of]using [his of M] strong muscles to keep the pounding strong and hard[or]varying the speed of [his of M] pumps to keep you on your toes[or]putting [his of M] body weight into it[in random order]. Your [variable F] struggles to keep up with [his of M] girth and speed!";
	decrease the sex-length of M by 1.

To TimesSubmittedUp (M - a wrestler):
	if the excitement of M > 0:
		DifficultyDown M by 5 + the times-dominated of M;
		decrease the excitement of M by 1;
	increase the times-submitted of M by 1.

To compute unique climax of (M - a wrestler) in (F - a fuckhole):
	compute M leaving F.

To compute (M - a wrestler) leaving (F - a fuckhole):
	say "[BigNameDesc of M] pulls [his of M] [if the fingers of M is 6]fist out of your [variable F] with a loud POP. [otherwise]fingers slowly out of your [variable F]. [end if]It looks like [he of M]'s satisfied with [himself of M].";
	say "[speech style of M]'That was fun. Let's do it again soon.'[roman type][line break][BigNameDesc of M] seems to lose interest in you for now.";
	FavourUp M;
	bore M.

To say StrikingFlav of (M - a wrestler) on (B - a body part):
	say "[BigNameDesc of M] grapples you, gripping your [if B is breasts][BreastDesc][otherwise]waist[end if] tightly! [big he of M] throws you into the close-by wall! Oof. ".

To say StrikingSuccessFlav of (M - a wrestler) on (B - a body part):
	say "[StrikingFlav of M on B]";
	say "[if there are worn heels]You barely manage to stay on your feet.[otherwise]You stagger slightly as you regain your footing.[end if]".

To say StrikingFailureFlav of (M - a wrestler) on (B - a body part):
	say "[StrikingFlav of M on B]";
	say "You manage to recover gracefully without any [unless the body soreness of the player is 0]more [end if]bruises.".

This is the wrestler friendly convinced rule:
	let M be current-monster;
	if presented-orifice is face:[she rejects you if you're gagged.]
		if there is a worn chastity cage or the player is gagged or (the player is sexed male and the player is not possessing a penis) or (the player is possessing a vagina and vagina is actually occupied):
			if watersports fetish is 1, compute friendly drink of M;
			otherwise say PresentFriendlyRejectionFlav of M;
		otherwise:
			if lady fetish is 2:
				say "[BigNameDesc of M] unzips [his of M] catsuit, revealing a bright purple chastity cage. [big he of M] eagerly pushes your head between [his of M] legs, lifting up [his of M] sack as you [if the oral sex addiction of the player < 3]hesitantly[otherwise]hungrily[end if] stick out your tongue. [line break][speech style of M]'[one of]Hey, wait a sec. Why don[']t I get down there and do some licking of my own? You keep going, and we[']ll see who comes first!'[or]Want to see which of us comes first? I[']m betting on you!'[stopping][roman type][line break]";
			otherwise:
				say "[BigNameDesc of M] unzips [his of M] catsuit, revealing a very wet, rosy [vagina]. [big he of M] eagerly pushes your head between [his of M] legs, spreading [his of M] engorged outer lips as you [if the oral sex addiction of the player < 3]hesitantly[otherwise]hungrily[end if] stick out your tongue. [line break][speech style of M]'[one of]Hey, wait a sec. Why don[']t I get down there and do some licking of my own? You keep going, and we[']ll see who comes first!'[or]Want to see which of us comes first? I[']m betting on you!'[stopping][roman type][line break]";
			if the player is bimbo consenting:
				now chosen-orifice of M is face;
				now M is friendly-fucking;
				compute M entering mouth;
			otherwise if watersports fetish is 1:
				say "[speech style of M]'Oh. Well, this should be fun at least!'[roman type][line break][big he of M] rubs [if lady fetish is 2][himself of M] through the cage[otherwise][his of M] clit[end if] as [he of M] begins to pee in your face!";
				FacePiss from M;
			otherwise:
				say "[speech style of M]'Oh well. I'll be up for it if you change your mind!'[roman type]";
	otherwise if presented-orifice is a reasonable target:
		now the chosen-orifice of M is presented-orifice;
		say PresentFriendlyAcceptanceFlav of M;
		rule succeeds;
	otherwise if presented-orifice is not nothing:
		say PresentFriendlyRejectionFlav of M.
The monster friendly convinced rule of a wrestler is usually the wrestler friendly convinced rule.

To say PresentFriendlyRejectionFlav of (M - a wrestler):
	say "[speech style of M]'Not really interested, sorry!'[roman type][line break]".

To compute (M - a wrestler) entering mouth:
	now the sex-length of M is the patron-chance of M + 3;
	if the sex-length of M > 7, now the sex-length of M is 7;
	say FriendlyMouthPenetrationFlav of M;
	now M is penetrating face;
	if the player is possessing a vagina, now M is penetrating vagina;
	otherwise now M is penetrating penis;

To say FriendlyMouthPenetrationFlav of (M - a wrestler):
	let C be a random worn top level protection clothing;
	if C is clothing:
		if C is displacable, displace C;
		otherwise now C is in the location of the player;
	say "[BigNameDesc of M] joins you on the floor, [if C is clothing and the size of penis <= the armour of C and the size of penis > 2]fishing your [ShortDesc of penis] out of your [printed name of C][otherwise if C is clothing]pulling down your [printed name of C][otherwise if the player is male]stroking your [ShortDesc of penis][otherwise]planting a kiss on your outer lips[end if] as [he of M] pulls you on top of [him of M]. [if the oral sex addiction of the player < 3][one of]Already feeling [his of M] probing tongue on your [genitals], you lean in and start some hesitant probing of your own.[or]You take the time to build up some extra courage before hesitantly forcing your tongue to work.[at random][otherwise if the oral sex addiction of the player < 7][one of]Already feeling [his of M] probing tongue on your [genitals], you lean in and do some eager probing of your own.[or]You find yourself ruminating on how enticing [his of M] crotch looks for a moment before diving in.[at random][otherwise][one of]You don't even wait for [him of M] to start, eagerly shoving your face in [his of M] crotch and sending your tongue to work[or]You immediately dive in, desperate to get a taste of [his of M] beautiful crotch.[at random][end if]";
	if the player is male, cutshow figure of wrestler cutscene 9 for M;
	otherwise cutshow figure of wrestler cutscene 8 for M.

To compute facial sex of (M - a wrestler):
	let P be a random patron in the location of the player;
	if P is not patron and patronTime > 15:
		now patronTime is 0;
		let N be a random off-stage generic-appropriate patron;[we use N so it's not picked up by the next clause]
		let R be a random number between 1 and the sex-length of M;
		decrease R by the patron-chance of M;[if her patron-chance is 2 or more, a patron has a chance of showing up. Chance gets higher the closer she is to orgasm.]
		if R < 0:
			now N is in the location of the player;
			say "A stranger walks past the doorway and does a double take.[line break][speech style of N]'What do we have here?'[roman type][line break]You watch as [he of N] strips off [his of N] pants and immediately begins stroking [his of N] [if full-lady fetish is 1]strapon[otherwise]rapidly hardening cock[end if]. [big he of N] must think this is some sort of show!";
	if the reaction of the player is 0:
		say OralResisting of M;
	otherwise if P is patron and asshole is not actually occupied and (a random number between 1 and 2 is 1 or M is not friendly-fucking):
		say "[BigNameDesc of M] suddenly stops what [he of M][']s doing to talk to [NameDesc of P]![line break][speech style of M]'Hey, why don[']t you join in? We have a spot for you right here!'[roman type][line break][big he of M] pushes your [AssDesc] apart, and [if the anal sex addiction of the player < 4]to your horror[otherwise if the anal sex addiction of the player < 8]to your [italic type]total[roman type] surprise[otherwise]to your delight[end if] [NameDesc of P] immediately climbs on top of you and [if the openness of asshole < 2]forces[otherwise if the openness of asshole < 6]pushes[otherwise]slides[end if] [his of P] [manly-penis] into your [asshole].[line break][speech style of P]'[one of]Sweet!'[or]Finally.'[or]About time.'[at random][roman type][line break]";
		now the sex-length of M is a random number between 3 and 4;
		now P is penetrating asshole;
	otherwise if P is patron and P is penetrating asshole:
		say OralResistingResponse of M;
	otherwise:
		say OralSubmissionResponse of M;
	if P is patron:
		if P is penetrating asshole, compute anal sex of P;
		otherwise say "The [P] continues jerking off to the sight in front of [him of P].[line break]";
		compute anal sex of P;
	unless (the reaction of the player is 0 and the number of patrons penetrating asshole is 0), decrease the sex-length of M by 1.

To say OralResisting of (M - a wrestler):
	if lady fetish is 2:
		say "[one of]You refuse to pleasure [NameDesc of M].[or]You keep your tongue in your mouth, away from [NameDesc of M][']s caged genitals.[or]You neglect the caged [sissy-penis] before you.[or]You keep your mouth tightly closed, unwilling to pleasure [NameDesc of M].[at random][line break]";
	otherwise:
		say "[one of]You refuse to lick out [NameDesc of M].[or]You refuse to pleasure [NameDesc of M].[or]You keep your tongue in your mouth, away from [NameDesc of M][']s pussy.[or]You neglect the needy pussy in front of you.[or]You keep your mouth tightly closed, unwilling to pleasure [NameDesc of M].[at random][line break]".

To say SexSubmissionFlav of (M - a wrestler):
	let P be a random patron in the location of the player;
	if (P is patron and P is penetrating asshole) or M is not penetrating face:
		say "[one of]You lie still and endure the punishment.[or]You submit to being used as a plaything.[or]You don't resist [his of M] punishment.[purely at random]";
	otherwise:
		if lady fetish is 2:
			say "[one of]You press your tongue into the opening in [NameDesc of M][']s cage, taking in the taste of [his of M] precum[or]You roll your tongue around the base of [NameDesc of M][']s [sissy-penis], trying to tease out an orgasm![or]You stroke [NameDesc of M][']s balls with your tongue as your [LipDesc] bump [his of M] cage.[or][NameDesc of M][']s cage rests on your nose as you [if the oral sex addiction of the player > 5]happily[otherwise]hesitantly[end if] suckle [his of M] balls.[or]You take [NameDesc of M][']s cage fully into your mouth and swirl around your tongue, [if the oral sex addiction of the player > 6]eagerly[otherwise]dutifully[end if] slurping up [his of M] precum.[at random]";
		otherwise:
			say "[one of]You dig your tongue into [NameDesc of M][']s pussy, taking in [his of M] feminine smell and taste[or]You roll the tip of your tongue around [NameDesc of M][']s clit, trying to tease out an orgasm![or]You stroke [NameDesc of M][']s labia with your tongue as your [LipDesc] bump [his of M] clit.[or]You [if the oral sex addiction of the player > 5]happily[otherwise]hesitantly[end if] stroke [his of M] delicate folds with your tongue.[or]You push your tongue into [NameDesc of M][']s [vagina], [if the oral sex addiction of the player > 6]eagerly[otherwise]dutifully[end if] licking up [his of M] feminine moisture.[at random]".

To say FriendlySexSubmissionFlav of (M - a wrestler):
	if the number of patrons penetrating asshole > 0:
		say "You lie there and accept the invasion";
	otherwise if M is penetrating face:
		say SexSubmissionFlav of M;
	otherwise:[You're getting fisted]
		say "[one of]You lie there, forcing yourself to endure [NameDesc of M][']s brutal punishment.[or]You endure the brutal punishment.[or]You force yourself to sit through the punishment.[at random]".

To say OralSubmissionResponse of (M - a wrestler):[This is only called if the player is not currently getting fucked by a patron.]
	if the size of penis > 6:
		say "[one of][BigNameDesc of M] slurps away at your [ShortDesc of penis], moaning to [himself of M] as [his of M] tongue strokes your throbbing length.[or][BigNameDesc of M] eases your [ShortDesc of penis] into [his of M] throat, pleasuring you with expert movements of [his of M] tongue and neck.[or][BigNameDesc of M] makes noisy slurping noises as [he of M] works your shaft from below.[or][BigNameDesc of M] sucks your [manly-penis] with unbridled enthusiasm.[or][BigNameDesc of M][']s nose bumps your sack as [he of M] works your [manly-penis], stimulating it with expert movements of [his of M] tongue and throat.[at random]";
	otherwise if the size of penis > 2:
		say "[one of][BigNameDesc of M] slurps away at your [Shortdesc of penis], teasing your most sensitive parts with [his of M] tongue.[or][BigNameDesc of M] keeps [his of M] lips firmly sealed to the base of your [manly-penis], mercilessly pleasuring you with [his of M] tongue.[or][BigNameDesc of M] sucks relentlessly, practically torturing you with expert stimulation from [his of M] lips and tongue.[or][BigNameDesc of M] hums as [he of M] suckles your [ShortDesc of penis], having no issue at all driving you insane with pleasure.[or][BigNameDesc of M] pleasures you mercilessly, swirling [his of M] tongue around your tip as [he of M] steadily works you over with [his of M] lips.[at random]";
	otherwise if the player is male:
		say "[one of][BigNameDesc of M] relentlessly teases your [Shortdesc of penis] with [his of M] tongue[or][BigNameDesc of M] skilfully runs [his of M] tongue over your genitals, coating the entire area in spit.[or][BigNameDesc of M] teases your [Shortdesc of penis] with the very tip of [his of M] tongue, as if stimulating a clitoris[or][BigNameDesc of M] pleasures you mercilessly with [his of M] tongue.[or][BigNameDesc of M][']s tongue dances over your [sissy-penis] and taint, driving you insane with expert stimulation.[at random]";
	otherwise:
		say "[one of][BigNameDesc of M] teases your clit with the tip of [his of M] tongue, driving you insane with expert stimulation[or][BigNameDesc of M] pushes [his of M] tongue in and out of your [vagina], hugging your clit with [his of M] lower lip.[or][BigNameDesc of M] stimulates your labia and clit with [his of M] tongue, pistoning [his of M] fingers in and out of your pussy[or][BigNameDesc of M] slurps away at your pussy, practically torturing you with [his of M] expert tongue.[at random]";
	if the player is male:
		stimulate penis from M;
	otherwise:
		stimulate vagina from M;
	if refractoryperiod > 0:
		now the sex-length of M is 1;[this way we know the player is the one who had the orgasm.]
		compute facial climax of M;
	say "[line break]".

To compute erection orgasm of (M - a wrestler):
	if M is penetrating penis:
		say "[line break][one of]It's just too much for you, and you cum[or]You try to hold back, but it's too good! Your eyes roll back as you cum[or]It feels way too good to hold back, and you cum[at random], [if the size of penis > 4]groaning[otherwise]moaning[end if] with pleasure as [if the size of penis < 4]your [sissy-penis] dribbles a pitifully tiny load into [NameDesc of M][']s mouth[otherwise if the size of penis < 7]you shoot your load straight into [NameDesc of M][']s mouth[otherwise]shoot a massive load straight down [NameDesc of M][']s throat[end if]. [big he of M] [if the size of penis > 6]releases your [manly-penis] from [his of M] mouth, swallowing[otherwise]swallows it [end if] with a self-satisfied giggle and crawls out from underneath you.";
		cutshow figure of wrestler cutscene 12 for M;
	otherwise:
		follow the default ejaculation rule;
	now penis is not penis-erect.

To compute vaginal orgasm hijack of (M - wrestler):
	if M is penetrating face:
		say "[line break][one of]It's just too much for you, and you cum[or]You try to hold back, but it's too good! Your eyes roll back as you cum[or]It feels way too good to hold back, and you cum[at random], moaning with pleasure as you squirt all over [NameDesc of M][']s face. [big he of M] giggles, slowly crawling out from underneath you.";
	otherwise:
		say DefaultVaginalOrgasmFlav.

To say OralResistingResponse of (M - a wrestler):
	let P be a random patron in the location of the player;
	say "[line break][one of][BigNameDesc of M] continues holding you for [NameDesc of P].[or][BigNameDesc of M] holds you down to make sure [NameDesc of P] can fuck you as deep and hard as possible[or][BigNameDesc of M] eggs on [NameDesc of P]. [line break][speech style of M]'Fuck [him of the player] harder!'[roman type][line break][or][BigNameDesc of M] spreads your [AssDesc] for [NameDesc of P], egging [him of P] on[at random][line break]".

To compute facial climax of (M - a wrestler):
	let P be a random patron in the location of the player;
	if P is patron and P is penetrating asshole:
		say "You know what's coming, and [if the reaction of the player is 0]you do your best to struggle, but [NameDesc of M] easily holds[otherwise]you don't struggle, but [NameDesc of M] insists on holding[end if] you down anyway.";
		say CreampieFlav of P in asshole;
		compute P finishing in asshole;
		orgasm P;
		let G be a random off-stage plentiful accessory;
		now G is ruby;
		set shortcut of G;
		now G is in the location of the player;
		say "[BigNameDesc of M] finally releases [his of M] grip, allowing you to roll off as [BigNameDesc of P] happily shuffles out of the room. [line break][speech style of M]'[if refractoryperiod > 0]Technically, you still came first, but that was fun, so...'[otherwise]Wow, I guess [he of P] came first, huh? Take this, you earned it!'[end if][roman type][line break][big he of M] grins, pulling out a [printed name of G] and tossing it in your direction.";
	otherwise if the sex-length of M > 0:[if sex ends and her sex length is 1 or more, it means you came first.]
		say "[line break][speech style of M]'[one of]Looks like I win!'[or]I win! I'm game if you want another try later, though.'[or]I win again!'[cycling][roman type][line break]";
		now the sex-length of M is 0;
		orgasm quietly;
		decrease the patron-chance of M by 4;[offsets the increase below]
	otherwise:
		let G be a random off-stage plentiful accessory;
		now G is sapphire;
		if the patron-chance of M > 2, now G is emerald;
		if the patron-chance of M > 4, now G is ruby;
		set shortcut of G;
		now G is in the location of the player;
		say "[BigNameDesc of M] bucks [his of M] hips, moaning with pleasure as [if lady fetish is 2]several spurts of [semen] dribble out of [his of M] cage[otherwise][he of M] sprays you with fem cum[end if].[line break][speech style of M]'Ooooh! Yeah! That was awesome!'[roman type][line break][line break][big he of M] lies there panting for a few seconds before gently pushing you off and climbing to [his of M] feet.[line break][speech style of M]'[if the patron-chance of M > 4]Wow, I can't believe you held out! You've earned this!'[otherwise if the patron-chance of M > 2]I'll have to try a lot harder next time. Still, you've earned this.'[otherwise]I was going a little easy on you, but I still came first, so...'[end if][roman type][line break][big he of M] grins, pulling out a [printed name of G] and places it in front of you.";
		orgasm M;
	if P is patron and P is not penetrating asshole:
		say "[line break]The [P] jizzes on the floor and leaves the same way [he of P] came.";
		SemenPuddleUp the semen load of P;
		orgasm P;
	now M is not penetrating face;
	now M is not penetrating vagina;
	now M is not penetrating penis;
	increase the patron-chance of M by 2;
	if P is patron, destroy P;
	calm M;
	bore M.

This is the wrestler uses your diaper rule:
	let M be current-monster;
	if the player is diaper focused:
		let D be a random worn diaper;
		if watersports fetish is 1:
			let C be the coverer of D;
			if C is clothing:
				compute M attacking C;
			otherwise:
				now C is a random worn overdress;
				say "[BigNameDesc of M] pulls up the rear of the waistband of your [D] and squats over your back. [big he of M] starts peeing!";
				PissSoak 6 on D;
				if C is clothing, PissSoak 6 on C;
				satisfy M;
		otherwise:
			say "[BigNameDesc of M] gives you a strong spanking through your [D]! [line break][speech style of M]'[one of]Do you like to get treated like a bad girl, huh? Take this!'[or]Time for your punishment, loser!'[or]When you're in a big nappy like that, there's only one appropriate way to punish you!'[in random order][italic type][line break]SMACK SMACK THWACK SMACK[roman type][line break]";
			PainUp 1;
			satisfy M;
		rule succeeds.
The diaper punishment rule of a wrestler is usually the wrestler uses your diaper rule.

Section - DQ

To compute diaper mess reaction of (M - a wrestler):
	if M is unfriendly:
		say "[BigNameDesc of M] watches you with awe. [line break][speech style of M]'Unf, that's so HOT! You're getting me all worked up...'[roman type][line break]";
	otherwise:
		say "[BigNameDesc of M] looks surprised. [line break][speech style of M]'Oh I didn't realise we were supposed to be playing... My turn next! But first you have to get under my butt...'[roman type][line break]";
		anger M;
	humiliate 200.

To say DiaperReaction of (M - a wrestler):
	if there is a currently visible diaper or the player is shameless:
		if diaper quest is 0:
			say "[BigNameDesc of M] smirks and looks directly at your dampening crotch. [line break][speech style of M]'[one of]Wow, you're even more kinky than me. There's no way I would let anyone see me wetting myself into such a humiliating diaper.'[or]Hey, you must really get off on humiliation if you keep doing that in front of me. How does it feel to be the filthiest skank in this hotel, especially when there are people like me here? You're right at the bottom of the pecking order, you know that?'[stopping][roman type][line break]";
			if the player is modest, say "[one of]You are so ashamed you wish the ground would just open up and swallow you. [or][stopping]You turn bright red and refuse to look at [NameDesc of M] in the eye.";
		otherwise if M is unfriendly:
			say "[BigNameDesc of M] watches you with awe. [line break][speech style of M]'Unf, that's so HOT! You're getting me all worked up...'[roman type][line break]";
		otherwise:
			say "[BigNameDesc of M] coos.[line break][speech style of M]'[one of]Ooh, that sound is music to my ears. You're the best[or]Ooh, if you keep doing that around me I'm going to get all horny and woozy and not be able to hold back[at random]!'[roman type][line break]";
			FavourDown M;
			if M is unfriendly:
				say "[big his of M][']s eyes glaze over.[line break][speech style of M]'Hmm, yeah, let's play a little bit[if the number of monsters in the location of the player is 1]... just you and me[end if]...'[roman type][line break]";
				now the boredom of M is 0;
				now M is interested;
	otherwise:
		say "[BigNameDesc of M] is either completely oblivious or doesn't care about what you've just done.".

Definition: a wrestler is willing to masturbate: decide yes.

Definition: a wrestler is only willing to masturbate horny players: decide no.

To decide which number is the masturbation skill of (M - a wrestler):
	decide on the difficulty of M * 250.

To decide which number is the masturbation length of (M - a wrestler):
	decide on a random number between 2 and 3.

To say MasturbationDeclarationFlav of (M - a wrestler):
	if there is a worn diaper:
		if the player is a bit horny, say "[speech style of M]'[one of]Do you love diapers as much as I do? Let's find out...'[or]You're looking a bit hot under the collar there... let's see what we can do about that!'[or]If you're as horny as I think you are, then you're going to love this.'[then at random][roman type][line break]";
		otherwise say "[speech style of M]'[one of]You don't seem horny at all... but don't worry, I can fix that!'[or]How can you be in such a cute diaper and not be as turned on as I am?! Let me show you how good diapers can feel...'[at random][roman type][line break]".

To say MasturbationStartFlav of (M - a wrestler):
	say "[BigNameDesc of M] pushes you onto your back and sits on your [BellyDesc] to keep you still. ";
	if the total squirtable fill of belly > 0:
		say "The huge pressure on your belly is too much and its contents are forced out!";
		AssSquirt;
	say "[big he of M] produces a vibrating magic wand from somewhere you can't see and pushes the head against [if there is a worn diaper]the crotch of your diaper[otherwise if the player is posessing a vagina]your [vagina][otherwise]your [ShortDesc of penis][end if]! With a click it starts its powerful buzzing...".

To say DiaperMasturbationFlav of (M - a wrestler):
	let D be a random worn diaper;
	say "[BigNameDesc of M] [one of]holds the powerful vibrating wand over your [MediumDesc of D] at the most sensitive spot![or]moves the head of the vibrating wand around in small circles over the front of your [MediumDesc of D].[or][if the player is possessing a penis]grips the tip your [ShortDesc of penis] through your padding and presses the vibrating wand against your shaft[otherwise]pushes the vibrating wand into your padding as hard as [he of M] can[end if]![in random order]".

To say VanillaMasturbationFlav of (M - a wrestler):
	say "[if the player is possessing a vagina][BigNameDesc of M] keeps holding the vibrating wand against your clit and [vagina]![otherwise][BigNameDesc of M] keeps holding the vibrating wand against the head of your [ShortDesc of penis]![end if]".

To say MasturbationAfterFlav of (M - a wrestler):
	say "[BigNameDesc of M] clicks the wand off and pulls it away, getting up off of your belly, clearly content with leaving it there.[if the player is a bit horny][line break][MasturbationTeaseFlav of M][end if]".

To say MasturbationTeaseFlav of (M - a wrestler):
	say "[big he of M] giggles.[line break][speech style of M]'[one of]It's way more fun to be left on the brink of orgasm, don't you think? It's so deliciously frustrating!'[or]Oops! Maybe it ran out of batteries? Nope, I just thought it would be funny to leave you like this, haha! It gets me hot just thinking about how much you must need to cum right now...'[in random order][roman type][line break]".

To say DQMasturbationResistReactionFlav of (M - a wrestler):
	say "[BigNameDesc of M] narrates [his of M] own performance.[line break][speech style of M]'[one of]What's this folks? The challenger is squirming like a child under the champ's rump... does [he of the player] need to breathe? Hope [he of the player] likes diaper pail flavoured air!'[or]Champ is just going to town on the challenger's diaper! [big he of the player] bucks and kicks but those moans tells me there'll be a honeymoon after this!'[or]C'mon tinkles I need SOME sort of work out... want me to lift up a bit?'[or]Oh what's this? Just when the champ was on a roll [he of M] pulls the challenger's legs up in the dreaded changing hold! Oh how humiliating!'[or]I'm barely at a tingle and you're bucking like this? I feel you owe me after this one!'[in random order][roman type][line break]".

Definition: a wrestler is willing to confiscate: decide yes.

To say ConfiscationDeclarationFlav of (M - a wrestler) on (C - a clothing):
	say "[speech style of M]'[if C is plentiful accessory]Since you're being so mean, I'm gonna take this.'[otherwise if C is equippable]Good babies don't fight back, you know. So I'm taking this away from you for your own good.'[otherwise]I assume you're wearing this by mistake, right? It's way too grown up for someone like you. Don't worry, I'll take it off your hands so that you don't feel tempted to keep wearing it.'[end if][roman type][line break]".

wrestler-feeds-you-to-master is a diaper punishment. The priority of wrestler-feeds-you-to-master is 5.

Definition: wrestler-feeds-you-to-master (called P) is appropriate:
	if current-monster is not wrestler, decide no;
	let N be a random alive dominatrix;
	if N is not monster and the times-met of current-monster <= 1, now N is a random alive matron;
	if N is monster and the times-met of N is 0 and the times-met of current-monster <= 1, decide yes;
	decide no.

To compute punishment of (P - wrestler-feeds-you-to-master):
	follow the wrestler feeds you to master rule.

wrestler-facesit is a diaper punishment. The priority of wrestler-facesit is 4.

Definition: wrestler-facesit (called P) is appropriate:
	if current-monster is not wrestler, decide no;
	if there is a worn wet diaper or there is a worn messed diaper, decide yes;
	decide no.

To compute punishment of (P - wrestler-facesit):
	let M be current-monster;
	let D be a random worn diaper;
	say "[BigNameDesc of M] flips you onto your back and lies on top of you so that [his of M] latex-covered diaper bulge is right above your face. From this vantage point [he of M] gives you a diaper check, pushing [his of M] hand into your [MediumDesc of D] and moving [his of M] nose very close to get a good sniff.[line break][speech style of M]'That's what I thought. Well, to make this a proper 69 I need to make sure mine matches yours, right?'[roman type][line break]That's the last thing you hear [him of M] say before your head is engulfed by cold stretchy rubber and all you can do is wriggle with [joy the diaper addiction of the player]. You can feel the softness of [his of M] thick padding cushioning you against the heavy weight of the butt and body above it. [if D is wet]A very subtle hiss accompanies the sound of rain hitting an umbrella and you know that [NameDesc of M] is peeing [himself of M] right on top of your face. The padding begins to sag which makes the latex cling to your face even tighter. [end if][if D is messed]There's a rubber whine, like a little bit of air being released from a balloon. Then a rasping sound heralds the arrival of something new above your face. It feels like there's an avalanche of snow or something right on the other side of [his of M] latex bodysuit. Your head becomes even more enveloped in its rubbery prison, if that were even possible. [end if]You can't breathe and you can hardly hear a thing. [NameDesc of M] is saying something but you can't make out the words at all, as if you were underwater. And then [he of M] starts thrusting [his of M] hips forward and back, grinding over your face. Through the latex you can feel the [if D is wet]soggy [end if][if D is messed]lumpy [end if]padding as it is moved up and down, forward and back, squished inwards then outwards, squelched around your entire head. [BigNameDesc of M] is moaning but it sounds like [he of M][']s a hundred of metres away. [big he of M] rubs your own [MediumDesc of D] as [he of M] continues to grind, [one of]and you at first assume [he of M] is using [his of M] hands but you realise that it's actually [his of M] own face you can feel against[or]once again using [his of M] face to nuzzle[stopping] your crotch.";
	let DAU be 0;
	if D is wet, increase DAU by 1;
	if D is messed, increase DAU by 1;
	DiaperAddictUp DAU;
	ruin vagina;
	say "And now [he of M][']s picking up the pace, pushing harder on top of your head to get your face even deeper into the spherical prison of [his of M] [if D is messed]messy[otherwise]soaking[end if] diaper. [big he of M] continues to speed up until [he of M] climaxes with a few sharp violent thrusts. [big he of M] falls forward, [his of M] own face planted firmly into the front of your own [ShortDesc of D], [his of M] own diapered butt lifting off of your face enough for you to now be able to gasp for air. Your mind is reeling in [horror the diaper addiction of the player] over what just happened[if the player is a bit horny] and [his of M] work on your own [genitals] has left you notably more aroused then you were when this started[end if]. [BigNameDesc of M] lovingly rubs [his of M] face in your loins for a few more seconds before getting up and beginning to stagger away.[line break][speech style of M]'That was fucking amazing... but I think I need to go find a change now. Until next time, [honey of M]...'[roman type][line break]";
	bore M.

wrestler-romper is a diaper punishment. The priority of wrestler-romper is 3.

Definition: wrestler-romper (called P) is appropriate:
	if current-monster is not wrestler, decide no;
	if the class of the player is adventurer and there is an off-stage full body baby romper, decide yes;
	decide no.

To compute punishment of (P - wrestler-romper):
	let M be current-monster;
	let C be a random off-stage full body baby romper;
	say "[speech style of M]'I think I've got the perfect thing for a little minx like you!'[roman type][line break][BigNameDesc of M] pulls out a large pink garment covered with colourful baby paraphernalia.";
	repeat with D running through worn dresses:
		say "[big he of M] rips off your [D]!";
		destroy D;
	repeat with D running through worn skirts:
		say "[big he of M] rips off your [D]!";
		destroy D;
	repeat with D running through worn trousers:
		say "[big he of M] rips off your [D]!";
		destroy D;
	repeat with D running through worn top-exclusive clothing:
		say "[big he of M] rips off your [D]!";
		destroy D;
	repeat with D running through worn totally-exclusive clothing:
		say "[big he of M] rips off your [D]!";
		destroy D;
	say "[big he of M] forces your arms and legs into the warm snug item. Before you know it, you're wearing a [ShortDesc of C]!";
	summon C cursed;
	compute quest of C; [we do this silently since the quest will be displayed in the examine call below]
	say FullExamineDesc of C;
	say "[speech style of M]'Haha, it totally suits you!'[roman type][line break]";
	satisfy M.

Section 2 - Damage

To compute damage reaction of (M - a wrestler):
	if M is uninterested:
		say "The [man of M] looks shocked.[line break][speech style of M]'Ooh, I didn't know you wanted to fight! Why didn't you just say so?'[roman type][line break]";
		cutshow figure of wrestler cutscene 3 for M;
		now M is interested;
		anger M;
	otherwise if the health of M < the maxhealth of M / 2 and the excitement of M is -1 and the times-dominated of M > 0:
		say "[speech style of M]'Haha, is that really all you've got? Looks like it's my turn to be on top!'[roman type][line break][BigNameDesc of M] seems to change [his of M] stance! Looks like this will be harder than you thought!";
		DifficultyUp M by 5 + the times-dominated of M;
		increase the health of M by 15;
		now the excitement of M is 1;
	otherwise:
		say DamageReaction (the health of M) of M.

To say DamageReactHealthy of (M - a wrestler):
	say "[big he of M] looks [one of][or]even [stopping]more excited than [he of M] did already!".

To say DamageReactDamaged of (M - a wrestler):
	say "[big he of M] takes the hit, [one of]somehow [or][stopping]even more turned on by the pain!".

To say DamageReactTired of (M - a wrestler):
	say "[big he of M] yelps in pain! [one of]It was a very sexual yelp, though...[or][line break][stopping]".

To say DamageReactWeak of (M - a wrestler):
	if lady fetish is 2:
		say "[big he of M] [i]coos[/i] in pain, as [he of M] fights to maintain [his of M] balance.";
	otherwise:
		say "[big he of M] [i]coos[/i] in pain, [if the intelligence of the player > 5]intentionally jiggling [his of M] tits[otherwise]causing [his of M] tits to jiggle[end if] as [he of M] fights to maintain [his of M] balance.".

To say DamageReactSubmissive of (M - a wrestler):
	if lady fetish is 2:
		say "[big he of M] [i]coos[/i] in pain, eagerly rubbing [his of M] thighs together as [he of M] struggles to maintain [his of M] balance.";
	otherwise:
		say "[big he of M] [i]coos[/i] in pain, [if the intelligence of the player > 5]intentionally jiggling [his of M] tits[otherwise]causing [his of M] tits to jiggle[end if] and eagerly rubbing [his of M] thighs together as [he of M] struggles to maintain [his of M] balance.".

To say PityOfferResponse of (M - a wrestler):
	say "[speech style of M]'Aww, how boring. You're not even going to punish me a little bit?'[roman type][line break]".

To say BanishForceFlav of (M - a wrestler):
	say "You point towards the west. [BigNameDesc of M] hangs [his of M] head in disappointment before turning and beginning to crawl away.[line break][speech style of M]'I guess it was almost time for me to go home for the night anyway...'[roman type][line break]".

To say TaxReturnDismay of (M - a wrestler):
	say "[speech style of M]'How boring. I was hoping the punishment for losing would be a little more... intimate.'[roman type][line break]".

Section 3 - Dominant Sex

To decide which number is the dominationtype of (M - a wrestler) using (F - penis):
	decide on FUCK-BLOWJOB.

To blowjob dominate (M - a wrestler):
	let C be a random worn bottom level protection clothing;
	say "You slam [NameDesc of M] against a wall, pushing [him of M] to [his of M] knees as you [if C is not strapon-panties and C is clothing]fish your [SexDesc of penis] out of your pants[otherwise if the player is a bit horny]slowly pump your [SexDesc of penis][otherwise]slowly pump your hardening [sexual-player-penis][end if].[line break]";
	if sexual-penis-length > 8:
		say "[speech style of M]'So... BIG...'[roman type][line break]A little bit of drool rolls out of [NameDesc of M][']s mouth as [he of M] stares at your [sexual-player-penis]. [if watersports fetish is 1 and the player is desperate to pee][line break][speech style of M]'[big please] make me your toilet. [big please] let me drink your [one of]urine[or]piss[or]pee[at random]...'[roman type][line break][otherwise][speech style of M]'[big please] fuck my mouth. [big please] give me all your [semen]...'[end if] [big he of M] pulls [his of M] mouth wide open, tongue lolling out as [he of M] gazes up at you, begging desperately for a taste of whatever you have to give [him of M]. You slam it in without a moment of hesitation, pinning [his of M] wrists against the wall as your [sexual-player-penis] hits the back of [his of M] throat. [big he of M] doesn't put up a shred of resistance, moaning reverently as [his of M] throat clenches around your monstrous tool. [big he of M] face-fucks [himself of M] with even more enthusiasm whenever there's any space between strokes. It's too intense, and before you've had a chance to really show [him of M] what you've got, your [SexDesc of penis] is pumping a [load] directly into [his of M] hungry belly.";
		BlowGet;
		orgasm;
		say "You pull out slowly, allowing [him of M] to fully clean your softening [SexShaft] with [his of M] tongue as you stretch and straighten up.";
		strongDignify;
		say AfterDominationComment 2 of M;
	otherwise if sexual-penis-length > 3:
		say "[if watersports fetish is 1 and the player is desperate to pee][line break][speech style of M]'Looks like it's my turn to be the toilet! Don't worry, I'll swallow every drop of your [one of]urine[or]piss[or]pee[at random].'[roman type][line break][otherwise][line break][speech style of M]'I'm on the bottom again! Ooh! I'm gonna swallow every last drop! Just watch!'[roman type][line break][end if] [big he of M] grabs your [SexDesc of penis] with [if sexual-penis-length > 6]both hands[otherwise]one hand[end if], glancing up at you as [he of M] accepts it into [his of M] mouth. [big his of M] eyes roll as [he of M] pushes further and further onto your meat, [his of M] tongue lapping at the underside of your [SexShaft]. [big he of M] soon removes [if sexual-penis-length > 6][his of M] hands, emitting a happy noise[otherwise][his of M] hand, humming proudly[end if] as [his of M] nose bumps up against your belly, and you feel [his of M] lower lip against your sack. It's just not in you not to give [him of M] what [he of M] wants, and with a guttural groan you come [if sexual-penis-length > 6]straight down [his of M] throat[otherwise]directly into [his of M] mouth[end if], filling [his of M] hungry belly with your [load].";
		BlowGet;
		orgasm;
		moderateDignify;
		say AfterDominationComment 2 of M;
	otherwise if sexual-penis-length > 0:
		say "[line break][speech style of M]'[one of]Awww, is that your penis? Come on and give me a mouthful, cutie!'[or]I don't care how your penis got so small, all I know is that tiny [sissy] penises make the best-tasting cum!'[stopping][roman type][line break][big he of M] opens [his of M] mouth wide, gesturing to [his of M] outstretched tongue with a latex-clad finger. When you got [him of M] to [his of M] knees, you thought it was too good to be true, but now here [he of M] is, begging for a drink of your [semen]!";
		orgasm;
		say "You immediately begin to masturbate, moaning uncontrollably as you blow your load in [if the player is horny]six[otherwise if the player is a bit horny]eight[otherwise]ten[end if] seconds flat, filling [his of M] mouth with a disproportionally large helping of fresh [semen]. [big he of M] slowly stands up, pinning your arms to your sides as [he of M] suddenly kisses you on the lips! You're unable to fight [his of M] grip, torn between arousal and [if the semen taste addiction of the player < 7]disgust[otherwise]thirst[end if] as [he of M] uses [his of M] tongue to aggressively force every last drop down your throat.";
		now player-fucking is DOMINANT-NEUTRAL;
		trivialDignify;
		StomachSemenUp the semen load of the player;
	say AfterDominationComment 2 of M.

To watersports dominate (M - a wrestler):
	let C be a random worn bottom level protection clothing;
	say "You slam [NameDesc of M] against a wall, pushing [him of M] to [his of M] knees as you [if C is clothing and the player is female]pull down your [printed name of C][otherwise if the player is female]use your fingers to spread your nether lips[otherwise if C is not strapon-panties and C is clothing]fish your [player-penis] out of your [printed name of C][otherwise]take aim with your [sexual-player-penis][end if].[line break]";
	if the player is female:[as in has a vagina]
		say "[line break][speech style of M]'[one of]Yes! YES! [big please], make me your toilet![or]Fuuuck yeeesss!'[or]Toilet time!'[at random][roman type][line break] [big he of M] opens wide for the incoming stream of [urine], gargling happily as [his of M] mouth slowly fills with the frothy liquid. You let out a long sigh of relief as the flow peters out, and [he of M] swallows it all in one gulp.";
		strongDignify;
	otherwise if the size of penis > 8:
		say "[speech style of M]'So... BIG...'[roman type][line break]A little bit of drool rolls out of [NameDesc of M][']s mouth as [he of M] stares at your [sexual-player-penis]. [line break][speech style of M]'[big please] make me your toilet. [big please] let me drink it...'[roman type][line break]A good Samaritan as always, you tilt [his of M] head up, allowing relief to wash over your body as you empty your bladder directly into [his of M] mouth. [big he of M] holds all of it in [his of M] mouth, gargling happily before swallowing it all in a single gulp.";
		strongDignify;
	otherwise if the size of penis > 3:
		say "[line break][speech style of M]'Looks like it's my turn to be the toilet! Don't worry, I'll swallow every drop of your [one of]urine[or]piss[or]pee[at random].'[roman type][line break] [big he of M] opens wide, playfully wiggling [his of M] eyebrows as [he of M] cups [his of M] hands under [his of M] chin. It's just not in you to deny [him of M] what [he of M] wants, and you emit a heavy sigh as you allow all your stress to flow out directly into [his of M] mouth. True to [his of M] word [he of M] swallows every drop.";
		moderateDignify;
	otherwise:
		say "[line break][speech style of M]'[one of]Oh wow! I didn't even know dicks could get that small! [big please], I have to know what your piss tastes like!'[or]I never get tired of your tiny cock! Let me have another taste of that yummy piss!'[stopping][roman type][line break] [big he of M] opens [his of M] mouth wide, gesturing to [his of M] outstretched tongue with a latex-clad finger. This is too good to be true! You immediately release your hold on your bladder, allowing a shudder of relief to pass through your body as you douse [NameDesc of M] in a stream of golden [urine]. [big he of M] pushes [his of M] breasts together enticingly as [he of M] captures it in [his of M] mouth, making a show of swallowing it in one huge gulp. After [he of M]'s done, [he of M] suddenly gets up and kisses you square on the lips. Wow!";
		slightDignify;
		UrineTasteAddictUp 1;
	now the bladder of the player is 0;
	cutshow figure of wrestler cutscene 2 for M;
	say AfterDominationComment 1 of M;
	SportsGet.

To facesit dominate (M - a wrestler):
	if player-fucker is asshole:
		say "You force [NameDesc of M] onto [his of M] back, sitting on [his of M] face. [big he of M] eagerly spreads your [AssDesc], giggling as [he of M] peppers kisses on and around your delicate sphincter. It feels nice to receive such tender treatment, and you feel some of your aches and pains fade away as [big he of M] lavishes attention on your hole. Unfortunately, it's not enough to make you cum, and you get off [him of M] feeling slightly more hot and bothered than you did before.";
		LickGet;
		moderateDignify;
		heal asshole times 2;
		passively stimulate asshole from M;
		say AfterDominationComment 2 of M;
	otherwise:
		say "You force [NameDesc of M] onto [his of M] back, sitting on [his of M] face. [big he of M] eagerly gets to work, peppering kisses around your clit and gently tonguing your hole. It feels nice to receive such tender treatment, and you feel some of your aches and pains fade away as [big he of M] lavishes attention on your lady parts. Unfortunately, it's not enough to make you cum, and you get off [him of M] slightly more hot and bothered than you did before.";
		LickGet;
		moderateDignify;
		heal vagina times 2;
		passively stimulate vagina from M;
		say AfterDominationComment 2 of M;

To compute unique dominance reward of (M - a wrestler):[She doesn't increase her difficulty until later]
	compute default dominance reward of M;
	now the excitement of M is -1;
	DelicateDown 1.

To say AfterDominationComment (N - a number) of (M - a wrestler):
	if N is 1, say "[speech style of M]'[one of]Thanks for the yummy piss!'[or]Thanks for making me your toilet!'[or]I love toilet time...'[at random][roman type]";
	if N is 2, say "[speech style of M]'[one of]You should come see my mistress sometime![or]There's no way I'm gonna let myself lose to you again! Get ready, hot stuff!'[or]Let's see if you can beat me like that next time, sexy!'[at random][roman type]".

To say DominanceFailure of (M - a wrestler):
	say "You grapple with [NameDesc of M] until [he of M] overpowers you and pins you on the ground underneath [him of M].";

To compute failed dominance punishment of (M - a wrestler):
	let P be a random worn bottom level protection clothing;
	if the excitement of M > 0 and the player is getting very unlucky:
		if the size of penis < 4 and the size of penis > 0 and asshole is not actually occupied:
			say "[big he of M] giggles as [he of M] [if P is clothing]pulls aside your [ShortDesc of P][otherwise]pinches your [sissy-penis] between [his of M] thumb and forefinger[end if].[line break][speech style of M]'I KNEW it'd be cute! I wonder if I can make the little guy cum?'[roman type][line break]";
			let R be a random number between 1 and 3;
			say "You watch as [he of M] puckers [his of M] lips, making an exaggerated smooching sound as [he of M] plants them on your [if the player is horny]painfully hard[otherwise if the player is a bit horny]hard[otherwise]semi-soft[end if] [ShortDesc of penis].";
			decrease R by 1;
			while R > 0 and M is interested:
				stimulate penis from M;
				if refractoryperiod < 3:
					say "You gasp and shiver [one of]unprepared[or]still unprepared[stopping] for the surprisingly intense sensation. Your [sissy-penis] spasms a couple times, leaking precum, but an orgasm doesn't arrive. [line break][speech style of M][if R is 0]'Aww, oh well. I'll make you cum with some fisting later.'[otherwise]'[one of]Come on, cutie! Aren't you close?'[or]It's twitching!'[or]Come on, cum for me!'[at random][end if][roman type][line break]";
					slightHumiliate;
				otherwise:
					say "You emit a feminine groan, bucking your hips as your [sissy-penis] spurts [semen] all over [his of M] lips and chin. Embarrassment from having cum from such slight stimulation radiates up from your core as [big he of M] releases you.";
					strongHumiliate;
					Satisfy M;
			if M is interested:
				Bore M;
		otherwise if the size of penis > 0:
			say "[big he of M] unzips [his of M] catsuit, revealing [his of M] wet, rosy vagina.[line break][speech style of M]'I really wanted to fuck, but losers don't get sex, so I came up with a fun punishment!'[roman type][line break][big he of M] straddles your [if P is clothing][ShortDesc of P][otherwise][Shortdesc of penis][end if] with [his of M] bare sex and begins to grind back and forth. It feels good, but [if P is clothing]you can barely feel it through the [clothing-material of P][otherwise][big he of M] moves too slowly for you to get very much of anything out of it[end if]. [big he of M] puts you through several minutes of slow torture, somehow bringing [himself of M] to orgasm after orgasm. You have no choice but to lie there and endure it until [he of M] finally gets up, leaving you achingly hard and completely soaked in [his of M] feminine juices.";[she has a bunch of vibrators in there, the cheater]
			passively stimulate penis times 3;
			Satisfy M;
		otherwise:
			if M is presenting as male, say "[big he of M] unzips [his of M] catsuit, revealing bright purple chastity cage.[line break][speech style of M]'Normally, this is where I'd fuck you... But I'm locked up for life!'[roman type][line break][big he of M] straddles your [if P is clothing][ShortDesc of P][otherwise][vagina][end if]and begins to grind against you. It feels good, but [if P is clothing]you can barely feel it through the [clothing-material of P][otherwise][big he of M] moves too slowly for you to get very much of anything out of it[end if] [big he of M] puts you through several minutes of slow torture, somehow bringing [himself of M] to orgasm after orgasm. You have no choice but to lie there and endure it until [he of M] finally gets up, leaving you achingly aroused and completely soaked in [his of M] slippery precum.";
			otherwise say "[big he of M] unzips [his of M] catsuit, revealing [his of M] wet, rosy vagina.[line break][speech style of M]'I was really hoping you'd win... Looks like I'm going to have to punish you.'[roman type][line break][big he of M] straddles your [if P is clothing][ShortDesc of P][otherwise][vagina][end if] with [his of M] bare sex and begins to grind against you. It feels good, but [if P is clothing]you can barely feel it through the [clothing-material of P][otherwise][big he of M] moves too slowly for you to get very much of anything out of it[end if] [big he of M] puts you through several minutes of slow torture, somehow bringing [himself of M] to orgasm after orgasm. You have no choice but to lie there and endure it until [he of M] finally gets up, leaving you achingly aroused and completely soaked in [his of M] feminine juices.";
			passively stimulate vagina from M times 3;
			Satisfy M;
		now the excitement of M is 0;
	otherwise if the player is getting unlucky:
		let B be a random off-stage actually summonable bondage;
		if B is clothing:
			say "[line break][speech style of M]'You're into bondage, right? I bet you'll like this, then!'[roman type][line break][big he of M] pulls out a [Shortdesc of B] and locks it into place.";
			summon B cursed;
			now B is locked;
			Satisfy M;
		otherwise:[she just fucks you]
			say "[speech style of M]'Hehe, this will be fun!'[roman type][line break]";
			now another-turn-flavour is the substituted form of "[BigFuckerDesc of M] holds you in place.";
			now another-turn is 1;
	otherwise:
		say "[big he of M] giggles, [if face is actually occupied]peppering kisses around your lips[otherwise]kissing you on the lips[end if] before releasing you. [line break][speech style of M]'That was a great match. I'm looking forward to seeing if you win the next one!'[roman type][line break]";
		increase the excitement of M by 1;
		Bore M.

Part 4 - Friendly Sex

To compute FriendlySexRelease of (M - a wrestler):
	if M is penetrating asshole and the fingers of M > 5:
		say "[speech style of M]'No way! Try again when I meet someone else who can take the whole fist!'[roman type][line break][BigNameDesc of M] refuses to let you go!";
	otherwise if the number of patrons penetrating asshole > 0:
		say "[speech style of M]'[one of]Come on, [he of pimp][']s having fun!'[or]But [he of pimp][']s so into it!'[or]But this is so fun!'[at random][roman type][line break][BigNameDesc of M] refuses to let you go!";
	otherwise if watersports fetish is 1:
		say "[speech style of M]'Aww, alright.'[roman type][line break][BigNameDesc of M] [if M is penetrating asshole]gently removes [his of M] fingers from your [asshole], unzipping [his of M] crotch as [he of M] rises to [his of M] feet.[otherwise]crawls out from under you and rises to [his of M] feet.[end if][line break][speech style of M]'If you couldn't handle that... I guess I'll have to settle for toilet time!'[roman type][line break][big he of M] mashes [his of M] pussy into your face, and before you can react, begins pissing straight into your mouth. You know there's nothing you can do as the warm, salty [urine] hits your tongue, and [if the humiliation of the player < 34000]reluctantly[otherwise]eagerly[end if] allow [him of M] to use you as a literal human toilet.";
		increase the blue-balls of M by 5; [In the future, watersports players will use this for greetings.]
		dislodge M;
		FacePiss from M;
	otherwise if M is willing to let go:
		say FriendlySexReleaseFlav of M;
		increase the blue-balls of M by 10;
		dislodge M;
	otherwise:
		say FriendlySexReleaseRefusalFlav of M;
	if the number of monsters penetrating face + the number of monsters penetrating asshole is 0:
		repeat with P running through patrons in the location of the player:
			destroy P.

To say FriendlySexReleaseFlav of (M - a wrestler):
	if M is intelligent, say FriendlySexReleaseSpeech of M;
	say "[BigNameDesc of M] [if M is penetrating asshole]pulls out.[otherwise]crawls out from underneath you.[end if].".

To say FriendlySexReleaseSpeech of (M - a wrestler):
	say "[speech style of M]'Alright, but I won[']t go easy on you like this forever!!'[roman type][line break]".

To say FriendlySexReleaseRefusalSpeech of (M - a wrestler):
	say "[speech style of M]'[one of]No way! Playing with you is way too fun!'[or]Don[']t wimp out, I know you can take it!'[or]I know you can take it, sexy!'[or]No way, I know you can take it!'[in random order][roman type][line break]".

Part 5 - Conversation

Section 1 - Greeting

To say FirstResponse of (M - a wrestler):
	say "[speech style of M]'Ooh, [please]d to meet you! Can we be friends?'[roman type][line break]";
	alwayscutshow figure of wrestler interact 1 for M.

To say RepeatResponse of (M - a wrestler):
	if M is unfriendly:
		say "[one of][BigNameDesc of M] ignores you.[or][BigNameDesc of M] smiles, silently retaining [his of M] aggressive stance[at random]";
		alwayscutshow figure of wrestler cutscene 3 for M;
	otherwise:
		say "[speech style of M]'[one of]Hey sexy. How have things been going for you?'[or]Hey babe! Remind me to wrestle you sometime.'[or]Hi! [if largeness of breasts > 3]You know, I[']d really like a chance to play with those tits if you'd let me[otherwise]You know, I think you'd look really hot with big tits[end if].'[or]Hey! Have you met my mistress yet?'[or]Hey there. Maybe you and I should go put on a show for my mistress.'[at random][roman type][line break]";
		alwayscutshow figure of wrestler interact 6 for M.

[taunting doesn't work on the wrestler]
To say TauntResponse of (M - a wrestler):
	say "[speech style of M]'[one of]Ooh, it[']s you again. This time I[']m going to win!'[or]Ooh, I'm going to punch you for what you did to me. In a fun way!'[or]Earlier was SO much fun! Let's wrestle for next turn on top![or]Don[']t get used to winning! I[']ve been working out!'[or]I[']m always ready to wrestle some more! Losing is so much fun, though, you should try it some time.'[or]Oh yeah? I[']ll let my fingers do the talking on this one!'[or]This one is for the title of biggest slut! You[']re gonna win for sure!'[at random][roman type][line break][BigNameDesc of M] looks even more excited!";
	compute taunt rejection effect of M;
	alwayscutshow figure of wrestler interact 8 for M.

To say SubmissiveResponse of (M - a wrestler):
	if M is friendly:
		say RepeatResponse of M;
	otherwise:
		say "[speech style of M]'[one of]Ooh, I remember you. Does this mean you want to go again?'[or]Hi! I hope you[']re ready to lose to me again because I'm ready to beat you!'[or]Hi there! You[']re not a very good wrestler, but don[']t worry, you[']re an awesome loser!'[or]What[']s up loser! Ready to wrestle again?'[at random][roman type][line break]";
	alwayscutshow figure of wrestler interact 3 for M.

To say InvitationResponse of (M - a wrestler) with (N - a monster):[The wrestler should always aggro when she notices the player in combat, so there's not much reason to have her say anything here since she says something when she becomes aggressive.]
	if a random number between -1 and the charisma of the player > 3, FavourUp M;
	if M is interested:
		say "[speech style of M]'[one of]Haha, I[']m going to join in too, don[']t worry!'[or]Get ready, we[']re going to gang up on you!'[or]If you can talk, it means you have room for one more!'[or]Hmm...'[or]I[']m gonna help out for sure!'[at random][roman type][line break]";
	otherwise:
		say "[BigNameDesc of M] grins.";
	alwayscutshow figure of wrestler interact 5 for M.

To say UnAnnoyedResponse of (M - a wrestler):
	say "[speech style of M]'[one of]Haha! This is so much fun!'[or]I knew you'd love this!'[at random][roman type][line break]";
	alwayscutshow figure of wrestler interact 10 for M.

To say MildAnnoyedResponse of (M - a wrestler):
	say "[speech style of M]'[one of]Haha! Take it!'[or]Take it, loser!'[or]I know you love it!'[or]Wow, are you this talkative when guys fuck you?'[or]Scream, loser! I won[']t let up!'[at random][roman type][line break]";
	alwayscutshow figure of wrestler interact 10 for M.

To say AnnoyedResponse of (M - a wrestler):
	say "[speech style of M]'[one of]Stop being such a sore loser!'[or]Shut up, you're being such a bad sport!'[or]Are you ever going to stop complaining?!'[at random][roman type]".

To compute annoyed punishment of (M - a wrestler):
	say "[speech style of M]'[one of]Ooh, you are SO going to regret this.'[or]Haha, I'm so going to get you later.'[at random][roman type]";
	DifficultyUp M by 2;
	ApplyFullConvoFatigue to M.

Section 2 - Questioning

To say WhereAnswer of (M - a wrestler):
	say "[speech style of M]'This is the fetish hotel Premier Sinn. But since you're here, and dressed like that, surely you know that?'[roman type][line break]";
	alwayscutshow figure of wrestler interact 13 for M.

To say WhoAnswer of (M - a wrestler):
	say "[speech style of M]'My owner just calls me [if diaper quest is 1]Tinklebutt[otherwise if watersports fetish is 1]Toilet[otherwise]Cumslut[end if]!'[roman type][line break]";
	alwayscutshow figure of wrestler interact 3 for M.

To say StoryAnswer of (M - a wrestler):
	say "[speech style of M]'I love being dominated, and my owner loves dominating me. We make a good match. We come here to unwind and meet new playmates!'[roman type][line break]";
	alwayscutshow figure of wrestler interact 14 for M.

To say EscapeAnswer of (M - a wrestler):
	say "[speech style of M]'What do you mean escape? Who would want to leave this paradise?'[roman type][line break][if the bimbo of the player < 10][line break][first custom style]'Wow, useful...'[roman type][line break][end if]";
	alwayscutshow figure of wrestler interact 12 for M.

To say AdviceAnswer of (M - a wrestler):
	say "[speech style of M]'[one of]Sometimes, it[']s better to crawl around than walk. And I[']m not saying that just because I love to serve!'[or]Latex isn[']t absorbent like other materials, so it's easy clean up if you end up making a mess. It's not just fun to wear, it's practical too!'[or]Acting like a slut gets easier and easier as time goes on, but it never gets any harder. You can fight it, if you hate fun or something, but if you let a guy cum in your mouth once, you remember that feeling forever.'[or]Don[']t just eat candy as soon as you find it. Save it for when you need some energy!'[or]If you don't want the butler to force you to do stuff, always carry around a little bit of jewellery.'[or]Latex isn[']t very flexible. If you[']ve got rubber blocking your crotch, it's easier to tear it off than to move it out of the way. Sure, latex is durable, but it won't hold up forever. If you care about your clothes, take them off before a fuck, or you can just use a zipper like me!'[at random][roman type][line break]";
	alwayscutshow figure of wrestler interact 14 for M.

To compute annoyance of (M - a wrestler):
	if M is unfriendly:
		say "[BigNameDesc of M] ignores your question. [line break][speech style of M]'You should stop talking and start moving if you want any chance of beating me in a fight!'[roman type][line break]";
		alwayscutshow figure of wrestler cutscene 3 for M;
	otherwise:
		say "[speech style of M]'I'm bored of your questions. I just want to follow you and watch your adventure unfold...'[roman type][line break]";
		alwayscutshow figure of wrestler interact 9 for M.

To compute teaching of (M - a wrestler):
	if diaper quest is 0:
		say "[speech style of M]'When someone's shoving their massive cock up your you-know-where, it's important to be able to stay loose and let it happen, otherwise you won't enjoy it properly! Here, let me show you how...'[roman type][line break]";
		if mythical creature fetish is 1, cutshow figure of wrestler cutscene 1 for M;
		teach relaxing;
		if the questioned of M <= the mild-annoyance threshold of M:
			ModerateConvoFatigue M;
		otherwise:
			HeavyConvoFatigue M;
	otherwise:
		say "[speech style of M]'Hmm, maybe in a future version I'll have thought of something to teach you.'[roman type][line break]".

Section 3 - Drink Requesting

To compute friendly drink of (M - a wrestler):
	if diaper quest is 1:
		say "[speech style of M]'Haha, no, does it look like this outfit has pockets?'[roman type][line break]";
		alwayscutshow figure of wrestler interact 16 for M;
	otherwise if the player is prone and watersports fetish is 1:
		say "[BigNameDesc of M][']s eyes light up. [line break][speech style of M]'One Toilet Special, coming right up!'[roman type][line break][BigNameDesc of M] doesn't give you a chance to ask what that means before [he of M] has unzipped [his of M] crotch and starting pissing straight at you! [variable custom style][if the urine taste addiction of the player < 6]Shit shit shit![otherwise if the urine taste addiction of the player < 13]That's not what I meant...[otherwise]Ooh, yum![end if]";
		FacePiss from M;
	otherwise:
		say "[if watersports fetish is 1]You notice a naughty look in [his of M] eyes. [line break][speech style of M]'[one of]Get on your knees and ask me again.'[or]Haha, sure! But only if you get on your knees first!'[or]Of course, why didn[']t you ask sooner? Get on your knees and open wide!'[or]Totally. Get on your knees and say the word, I[']ve got plenty for you.'[at random][otherwise][speech style of M]'Haha, no, does it look like this outfit has pockets?'[end if][roman type][line break]";
		if watersports fetish is 1, alwayscutshow figure of wrestler interact 5 for M;
		otherwise alwayscutshow figure of wrestler interact 16 for M.

To compute unfriendly drink of (M - a wrestler):
	say "[speech style of M]'[if watersports fetish is 1 and diaper quest is 0]Oh I'll give you a drink all right!'[otherwise]You should stop talking and start moving if you want any chance of beating me in a fight!'[end if][roman type][line break]";
	alwayscutshow figure of wrestler cutscene 3 for M;
	now M is interested;
	now the boredom of M is 0.

Section 4 - Food Requesting

Definition: a wrestler is willing to give snacks: decide yes.

Section 5 - Trading

To say MonsterOfferAcceptFlav of (M - a wrestler) to (T - a thing):
	say "[speech style of M]'Oh wow, [if T is clothing]that'll look amazing on me[otherwise]that's perfect for my mistress[end if]! Sure, I'll take that off your hands.'[roman type][line break]";
	alwayscutshow figure of wrestler interact 15 for M.

To say MonsterOfferRejectFlav of (M - a wrestler) to (T - a thing):
	say "[speech style of M]'Why would I need that?'[roman type][line break]";
	alwayscutshow figure of wrestler interact 13 for M.

To say MonsterOfferRejectFlav of (M - a wrestler) to (T - a clothing):
	say "[speech style of M]'I'm quite happy with what I wear right now, thanks!'[roman type][line break]";
	alwayscutshow figure of wrestler interact 16 for M.

To say MonsterOfferRejectFlav of (M - a wrestler) to (T - a sex toy):
	say "[speech style of M]'Oh I've already got one of those, thanks anyway!'[roman type][line break]";
	alwayscutshow figure of wrestler interact 4 for M.

Wrestler ends here.
